disease_name,year,week,week_date,male_count,female_count,total_count,sentinel_points,data_type
インフルエンザ,2015,1,2015-W01,1889,1920,3809,345,gender
RSウイルス感染症,2015,1,2015-W01,34,44,78,210,gender
咽頭結膜熱,2015,1,2015-W01,14,11,25,210,gender
Ａ群溶血性レンサ球菌咽頭炎,2015,1,2015-W01,56,50,106,210,gender
感染性胃腸炎,2015,1,2015-W01,275,206,481,210,gender
水痘,2015,1,2015-W01,28,21,49,210,gender
手足口病,2015,1,2015-W01,7,3,10,210,gender
突発性発しん,2015,1,2015-W01,10,8,18,210,gender
ヘルパンギーナ,2015,1,2015-W01,0,1,1,210,gender
流行性耳下腺炎,2015,1,2015-W01,7,4,11,210,gender
川崎病,2015,1,2015-W01,0,1,1,210,gender
インフルエンザ,2009,50,2009-W50,1980,2007,3987,290,gender
RSウイルス感染症,2009,50,2009-W50,26,21,47,150,gender
咽頭結膜熱,2009,50,2009-W50,10,2,12,150,gender
Ａ群溶血性レンサ球菌咽頭炎,2009,50,2009-W50,93,94,187,150,gender
感染性胃腸炎,2009,50,2009-W50,483,451,934,150,gender
水痘,2009,50,2009-W50,84,90,174,150,gender
手足口病,2009,50,2009-W50,31,19,50,150,gender
突発性発しん,2009,50,2009-W50,32,43,75,150,gender
ヘルパンギーナ,2009,50,2009-W50,5,5,10,150,gender
流行性耳下腺炎,2009,50,2009-W50,51,46,97,150,gender
川崎病,2009,50,2009-W50,0,0,0,150,gender
インフルエンザ,2015,29,2015-W29,3,4,7,410,gender
RSウイルス感染症,2015,29,2015-W29,10,5,15,259,gender
咽頭結膜熱,2015,29,2015-W29,97,78,175,259,gender
Ａ群溶血性レンサ球菌咽頭炎,2015,29,2015-W29,375,337,712,259,gender
感染性胃腸炎,2015,29,2015-W29,691,572,1263,259,gender
水痘,2015,29,2015-W29,69,52,121,259,gender
手足口病,2015,29,2015-W29,2138,1810,3948,259,gender
突発性発しん,2015,29,2015-W29,77,93,170,259,gender
ヘルパンギーナ,2015,29,2015-W29,443,422,865,259,gender
流行性耳下腺炎,2015,29,2015-W29,59,49,108,259,gender
川崎病,2015,29,2015-W29,3,3,6,259,gender
インフルエンザ,2016,34,2016-W34,8,7,15,409,gender
RSウイルス感染症,2016,34,2016-W34,89,82,171,256,gender
咽頭結膜熱,2016,34,2016-W34,22,33,55,256,gender
Ａ群溶血性レンサ球菌咽頭炎,2016,34,2016-W34,146,135,281,256,gender
感染性胃腸炎,2016,34,2016-W34,458,397,855,256,gender
水痘,2016,34,2016-W34,37,26,63,256,gender
手足口病,2016,34,2016-W34,142,101,243,256,gender
突発性発しん,2016,34,2016-W34,66,79,145,256,gender
ヘルパンギーナ,2016,34,2016-W34,256,230,486,256,gender
流行性耳下腺炎,2016,34,2016-W34,107,95,202,256,gender
川崎病,2016,34,2016-W34,3,5,8,256,gender
インフルエンザ,2024,12,2024-W12,2530,2247,4777,416,gender
新型コロナウイルス感染症（COVID-19）,2024,12,2024-W12,561,713,1274,416,gender
RSウイルス感染症,2024,12,2024-W12,82,59,141,262,gender
咽頭結膜熱,2024,12,2024-W12,25,19,44,262,gender
Ａ群溶血性レンサ球菌咽頭炎,2024,12,2024-W12,406,335,741,262,gender
感染性胃腸炎,2024,12,2024-W12,582,514,1096,262,gender
水痘,2024,12,2024-W12,26,30,56,262,gender
手足口病,2024,12,2024-W12,3,1,4,262,gender
突発性発しん,2024,12,2024-W12,31,33,64,262,gender
ヘルパンギーナ,2024,12,2024-W12,2,0,2,262,gender
流行性耳下腺炎,2024,12,2024-W12,5,5,10,262,gender
川崎病,2024,12,2024-W12,0,4,4,262,gender
インフルエンザ,2014,47,2014-W47,434,359,793,412,gender
RSウイルス感染症,2014,47,2014-W47,207,175,382,263,gender
咽頭結膜熱,2014,47,2014-W47,80,77,157,263,gender
Ａ群溶血性レンサ球菌咽頭炎,2014,47,2014-W47,398,308,706,263,gender
感染性胃腸炎,2014,47,2014-W47,1180,1025,2205,263,gender
水痘,2014,47,2014-W47,129,101,230,263,gender
手足口病,2014,47,2014-W47,94,52,146,263,gender
突発性発しん,2014,47,2014-W47,85,64,149,263,gender
ヘルパンギーナ,2014,47,2014-W47,17,5,22,263,gender
流行性耳下腺炎,2014,47,2014-W47,30,22,52,263,gender
川崎病,2014,47,2014-W47,2,1,3,263,gender
インフルエンザ,2019,17,2019-W17,609,582,1191,409,gender
RSウイルス感染症,2019,17,2019-W17,54,45,99,257,gender
咽頭結膜熱,2019,17,2019-W17,34,32,66,257,gender
Ａ群溶血性レンサ球菌咽頭炎,2019,17,2019-W17,432,335,767,257,gender
感染性胃腸炎,2019,17,2019-W17,1378,1196,2574,257,gender
水痘,2019,17,2019-W17,77,45,122,257,gender
手足口病,2019,17,2019-W17,6,8,14,257,gender
突発性発しん,2019,17,2019-W17,97,90,187,257,gender
ヘルパンギーナ,2019,17,2019-W17,2,2,4,257,gender
流行性耳下腺炎,2019,17,2019-W17,10,8,18,257,gender
川崎病,2019,17,2019-W17,1,1,2,257,gender
インフルエンザ,2010,33,2010-W33,3,2,5,284,gender
RSウイルス感染症,2010,33,2010-W33,2,0,2,148,gender
咽頭結膜熱,2010,33,2010-W33,15,15,30,148,gender
Ａ群溶血性レンサ球菌咽頭炎,2010,33,2010-W33,34,26,60,148,gender
感染性胃腸炎,2010,33,2010-W33,180,159,339,148,gender
水痘,2010,33,2010-W33,36,32,68,148,gender
手足口病,2010,33,2010-W33,120,93,213,148,gender
突発性発しん,2010,33,2010-W33,33,50,83,148,gender
ヘルパンギーナ,2010,33,2010-W33,90,95,185,148,gender
流行性耳下腺炎,2010,33,2010-W33,61,45,106,148,gender
川崎病,2010,33,2010-W33,0,0,0,148,gender
インフルエンザ,2012,40,2012-W40,5,6,11,409,gender
RSウイルス感染症,2012,40,2012-W40,297,270,567,259,gender
咽頭結膜熱,2012,40,2012-W40,61,68,129,259,gender
Ａ群溶血性レンサ球菌咽頭炎,2012,40,2012-W40,162,126,288,259,gender
感染性胃腸炎,2012,40,2012-W40,498,449,947,259,gender
水痘,2012,40,2012-W40,53,46,99,259,gender
手足口病,2012,40,2012-W40,81,67,148,259,gender
突発性発しん,2012,40,2012-W40,94,87,181,259,gender
ヘルパンギーナ,2012,40,2012-W40,61,54,115,259,gender
流行性耳下腺炎,2012,40,2012-W40,46,37,83,259,gender
川崎病,2012,40,2012-W40,2,1,3,259,gender
インフルエンザ,2022,15,2022-W15,0,0,0,407,gender
RSウイルス感染症,2022,15,2022-W15,5,7,12,256,gender
咽頭結膜熱,2022,15,2022-W15,6,2,8,256,gender
Ａ群溶血性レンサ球菌咽頭炎,2022,15,2022-W15,14,8,22,256,gender
感染性胃腸炎,2022,15,2022-W15,621,538,1159,256,gender
水痘,2022,15,2022-W15,6,11,17,256,gender
手足口病,2022,15,2022-W15,7,7,14,256,gender
突発性発しん,2022,15,2022-W15,41,55,96,256,gender
ヘルパンギーナ,2022,15,2022-W15,0,0,0,256,gender
流行性耳下腺炎,2022,15,2022-W15,5,1,6,256,gender
川崎病,2022,15,2022-W15,1,0,1,256,gender
インフルエンザ,2001,24,2001-W24,13,7,20,178,gender
RSウイルス感染症,2001,24,2001-W24,0,0,0,142,gender
咽頭結膜熱,2001,24,2001-W24,9,7,16,142,gender
Ａ群溶血性レンサ球菌咽頭炎,2001,24,2001-W24,31,24,55,142,gender
感染性胃腸炎,2001,24,2001-W24,188,160,348,142,gender
水痘,2001,24,2001-W24,72,57,129,142,gender
手足口病,2001,24,2001-W24,43,33,76,142,gender
突発性発しん,2001,24,2001-W24,28,23,51,142,gender
ヘルパンギーナ,2001,24,2001-W24,89,89,178,142,gender
流行性耳下腺炎,2001,24,2001-W24,76,69,145,142,gender
川崎病,2001,24,2001-W24,1,2,3,142,gender
インフルエンザ,2002,6,2002-W06,1135,1084,2219,178,gender
RSウイルス感染症,2002,6,2002-W06,0,0,0,142,gender
咽頭結膜熱,2002,6,2002-W06,4,9,13,142,gender
Ａ群溶血性レンサ球菌咽頭炎,2002,6,2002-W06,74,63,137,142,gender
感染性胃腸炎,2002,6,2002-W06,729,635,1364,142,gender
水痘,2002,6,2002-W06,76,63,139,142,gender
手足口病,2002,6,2002-W06,1,1,2,142,gender
突発性発しん,2002,6,2002-W06,38,22,60,142,gender
ヘルパンギーナ,2002,6,2002-W06,2,2,4,142,gender
流行性耳下腺炎,2002,6,2002-W06,40,33,73,142,gender
川崎病,2002,6,2002-W06,0,1,1,142,gender
インフルエンザ,2021,36,2021-W36,0,0,0,409,gender
RSウイルス感染症,2021,36,2021-W36,103,73,176,258,gender
咽頭結膜熱,2021,36,2021-W36,10,10,20,258,gender
Ａ群溶血性レンサ球菌咽頭炎,2021,36,2021-W36,23,21,44,258,gender
感染性胃腸炎,2021,36,2021-W36,339,259,598,258,gender
水痘,2021,36,2021-W36,7,13,20,258,gender
手足口病,2021,36,2021-W36,8,11,19,258,gender
突発性発しん,2021,36,2021-W36,58,41,99,258,gender
ヘルパンギーナ,2021,36,2021-W36,39,25,64,258,gender
流行性耳下腺炎,2021,36,2021-W36,11,6,17,258,gender
川崎病,2021,36,2021-W36,7,3,10,258,gender
インフルエンザ,2013,10,2013-W10,736,744,1480,417,gender
RSウイルス感染症,2013,10,2013-W10,22,13,35,264,gender
咽頭結膜熱,2013,10,2013-W10,40,35,75,264,gender
Ａ群溶血性レンサ球菌咽頭炎,2013,10,2013-W10,408,314,722,264,gender
感染性胃腸炎,2013,10,2013-W10,1600,1505,3105,264,gender
水痘,2013,10,2013-W10,112,88,200,264,gender
手足口病,2013,10,2013-W10,13,6,19,264,gender
突発性発しん,2013,10,2013-W10,76,82,158,264,gender
ヘルパンギーナ,2013,10,2013-W10,3,2,5,264,gender
流行性耳下腺炎,2013,10,2013-W10,34,34,68,264,gender
川崎病,2013,10,2013-W10,2,2,4,264,gender
インフルエンザ,2024,9,2024-W09,2817,2397,5214,416,gender
新型コロナウイルス感染症（COVID-19）,2024,9,2024-W09,928,1012,1940,416,gender
RSウイルス感染症,2024,9,2024-W09,34,22,56,262,gender
咽頭結膜熱,2024,9,2024-W09,38,48,86,262,gender
Ａ群溶血性レンサ球菌咽頭炎,2024,9,2024-W09,443,398,841,262,gender
感染性胃腸炎,2024,9,2024-W09,752,716,1468,262,gender
水痘,2024,9,2024-W09,33,16,49,262,gender
手足口病,2024,9,2024-W09,3,1,4,262,gender
突発性発しん,2024,9,2024-W09,24,29,53,262,gender
ヘルパンギーナ,2024,9,2024-W09,1,3,4,262,gender
流行性耳下腺炎,2024,9,2024-W09,9,5,14,262,gender
川崎病,2024,9,2024-W09,0,2,2,262,gender
インフルエンザ,2021,5,2021-W05,4,1,5,406,gender
RSウイルス感染症,2021,5,2021-W05,8,3,11,255,gender
咽頭結膜熱,2021,5,2021-W05,20,13,33,255,gender
Ａ群溶血性レンサ球菌咽頭炎,2021,5,2021-W05,57,31,88,255,gender
感染性胃腸炎,2021,5,2021-W05,406,367,773,255,gender
水痘,2021,5,2021-W05,9,6,15,255,gender
手足口病,2021,5,2021-W05,2,2,4,255,gender
突発性発しん,2021,5,2021-W05,46,55,101,255,gender
ヘルパンギーナ,2021,5,2021-W05,1,1,2,255,gender
流行性耳下腺炎,2021,5,2021-W05,4,6,10,255,gender
川崎病,2021,5,2021-W05,1,1,2,255,gender
インフルエンザ,2002,39,2002-W39,0,0,0,178,gender
RSウイルス感染症,2002,39,2002-W39,0,0,0,142,gender
咽頭結膜熱,2002,39,2002-W39,3,6,9,142,gender
Ａ群溶血性レンサ球菌咽頭炎,2002,39,2002-W39,12,17,29,142,gender
感染性胃腸炎,2002,39,2002-W39,166,132,298,142,gender
水痘,2002,39,2002-W39,27,21,48,142,gender
手足口病,2002,39,2002-W39,13,25,38,142,gender
突発性発しん,2002,39,2002-W39,36,38,74,142,gender
ヘルパンギーナ,2002,39,2002-W39,8,8,16,142,gender
流行性耳下腺炎,2002,39,2002-W39,28,22,50,142,gender
川崎病,2002,39,2002-W39,1,0,1,142,gender
インフルエンザ,2023,45,2023-W45,2577,2202,4779,417,gender
新型コロナウイルス感染症（COVID-19）,2023,45,2023-W45,235,266,501,417,gender
RSウイルス感染症,2023,45,2023-W45,4,2,6,262,gender
咽頭結膜熱,2023,45,2023-W45,470,442,912,262,gender
Ａ群溶血性レンサ球菌咽頭炎,2023,45,2023-W45,631,536,1167,262,gender
感染性胃腸炎,2023,45,2023-W45,591,541,1132,262,gender
水痘,2023,45,2023-W45,29,23,52,262,gender
手足口病,2023,45,2023-W45,95,76,171,262,gender
突発性発しん,2023,45,2023-W45,36,37,73,262,gender
ヘルパンギーナ,2023,45,2023-W45,13,14,27,262,gender
流行性耳下腺炎,2023,45,2023-W45,11,7,18,262,gender
川崎病,2023,45,2023-W45,5,2,7,262,gender
インフルエンザ,2009,8,2009-W08,1090,1093,2183,287,gender
RSウイルス感染症,2009,8,2009-W08,5,4,9,148,gender
咽頭結膜熱,2009,8,2009-W08,19,14,33,148,gender
Ａ群溶血性レンサ球菌咽頭炎,2009,8,2009-W08,153,121,274,148,gender
感染性胃腸炎,2009,8,2009-W08,525,515,1040,148,gender
水痘,2009,8,2009-W08,99,84,183,148,gender
手足口病,2009,8,2009-W08,1,5,6,148,gender
突発性発しん,2009,8,2009-W08,42,38,80,148,gender
ヘルパンギーナ,2009,8,2009-W08,2,0,2,148,gender
流行性耳下腺炎,2009,8,2009-W08,38,26,64,148,gender
川崎病,2009,8,2009-W08,1,0,1,148,gender
インフルエンザ,2015,17,2015-W17,274,254,528,416,gender
RSウイルス感染症,2015,17,2015-W17,28,13,41,262,gender
咽頭結膜熱,2015,17,2015-W17,46,54,100,262,gender
Ａ群溶血性レンサ球菌咽頭炎,2015,17,2015-W17,586,447,1033,262,gender
感染性胃腸炎,2015,17,2015-W17,1172,1037,2209,262,gender
水痘,2015,17,2015-W17,82,78,160,262,gender
手足口病,2015,17,2015-W17,41,17,58,262,gender
突発性発しん,2015,17,2015-W17,109,81,190,262,gender
ヘルパンギーナ,2015,17,2015-W17,6,6,12,262,gender
流行性耳下腺炎,2015,17,2015-W17,37,25,62,262,gender
川崎病,2015,17,2015-W17,2,1,3,262,gender
インフルエンザ,2018,47,2018-W47,107,101,208,417,gender
RSウイルス感染症,2018,47,2018-W47,32,34,66,262,gender
咽頭結膜熱,2018,47,2018-W47,60,43,103,262,gender
Ａ群溶血性レンサ球菌咽頭炎,2018,47,2018-W47,424,346,770,262,gender
感染性胃腸炎,2018,47,2018-W47,1080,933,2013,262,gender
水痘,2018,47,2018-W47,57,56,113,262,gender
手足口病,2018,47,2018-W47,169,134,303,262,gender
突発性発しん,2018,47,2018-W47,73,58,131,262,gender
ヘルパンギーナ,2018,47,2018-W47,12,13,25,262,gender
流行性耳下腺炎,2018,47,2018-W47,10,4,14,262,gender
川崎病,2018,47,2018-W47,4,0,4,262,gender
インフルエンザ,2007,23,2007-W23,6,2,8,287,gender
RSウイルス感染症,2007,23,2007-W23,7,5,12,149,gender
咽頭結膜熱,2007,23,2007-W23,81,60,141,149,gender
Ａ群溶血性レンサ球菌咽頭炎,2007,23,2007-W23,210,178,388,149,gender
感染性胃腸炎,2007,23,2007-W23,554,476,1030,149,gender
水痘,2007,23,2007-W23,123,123,246,149,gender
手足口病,2007,23,2007-W23,24,20,44,149,gender
突発性発しん,2007,23,2007-W23,62,64,126,149,gender
ヘルパンギーナ,2007,23,2007-W23,35,32,67,149,gender
流行性耳下腺炎,2007,23,2007-W23,31,26,57,149,gender
川崎病,2007,23,2007-W23,3,1,4,149,gender
インフルエンザ,2005,50,2005-W50,59,63,122,178,gender
RSウイルス感染症,2005,50,2005-W50,60,33,93,142,gender
咽頭結膜熱,2005,50,2005-W50,23,32,55,142,gender
Ａ群溶血性レンサ球菌咽頭炎,2005,50,2005-W50,197,152,349,142,gender
感染性胃腸炎,2005,50,2005-W50,1360,1374,2734,142,gender
水痘,2005,50,2005-W50,132,111,243,142,gender
手足口病,2005,50,2005-W50,4,11,15,142,gender
突発性発しん,2005,50,2005-W50,44,39,83,142,gender
ヘルパンギーナ,2005,50,2005-W50,6,7,13,142,gender
流行性耳下腺炎,2005,50,2005-W50,82,58,140,142,gender
川崎病,2005,50,2005-W50,2,0,2,142,gender
インフルエンザ,2019,29,2019-W29,21,15,36,411,gender
RSウイルス感染症,2019,29,2019-W29,116,93,209,262,gender
咽頭結膜熱,2019,29,2019-W29,64,46,110,262,gender
Ａ群溶血性レンサ球菌咽頭炎,2019,29,2019-W29,262,219,481,262,gender
感染性胃腸炎,2019,29,2019-W29,574,500,1074,262,gender
水痘,2019,29,2019-W29,42,49,91,262,gender
手足口病,2019,29,2019-W29,2159,1823,3982,262,gender
突発性発しん,2019,29,2019-W29,57,42,99,262,gender
ヘルパンギーナ,2019,29,2019-W29,530,495,1025,262,gender
流行性耳下腺炎,2019,29,2019-W29,17,10,27,262,gender
川崎病,2019,29,2019-W29,2,0,2,262,gender
インフルエンザ,2018,2,2018-W02,4761,4695,9456,414,gender
RSウイルス感染症,2018,2,2018-W02,28,23,51,261,gender
咽頭結膜熱,2018,2,2018-W02,33,39,72,261,gender
Ａ群溶血性レンサ球菌咽頭炎,2018,2,2018-W02,268,218,486,261,gender
感染性胃腸炎,2018,2,2018-W02,840,836,1676,261,gender
水痘,2018,2,2018-W02,50,60,110,261,gender
手足口病,2018,2,2018-W02,9,17,26,261,gender
突発性発しん,2018,2,2018-W02,61,60,121,261,gender
ヘルパンギーナ,2018,2,2018-W02,0,3,3,261,gender
流行性耳下腺炎,2018,2,2018-W02,8,10,18,261,gender
川崎病,2018,2,2018-W02,0,2,2,261,gender
インフルエンザ,2020,17,2020-W17,0,2,2,413,gender
RSウイルス感染症,2020,17,2020-W17,0,1,1,260,gender
咽頭結膜熱,2020,17,2020-W17,5,6,11,260,gender
Ａ群溶血性レンサ球菌咽頭炎,2020,17,2020-W17,43,47,90,260,gender
感染性胃腸炎,2020,17,2020-W17,119,123,242,260,gender
水痘,2020,17,2020-W17,8,12,20,260,gender
手足口病,2020,17,2020-W17,5,3,8,260,gender
突発性発しん,2020,17,2020-W17,39,29,68,260,gender
ヘルパンギーナ,2020,17,2020-W17,1,0,1,260,gender
流行性耳下腺炎,2020,17,2020-W17,5,4,9,260,gender
川崎病,2020,17,2020-W17,3,2,5,260,gender
インフルエンザ,2010,42,2010-W42,27,26,53,284,gender
RSウイルス感染症,2010,42,2010-W42,16,11,27,148,gender
咽頭結膜熱,2010,42,2010-W42,22,16,38,148,gender
Ａ群溶血性レンサ球菌咽頭炎,2010,42,2010-W42,89,75,164,148,gender
感染性胃腸炎,2010,42,2010-W42,330,315,645,148,gender
水痘,2010,42,2010-W42,43,44,87,148,gender
手足口病,2010,42,2010-W42,36,28,64,148,gender
突発性発しん,2010,42,2010-W42,55,36,91,148,gender
ヘルパンギーナ,2010,42,2010-W42,11,11,22,148,gender
流行性耳下腺炎,2010,42,2010-W42,32,38,70,148,gender
川崎病,2010,42,2010-W42,1,1,2,148,gender
インフルエンザ,2012,31,2012-W31,2,3,5,413,gender
RSウイルス感染症,2012,31,2012-W31,38,31,69,260,gender
咽頭結膜熱,2012,31,2012-W31,85,67,152,260,gender
Ａ群溶血性レンサ球菌咽頭炎,2012,31,2012-W31,154,133,287,260,gender
感染性胃腸炎,2012,31,2012-W31,536,446,982,260,gender
水痘,2012,31,2012-W31,72,57,129,260,gender
手足口病,2012,31,2012-W31,167,141,308,260,gender
突発性発しん,2012,31,2012-W31,112,85,197,260,gender
ヘルパンギーナ,2012,31,2012-W31,754,658,1412,260,gender
流行性耳下腺炎,2012,31,2012-W31,30,29,59,260,gender
川崎病,2012,31,2012-W31,0,0,0,260,gender
インフルエンザ,2003,18,2003-W18,0,0,0,178,gender
RSウイルス感染症,2003,18,2003-W18,0,0,0,142,gender
咽頭結膜熱,2003,18,2003-W18,9,8,17,142,gender
Ａ群溶血性レンサ球菌咽頭炎,2003,18,2003-W18,43,32,75,142,gender
感染性胃腸炎,2003,18,2003-W18,255,212,467,142,gender
水痘,2003,18,2003-W18,56,61,117,142,gender
手足口病,2003,18,2003-W18,10,7,17,142,gender
突発性発しん,2003,18,2003-W18,34,37,71,142,gender
ヘルパンギーナ,2003,18,2003-W18,4,3,7,142,gender
流行性耳下腺炎,2003,18,2003-W18,12,9,21,142,gender
川崎病,2003,18,2003-W18,0,0,0,142,gender
インフルエンザ,2016,45,2016-W45,203,187,390,414,gender
RSウイルス感染症,2016,45,2016-W45,91,51,142,261,gender
咽頭結膜熱,2016,45,2016-W45,34,27,61,261,gender
Ａ群溶血性レンサ球菌咽頭炎,2016,45,2016-W45,274,232,506,261,gender
感染性胃腸炎,2016,45,2016-W45,1946,1725,3671,261,gender
水痘,2016,45,2016-W45,66,62,128,261,gender
手足口病,2016,45,2016-W45,93,83,176,261,gender
突発性発しん,2016,45,2016-W45,64,52,116,261,gender
ヘルパンギーナ,2016,45,2016-W45,25,19,44,261,gender
流行性耳下腺炎,2016,45,2016-W45,126,110,236,261,gender
川崎病,2016,45,2016-W45,1,2,3,261,gender
インフルエンザ,2014,36,2014-W36,4,2,6,412,gender
RSウイルス感染症,2014,36,2014-W36,67,53,120,260,gender
咽頭結膜熱,2014,36,2014-W36,62,54,116,260,gender
Ａ群溶血性レンサ球菌咽頭炎,2014,36,2014-W36,146,122,268,260,gender
感染性胃腸炎,2014,36,2014-W36,522,438,960,260,gender
水痘,2014,36,2014-W36,37,40,77,260,gender
手足口病,2014,36,2014-W36,143,118,261,260,gender
突発性発しん,2014,36,2014-W36,93,94,187,260,gender
ヘルパンギーナ,2014,36,2014-W36,222,224,446,260,gender
流行性耳下腺炎,2014,36,2014-W36,40,32,72,260,gender
川崎病,2014,36,2014-W36,4,2,6,260,gender
インフルエンザ,2009,21,2009-W21,93,66,159,288,gender
RSウイルス感染症,2009,21,2009-W21,3,2,5,148,gender
咽頭結膜熱,2009,21,2009-W21,25,20,45,148,gender
Ａ群溶血性レンサ球菌咽頭炎,2009,21,2009-W21,159,139,298,148,gender
感染性胃腸炎,2009,21,2009-W21,439,391,830,148,gender
水痘,2009,21,2009-W21,106,86,192,148,gender
手足口病,2009,21,2009-W21,10,12,22,148,gender
突発性発しん,2009,21,2009-W21,54,57,111,148,gender
ヘルパンギーナ,2009,21,2009-W21,4,9,13,148,gender
流行性耳下腺炎,2009,21,2009-W21,75,61,136,148,gender
川崎病,2009,21,2009-W21,0,0,0,148,gender
インフルエンザ,2007,52,2007-W52,1154,1066,2220,288,gender
RSウイルス感染症,2007,52,2007-W52,49,34,83,150,gender
咽頭結膜熱,2007,52,2007-W52,20,19,39,150,gender
Ａ群溶血性レンサ球菌咽頭炎,2007,52,2007-W52,98,93,191,150,gender
感染性胃腸炎,2007,52,2007-W52,1054,997,2051,150,gender
水痘,2007,52,2007-W52,141,130,271,150,gender
手足口病,2007,52,2007-W52,15,11,26,150,gender
突発性発しん,2007,52,2007-W52,34,30,64,150,gender
ヘルパンギーナ,2007,52,2007-W52,2,0,2,150,gender
流行性耳下腺炎,2007,52,2007-W52,17,16,33,150,gender
川崎病,2007,52,2007-W52,1,0,1,150,gender
インフルエンザ,2005,21,2005-W21,11,18,29,178,gender
RSウイルス感染症,2005,21,2005-W21,3,2,5,142,gender
咽頭結膜熱,2005,21,2005-W21,21,23,44,142,gender
Ａ群溶血性レンサ球菌咽頭炎,2005,21,2005-W21,120,98,218,142,gender
感染性胃腸炎,2005,21,2005-W21,462,363,825,142,gender
水痘,2005,21,2005-W21,137,122,259,142,gender
手足口病,2005,21,2005-W21,15,16,31,142,gender
突発性発しん,2005,21,2005-W21,47,50,97,142,gender
ヘルパンギーナ,2005,21,2005-W21,30,38,68,142,gender
流行性耳下腺炎,2005,21,2005-W21,70,64,134,142,gender
川崎病,2005,21,2005-W21,2,0,2,142,gender
インフルエンザ,2017,15,2017-W15,849,867,1716,412,gender
RSウイルス感染症,2017,15,2017-W15,35,27,62,260,gender
咽頭結膜熱,2017,15,2017-W15,30,26,56,260,gender
Ａ群溶血性レンサ球菌咽頭炎,2017,15,2017-W15,300,259,559,260,gender
感染性胃腸炎,2017,15,2017-W15,1106,987,2093,260,gender
水痘,2017,15,2017-W15,51,38,89,260,gender
手足口病,2017,15,2017-W15,12,20,32,260,gender
突発性発しん,2017,15,2017-W15,55,54,109,260,gender
ヘルパンギーナ,2017,15,2017-W15,3,2,5,260,gender
流行性耳下腺炎,2017,15,2017-W15,29,25,54,260,gender
川崎病,2017,15,2017-W15,2,0,2,260,gender
インフルエンザ,2018,36,2018-W36,17,17,34,414,gender
RSウイルス感染症,2018,36,2018-W36,307,237,544,261,gender
咽頭結膜熱,2018,36,2018-W36,38,25,63,261,gender
Ａ群溶血性レンサ球菌咽頭炎,2018,36,2018-W36,232,169,401,261,gender
感染性胃腸炎,2018,36,2018-W36,611,503,1114,261,gender
水痘,2018,36,2018-W36,27,30,57,261,gender
手足口病,2018,36,2018-W36,171,127,298,261,gender
突発性発しん,2018,36,2018-W36,75,70,145,261,gender
ヘルパンギーナ,2018,36,2018-W36,163,148,311,261,gender
流行性耳下腺炎,2018,36,2018-W36,12,16,28,261,gender
川崎病,2018,36,2018-W36,2,3,5,261,gender
インフルエンザ,2021,47,2021-W47,0,0,0,413,gender
RSウイルス感染症,2021,47,2021-W47,3,3,6,261,gender
咽頭結膜熱,2021,47,2021-W47,19,10,29,261,gender
Ａ群溶血性レンサ球菌咽頭炎,2021,47,2021-W47,54,26,80,261,gender
感染性胃腸炎,2021,47,2021-W47,657,619,1276,261,gender
水痘,2021,47,2021-W47,25,7,32,261,gender
手足口病,2021,47,2021-W47,142,107,249,261,gender
突発性発しん,2021,47,2021-W47,52,32,84,261,gender
ヘルパンギーナ,2021,47,2021-W47,66,52,118,261,gender
流行性耳下腺炎,2021,47,2021-W47,3,5,8,261,gender
川崎病,2021,47,2021-W47,2,2,4,261,gender
インフルエンザ,2001,7,2001-W07,246,188,434,178,gender
RSウイルス感染症,2001,7,2001-W07,0,0,0,142,gender
咽頭結膜熱,2001,7,2001-W07,2,4,6,142,gender
Ａ群溶血性レンサ球菌咽頭炎,2001,7,2001-W07,26,21,47,142,gender
感染性胃腸炎,2001,7,2001-W07,580,523,1103,142,gender
水痘,2001,7,2001-W07,76,88,164,142,gender
手足口病,2001,7,2001-W07,6,4,10,142,gender
突発性発しん,2001,7,2001-W07,21,24,45,142,gender
ヘルパンギーナ,2001,7,2001-W07,3,1,4,142,gender
流行性耳下腺炎,2001,7,2001-W07,55,55,110,142,gender
川崎病,2001,7,2001-W07,1,0,1,142,gender
インフルエンザ,2011,12,2011-W12,2059,1978,4037,415,gender
RSウイルス感染症,2011,12,2011-W12,10,6,16,261,gender
咽頭結膜熱,2011,12,2011-W12,36,29,65,261,gender
Ａ群溶血性レンサ球菌咽頭炎,2011,12,2011-W12,249,194,443,261,gender
感染性胃腸炎,2011,12,2011-W12,729,618,1347,261,gender
水痘,2011,12,2011-W12,143,137,280,261,gender
手足口病,2011,12,2011-W12,4,1,5,261,gender
突発性発しん,2011,12,2011-W12,62,43,105,261,gender
ヘルパンギーナ,2011,12,2011-W12,0,2,2,261,gender
流行性耳下腺炎,2011,12,2011-W12,45,38,83,261,gender
川崎病,2011,12,2011-W12,1,1,2,261,gender
インフルエンザ,2002,48,2002-W48,15,9,24,178,gender
RSウイルス感染症,2002,48,2002-W48,0,0,0,142,gender
咽頭結膜熱,2002,48,2002-W48,7,5,12,142,gender
Ａ群溶血性レンサ球菌咽頭炎,2002,48,2002-W48,57,34,91,142,gender
感染性胃腸炎,2002,48,2002-W48,857,818,1675,142,gender
水痘,2002,48,2002-W48,105,92,197,142,gender
手足口病,2002,48,2002-W48,10,6,16,142,gender
突発性発しん,2002,48,2002-W48,22,37,59,142,gender
ヘルパンギーナ,2002,48,2002-W48,5,4,9,142,gender
流行性耳下腺炎,2002,48,2002-W48,20,24,44,142,gender
川崎病,2002,48,2002-W48,0,0,0,142,gender
インフルエンザ,2023,34,2023-W34,306,270,576,410,gender
新型コロナウイルス感染症（COVID-19）,2023,34,2023-W34,2844,3112,5956,410,gender
RSウイルス感染症,2023,34,2023-W34,45,40,85,255,gender
咽頭結膜熱,2023,34,2023-W34,134,88,222,255,gender
Ａ群溶血性レンサ球菌咽頭炎,2023,34,2023-W34,145,125,270,255,gender
感染性胃腸炎,2023,34,2023-W34,472,362,834,255,gender
水痘,2023,34,2023-W34,12,17,29,255,gender
手足口病,2023,34,2023-W34,114,92,206,255,gender
突発性発しん,2023,34,2023-W34,24,35,59,255,gender
ヘルパンギーナ,2023,34,2023-W34,95,86,181,255,gender
流行性耳下腺炎,2023,34,2023-W34,2,0,2,255,gender
川崎病,2023,34,2023-W34,1,2,3,255,gender
インフルエンザ,2020,29,2020-W29,0,0,0,414,gender
RSウイルス感染症,2020,29,2020-W29,1,0,1,260,gender
咽頭結膜熱,2020,29,2020-W29,13,6,19,260,gender
Ａ群溶血性レンサ球菌咽頭炎,2020,29,2020-W29,93,92,185,260,gender
感染性胃腸炎,2020,29,2020-W29,417,348,765,260,gender
水痘,2020,29,2020-W29,9,8,17,260,gender
手足口病,2020,29,2020-W29,17,16,33,260,gender
突発性発しん,2020,29,2020-W29,72,76,148,260,gender
ヘルパンギーナ,2020,29,2020-W29,19,32,51,260,gender
流行性耳下腺炎,2020,29,2020-W29,13,8,21,260,gender
川崎病,2020,29,2020-W29,1,2,3,260,gender
インフルエンザ,2022,4,2022-W04,2,2,4,407,gender
RSウイルス感染症,2022,4,2022-W04,3,1,4,255,gender
咽頭結膜熱,2022,4,2022-W04,3,11,14,255,gender
Ａ群溶血性レンサ球菌咽頭炎,2022,4,2022-W04,20,24,44,255,gender
感染性胃腸炎,2022,4,2022-W04,1099,1048,2147,255,gender
水痘,2022,4,2022-W04,8,6,14,255,gender
手足口病,2022,4,2022-W04,31,31,62,255,gender
突発性発しん,2022,4,2022-W04,38,35,73,255,gender
ヘルパンギーナ,2022,4,2022-W04,4,7,11,255,gender
流行性耳下腺炎,2022,4,2022-W04,6,2,8,255,gender
川崎病,2022,4,2022-W04,1,1,2,255,gender
インフルエンザ,2003,26,2003-W26,0,0,0,178,gender
RSウイルス感染症,2003,26,2003-W26,0,0,0,142,gender
咽頭結膜熱,2003,26,2003-W26,35,25,60,142,gender
Ａ群溶血性レンサ球菌咽頭炎,2003,26,2003-W26,59,61,120,142,gender
感染性胃腸炎,2003,26,2003-W26,188,166,354,142,gender
水痘,2003,26,2003-W26,103,80,183,142,gender
手足口病,2003,26,2003-W26,283,235,518,142,gender
突発性発しん,2003,26,2003-W26,52,38,90,142,gender
ヘルパンギーナ,2003,26,2003-W26,143,136,279,142,gender
流行性耳下腺炎,2003,26,2003-W26,18,23,41,142,gender
川崎病,2003,26,2003-W26,0,3,3,142,gender
インフルエンザ,2002,47,2002-W47,3,0,3,178,gender
RSウイルス感染症,2002,47,2002-W47,0,0,0,142,gender
咽頭結膜熱,2002,47,2002-W47,7,7,14,142,gender
Ａ群溶血性レンサ球菌咽頭炎,2002,47,2002-W47,32,36,68,142,gender
感染性胃腸炎,2002,47,2002-W47,632,553,1185,142,gender
水痘,2002,47,2002-W47,77,67,144,142,gender
手足口病,2002,47,2002-W47,15,12,27,142,gender
突発性発しん,2002,47,2002-W47,28,25,53,142,gender
ヘルパンギーナ,2002,47,2002-W47,6,8,14,142,gender
流行性耳下腺炎,2002,47,2002-W47,23,22,45,142,gender
川崎病,2002,47,2002-W47,0,0,0,142,gender
インフルエンザ,2004,4,2004-W04,1769,1702,3471,178,gender
RSウイルス感染症,2004,4,2004-W04,8,7,15,142,gender
咽頭結膜熱,2004,4,2004-W04,8,6,14,142,gender
Ａ群溶血性レンサ球菌咽頭炎,2004,4,2004-W04,74,53,127,142,gender
感染性胃腸炎,2004,4,2004-W04,513,496,1009,142,gender
水痘,2004,4,2004-W04,91,63,154,142,gender
手足口病,2004,4,2004-W04,2,3,5,142,gender
突発性発しん,2004,4,2004-W04,28,36,64,142,gender
ヘルパンギーナ,2004,4,2004-W04,0,0,0,142,gender
流行性耳下腺炎,2004,4,2004-W04,12,9,21,142,gender
川崎病,2004,4,2004-W04,0,1,1,142,gender
インフルエンザ,2000,34,2000-W34,0,0,0,178,gender
RSウイルス感染症,2000,34,2000-W34,0,0,0,142,gender
咽頭結膜熱,2000,34,2000-W34,7,9,16,142,gender
Ａ群溶血性レンサ球菌咽頭炎,2000,34,2000-W34,21,11,32,142,gender
感染性胃腸炎,2000,34,2000-W34,111,84,195,142,gender
水痘,2000,34,2000-W34,30,23,53,142,gender
手足口病,2000,34,2000-W34,87,78,165,142,gender
突発性発しん,2000,34,2000-W34,46,34,80,142,gender
ヘルパンギーナ,2000,34,2000-W34,63,67,130,142,gender
流行性耳下腺炎,2000,34,2000-W34,43,32,75,142,gender
川崎病,2000,34,2000-W34,0,0,0,142,gender
インフルエンザ,2021,48,2021-W48,0,0,0,410,gender
RSウイルス感染症,2021,48,2021-W48,3,2,5,259,gender
咽頭結膜熱,2021,48,2021-W48,25,15,40,259,gender
Ａ群溶血性レンサ球菌咽頭炎,2021,48,2021-W48,74,38,112,259,gender
感染性胃腸炎,2021,48,2021-W48,901,734,1635,259,gender
水痘,2021,48,2021-W48,13,11,24,259,gender
手足口病,2021,48,2021-W48,125,97,222,259,gender
突発性発しん,2021,48,2021-W48,41,38,79,259,gender
ヘルパンギーナ,2021,48,2021-W48,53,34,87,259,gender
流行性耳下腺炎,2021,48,2021-W48,5,2,7,259,gender
川崎病,2021,48,2021-W48,0,3,3,259,gender
インフルエンザ,2001,8,2001-W08,397,323,720,178,gender
RSウイルス感染症,2001,8,2001-W08,0,0,0,142,gender
咽頭結膜熱,2001,8,2001-W08,2,1,3,142,gender
Ａ群溶血性レンサ球菌咽頭炎,2001,8,2001-W08,44,36,80,142,gender
感染性胃腸炎,2001,8,2001-W08,606,622,1228,142,gender
水痘,2001,8,2001-W08,84,90,174,142,gender
手足口病,2001,8,2001-W08,6,7,13,142,gender
突発性発しん,2001,8,2001-W08,35,42,77,142,gender
ヘルパンギーナ,2001,8,2001-W08,4,3,7,142,gender
流行性耳下腺炎,2001,8,2001-W08,84,64,148,142,gender
川崎病,2001,8,2001-W08,0,0,0,142,gender
インフルエンザ,2003,29,2003-W29,0,0,0,178,gender
RSウイルス感染症,2003,29,2003-W29,0,0,0,142,gender
咽頭結膜熱,2003,29,2003-W29,43,38,81,142,gender
Ａ群溶血性レンサ球菌咽頭炎,2003,29,2003-W29,26,38,64,142,gender
感染性胃腸炎,2003,29,2003-W29,180,137,317,142,gender
水痘,2003,29,2003-W29,34,38,72,142,gender
手足口病,2003,29,2003-W29,467,375,842,142,gender
突発性発しん,2003,29,2003-W29,51,36,87,142,gender
ヘルパンギーナ,2003,29,2003-W29,387,393,780,142,gender
流行性耳下腺炎,2003,29,2003-W29,21,9,30,142,gender
川崎病,2003,29,2003-W29,0,0,0,142,gender
インフルエンザ,2020,26,2020-W26,0,0,0,414,gender
RSウイルス感染症,2020,26,2020-W26,0,0,0,261,gender
咽頭結膜熱,2020,26,2020-W26,12,4,16,261,gender
Ａ群溶血性レンサ球菌咽頭炎,2020,26,2020-W26,62,44,106,261,gender
感染性胃腸炎,2020,26,2020-W26,316,258,574,261,gender
水痘,2020,26,2020-W26,5,5,10,261,gender
手足口病,2020,26,2020-W26,15,12,27,261,gender
突発性発しん,2020,26,2020-W26,76,55,131,261,gender
ヘルパンギーナ,2020,26,2020-W26,10,9,19,261,gender
流行性耳下腺炎,2020,26,2020-W26,17,11,28,261,gender
川崎病,2020,26,2020-W26,2,1,3,261,gender
インフルエンザ,2024,52,2024-W52,11961,11664,23625,418,gender
新型コロナウイルス感染症（COVID-19）,2024,52,2024-W52,850,959,1809,418,gender
RSウイルス感染症,2024,52,2024-W52,55,50,105,264,gender
咽頭結膜熱,2024,52,2024-W52,30,35,65,264,gender
Ａ群溶血性レンサ球菌咽頭炎,2024,52,2024-W52,361,298,659,264,gender
感染性胃腸炎,2024,52,2024-W52,900,847,1747,264,gender
水痘,2024,52,2024-W52,56,41,97,264,gender
手足口病,2024,52,2024-W52,65,50,115,264,gender
突発性発しん,2024,52,2024-W52,20,23,43,264,gender
ヘルパンギーナ,2024,52,2024-W52,2,1,3,264,gender
流行性耳下腺炎,2024,52,2024-W52,4,7,11,264,gender
川崎病,2024,52,2024-W52,2,2,4,264,gender
インフルエンザ,2018,39,2018-W39,43,28,71,413,gender
RSウイルス感染症,2018,39,2018-W39,180,146,326,259,gender
咽頭結膜熱,2018,39,2018-W39,23,28,51,259,gender
Ａ群溶血性レンサ球菌咽頭炎,2018,39,2018-W39,202,172,374,259,gender
感染性胃腸炎,2018,39,2018-W39,477,414,891,259,gender
水痘,2018,39,2018-W39,33,24,57,259,gender
手足口病,2018,39,2018-W39,156,152,308,259,gender
突発性発しん,2018,39,2018-W39,67,51,118,259,gender
ヘルパンギーナ,2018,39,2018-W39,93,72,165,259,gender
流行性耳下腺炎,2018,39,2018-W39,16,11,27,259,gender
川崎病,2018,39,2018-W39,1,3,4,259,gender
インフルエンザ,2009,10,2009-W10,1679,1649,3328,287,gender
RSウイルス感染症,2009,10,2009-W10,7,1,8,149,gender
咽頭結膜熱,2009,10,2009-W10,10,17,27,149,gender
Ａ群溶血性レンサ球菌咽頭炎,2009,10,2009-W10,192,180,372,149,gender
感染性胃腸炎,2009,10,2009-W10,566,536,1102,149,gender
水痘,2009,10,2009-W10,93,88,181,149,gender
手足口病,2009,10,2009-W10,7,1,8,149,gender
突発性発しん,2009,10,2009-W10,32,32,64,149,gender
ヘルパンギーナ,2009,10,2009-W10,1,0,1,149,gender
流行性耳下腺炎,2009,10,2009-W10,36,37,73,149,gender
川崎病,2009,10,2009-W10,1,0,1,149,gender
インフルエンザ,2004,40,2004-W40,0,0,0,178,gender
RSウイルス感染症,2004,40,2004-W40,10,10,20,142,gender
咽頭結膜熱,2004,40,2004-W40,8,11,19,142,gender
Ａ群溶血性レンサ球菌咽頭炎,2004,40,2004-W40,34,20,54,142,gender
感染性胃腸炎,2004,40,2004-W40,140,131,271,142,gender
水痘,2004,40,2004-W40,25,20,45,142,gender
手足口病,2004,40,2004-W40,40,31,71,142,gender
突発性発しん,2004,40,2004-W40,55,37,92,142,gender
ヘルパンギーナ,2004,40,2004-W40,15,16,31,142,gender
流行性耳下腺炎,2004,40,2004-W40,45,38,83,142,gender
川崎病,2004,40,2004-W40,2,1,3,142,gender
インフルエンザ,2006,33,2006-W33,0,0,0,178,gender
RSウイルス感染症,2006,33,2006-W33,1,0,1,142,gender
咽頭結膜熱,2006,33,2006-W33,29,20,49,142,gender
Ａ群溶血性レンサ球菌咽頭炎,2006,33,2006-W33,20,25,45,142,gender
感染性胃腸炎,2006,33,2006-W33,131,110,241,142,gender
水痘,2006,33,2006-W33,24,23,47,142,gender
手足口病,2006,33,2006-W33,43,36,79,142,gender
突発性発しん,2006,33,2006-W33,35,25,60,142,gender
ヘルパンギーナ,2006,33,2006-W33,23,30,53,142,gender
流行性耳下腺炎,2006,33,2006-W33,36,36,72,142,gender
川崎病,2006,33,2006-W33,1,0,1,142,gender
インフルエンザ,2014,39,2014-W39,22,15,37,408,gender
RSウイルス感染症,2014,39,2014-W39,108,86,194,261,gender
咽頭結膜熱,2014,39,2014-W39,46,42,88,261,gender
Ａ群溶血性レンサ球菌咽頭炎,2014,39,2014-W39,182,156,338,261,gender
感染性胃腸炎,2014,39,2014-W39,448,392,840,261,gender
水痘,2014,39,2014-W39,63,65,128,261,gender
手足口病,2014,39,2014-W39,92,68,160,261,gender
突発性発しん,2014,39,2014-W39,79,78,157,261,gender
ヘルパンギーナ,2014,39,2014-W39,65,93,158,261,gender
流行性耳下腺炎,2014,39,2014-W39,37,36,73,261,gender
川崎病,2014,39,2014-W39,1,2,3,261,gender
インフルエンザ,2008,40,2008-W40,3,2,5,286,gender
RSウイルス感染症,2008,40,2008-W40,48,26,74,147,gender
咽頭結膜熱,2008,40,2008-W40,13,6,19,147,gender
Ａ群溶血性レンサ球菌咽頭炎,2008,40,2008-W40,88,72,160,147,gender
感染性胃腸炎,2008,40,2008-W40,271,230,501,147,gender
水痘,2008,40,2008-W40,37,21,58,147,gender
手足口病,2008,40,2008-W40,104,72,176,147,gender
突発性発しん,2008,40,2008-W40,42,49,91,147,gender
ヘルパンギーナ,2008,40,2008-W40,36,24,60,147,gender
流行性耳下腺炎,2008,40,2008-W40,39,35,74,147,gender
川崎病,2008,40,2008-W40,1,1,2,147,gender
インフルエンザ,2005,10,2005-W10,1728,1803,3531,178,gender
RSウイルス感染症,2005,10,2005-W10,3,3,6,142,gender
咽頭結膜熱,2005,10,2005-W10,7,10,17,142,gender
Ａ群溶血性レンサ球菌咽頭炎,2005,10,2005-W10,56,55,111,142,gender
感染性胃腸炎,2005,10,2005-W10,450,419,869,142,gender
水痘,2005,10,2005-W10,84,85,169,142,gender
手足口病,2005,10,2005-W10,4,5,9,142,gender
突発性発しん,2005,10,2005-W10,28,31,59,142,gender
ヘルパンギーナ,2005,10,2005-W10,2,2,4,142,gender
流行性耳下腺炎,2005,10,2005-W10,60,40,100,142,gender
川崎病,2005,10,2005-W10,0,1,1,142,gender
インフルエンザ,2013,3,2013-W03,5070,4926,9996,417,gender
RSウイルス感染症,2013,3,2013-W03,31,26,57,263,gender
咽頭結膜熱,2013,3,2013-W03,31,30,61,263,gender
Ａ群溶血性レンサ球菌咽頭炎,2013,3,2013-W03,231,205,436,263,gender
感染性胃腸炎,2013,3,2013-W03,1030,890,1920,263,gender
水痘,2013,3,2013-W03,109,100,209,263,gender
手足口病,2013,3,2013-W03,18,12,30,263,gender
突発性発しん,2013,3,2013-W03,67,58,125,263,gender
ヘルパンギーナ,2013,3,2013-W03,1,3,4,263,gender
流行性耳下腺炎,2013,3,2013-W03,20,19,39,263,gender
川崎病,2013,3,2013-W03,2,1,3,263,gender
インフルエンザ,2017,24,2017-W24,11,16,27,414,gender
RSウイルス感染症,2017,24,2017-W24,30,32,62,263,gender
咽頭結膜熱,2017,24,2017-W24,155,134,289,263,gender
Ａ群溶血性レンサ球菌咽頭炎,2017,24,2017-W24,508,450,958,263,gender
感染性胃腸炎,2017,24,2017-W24,1032,888,1920,263,gender
水痘,2017,24,2017-W24,65,53,118,263,gender
手足口病,2017,24,2017-W24,222,140,362,263,gender
突発性発しん,2017,24,2017-W24,92,82,174,263,gender
ヘルパンギーナ,2017,24,2017-W24,35,48,83,263,gender
流行性耳下腺炎,2017,24,2017-W24,40,23,63,263,gender
川崎病,2017,24,2017-W24,1,0,1,263,gender
インフルエンザ,2013,50,2013-W50,141,162,303,415,gender
RSウイルス感染症,2013,50,2013-W50,116,98,214,262,gender
咽頭結膜熱,2013,50,2013-W50,86,71,157,262,gender
Ａ群溶血性レンサ球菌咽頭炎,2013,50,2013-W50,353,318,671,262,gender
感染性胃腸炎,2013,50,2013-W50,3558,3381,6939,262,gender
水痘,2013,50,2013-W50,200,200,400,262,gender
手足口病,2013,50,2013-W50,30,26,56,262,gender
突発性発しん,2013,50,2013-W50,58,76,134,262,gender
ヘルパンギーナ,2013,50,2013-W50,4,5,9,262,gender
流行性耳下腺炎,2013,50,2013-W50,22,22,44,262,gender
川崎病,2013,50,2013-W50,1,3,4,262,gender
インフルエンザ,2011,23,2011-W23,21,13,34,414,gender
RSウイルス感染症,2011,23,2011-W23,11,6,17,259,gender
咽頭結膜熱,2011,23,2011-W23,97,88,185,259,gender
Ａ群溶血性レンサ球菌咽頭炎,2011,23,2011-W23,504,382,886,259,gender
感染性胃腸炎,2011,23,2011-W23,1003,876,1879,259,gender
水痘,2011,23,2011-W23,225,217,442,259,gender
手足口病,2011,23,2011-W23,78,66,144,259,gender
突発性発しん,2011,23,2011-W23,97,81,178,259,gender
ヘルパンギーナ,2011,23,2011-W23,28,37,65,259,gender
流行性耳下腺炎,2011,23,2011-W23,72,45,117,259,gender
川崎病,2011,23,2011-W23,0,4,4,259,gender
インフルエンザ,2003,17,2003-W17,4,3,7,178,gender
RSウイルス感染症,2003,17,2003-W17,0,0,0,142,gender
咽頭結膜熱,2003,17,2003-W17,2,4,6,142,gender
Ａ群溶血性レンサ球菌咽頭炎,2003,17,2003-W17,69,42,111,142,gender
感染性胃腸炎,2003,17,2003-W17,331,263,594,142,gender
水痘,2003,17,2003-W17,96,56,152,142,gender
手足口病,2003,17,2003-W17,16,9,25,142,gender
突発性発しん,2003,17,2003-W17,38,54,92,142,gender
ヘルパンギーナ,2003,17,2003-W17,3,2,5,142,gender
流行性耳下腺炎,2003,17,2003-W17,15,9,24,142,gender
川崎病,2003,17,2003-W17,0,1,1,142,gender
インフルエンザ,2020,18,2020-W18,0,0,0,402,gender
RSウイルス感染症,2020,18,2020-W18,1,0,1,254,gender
咽頭結膜熱,2020,18,2020-W18,6,0,6,254,gender
Ａ群溶血性レンサ球菌咽頭炎,2020,18,2020-W18,51,43,94,254,gender
感染性胃腸炎,2020,18,2020-W18,128,99,227,254,gender
水痘,2020,18,2020-W18,7,5,12,254,gender
手足口病,2020,18,2020-W18,2,4,6,254,gender
突発性発しん,2020,18,2020-W18,41,32,73,254,gender
ヘルパンギーナ,2020,18,2020-W18,3,2,5,254,gender
流行性耳下腺炎,2020,18,2020-W18,6,4,10,254,gender
川崎病,2020,18,2020-W18,1,0,1,254,gender
インフルエンザ,2018,48,2018-W48,201,191,392,418,gender
RSウイルス感染症,2018,48,2018-W48,37,34,71,263,gender
咽頭結膜熱,2018,48,2018-W48,58,56,114,263,gender
Ａ群溶血性レンサ球菌咽頭炎,2018,48,2018-W48,448,403,851,263,gender
感染性胃腸炎,2018,48,2018-W48,1445,1393,2838,263,gender
水痘,2018,48,2018-W48,103,97,200,263,gender
手足口病,2018,48,2018-W48,160,136,296,263,gender
突発性発しん,2018,48,2018-W48,71,67,138,263,gender
ヘルパンギーナ,2018,48,2018-W48,9,9,18,263,gender
流行性耳下腺炎,2018,48,2018-W48,15,12,27,263,gender
川崎病,2018,48,2018-W48,2,1,3,263,gender
インフルエンザ,2015,18,2015-W18,105,97,202,404,gender
RSウイルス感染症,2015,18,2015-W18,12,7,19,255,gender
咽頭結膜熱,2015,18,2015-W18,78,55,133,255,gender
Ａ群溶血性レンサ球菌咽頭炎,2015,18,2015-W18,500,448,948,255,gender
感染性胃腸炎,2015,18,2015-W18,988,837,1825,255,gender
水痘,2015,18,2015-W18,92,70,162,255,gender
手足口病,2015,18,2015-W18,42,33,75,255,gender
突発性発しん,2015,18,2015-W18,106,83,189,255,gender
ヘルパンギーナ,2015,18,2015-W18,13,5,18,255,gender
流行性耳下腺炎,2015,18,2015-W18,49,55,104,255,gender
川崎病,2015,18,2015-W18,1,2,3,255,gender
インフルエンザ,2004,31,2004-W31,0,0,0,178,gender
RSウイルス感染症,2004,31,2004-W31,5,2,7,142,gender
咽頭結膜熱,2004,31,2004-W31,59,46,105,142,gender
Ａ群溶血性レンサ球菌咽頭炎,2004,31,2004-W31,29,16,45,142,gender
感染性胃腸炎,2004,31,2004-W31,179,162,341,142,gender
水痘,2004,31,2004-W31,33,28,61,142,gender
手足口病,2004,31,2004-W31,81,68,149,142,gender
突発性発しん,2004,31,2004-W31,56,46,102,142,gender
ヘルパンギーナ,2004,31,2004-W31,185,171,356,142,gender
流行性耳下腺炎,2004,31,2004-W31,40,35,75,142,gender
川崎病,2004,31,2004-W31,1,1,2,142,gender
インフルエンザ,2009,7,2009-W07,1521,1492,3013,287,gender
RSウイルス感染症,2009,7,2009-W07,5,1,6,149,gender
咽頭結膜熱,2009,7,2009-W07,22,10,32,149,gender
Ａ群溶血性レンサ球菌咽頭炎,2009,7,2009-W07,149,142,291,149,gender
感染性胃腸炎,2009,7,2009-W07,465,448,913,149,gender
水痘,2009,7,2009-W07,91,85,176,149,gender
手足口病,2009,7,2009-W07,4,3,7,149,gender
突発性発しん,2009,7,2009-W07,29,26,55,149,gender
ヘルパンギーナ,2009,7,2009-W07,2,1,3,149,gender
流行性耳下腺炎,2009,7,2009-W07,35,27,62,149,gender
川崎病,2009,7,2009-W07,2,1,3,149,gender
インフルエンザ,2006,42,2006-W42,0,0,0,178,gender
RSウイルス感染症,2006,42,2006-W42,2,2,4,142,gender
咽頭結膜熱,2006,42,2006-W42,14,10,24,142,gender
Ａ群溶血性レンサ球菌咽頭炎,2006,42,2006-W42,98,85,183,142,gender
感染性胃腸炎,2006,42,2006-W42,321,288,609,142,gender
水痘,2006,42,2006-W42,38,35,73,142,gender
手足口病,2006,42,2006-W42,49,43,92,142,gender
突発性発しん,2006,42,2006-W42,32,37,69,142,gender
ヘルパンギーナ,2006,42,2006-W42,10,12,22,142,gender
流行性耳下腺炎,2006,42,2006-W42,50,47,97,142,gender
川崎病,2006,42,2006-W42,1,0,1,142,gender
インフルエンザ,2019,26,2019-W26,14,17,31,412,gender
RSウイルス感染症,2019,26,2019-W26,61,36,97,260,gender
咽頭結膜熱,2019,26,2019-W26,80,69,149,260,gender
Ａ群溶血性レンサ球菌咽頭炎,2019,26,2019-W26,355,314,669,260,gender
感染性胃腸炎,2019,26,2019-W26,828,716,1544,260,gender
水痘,2019,26,2019-W26,100,85,185,260,gender
手足口病,2019,26,2019-W26,722,603,1325,260,gender
突発性発しん,2019,26,2019-W26,59,76,135,260,gender
ヘルパンギーナ,2019,26,2019-W26,177,180,357,260,gender
流行性耳下腺炎,2019,26,2019-W26,22,18,40,260,gender
川崎病,2019,26,2019-W26,3,1,4,260,gender
インフルエンザ,2024,23,2024-W23,21,40,61,419,gender
新型コロナウイルス感染症（COVID-19）,2024,23,2024-W23,807,901,1708,419,gender
RSウイルス感染症,2024,23,2024-W23,136,110,246,264,gender
咽頭結膜熱,2024,23,2024-W23,71,63,134,264,gender
Ａ群溶血性レンサ球菌咽頭炎,2024,23,2024-W23,586,458,1044,264,gender
感染性胃腸炎,2024,23,2024-W23,687,597,1284,264,gender
水痘,2024,23,2024-W23,44,38,82,264,gender
手足口病,2024,23,2024-W23,394,348,742,264,gender
突発性発しん,2024,23,2024-W23,56,44,100,264,gender
ヘルパンギーナ,2024,23,2024-W23,96,77,173,264,gender
流行性耳下腺炎,2024,23,2024-W23,22,16,38,264,gender
川崎病,2024,23,2024-W23,1,0,1,264,gender
インフルエンザ,2022,24,2022-W24,0,0,0,409,gender
RSウイルス感染症,2022,24,2022-W24,34,35,69,256,gender
咽頭結膜熱,2022,24,2022-W24,46,38,84,256,gender
Ａ群溶血性レンサ球菌咽頭炎,2022,24,2022-W24,22,26,48,256,gender
感染性胃腸炎,2022,24,2022-W24,1037,881,1918,256,gender
水痘,2022,24,2022-W24,9,7,16,256,gender
手足口病,2022,24,2022-W24,52,42,94,256,gender
突発性発しん,2022,24,2022-W24,52,56,108,256,gender
ヘルパンギーナ,2022,24,2022-W24,15,12,27,256,gender
流行性耳下腺炎,2022,24,2022-W24,11,1,12,256,gender
川崎病,2022,24,2022-W24,0,3,3,256,gender
インフルエンザ,2002,9,2002-W09,998,923,1921,178,gender
RSウイルス感染症,2002,9,2002-W09,0,0,0,142,gender
咽頭結膜熱,2002,9,2002-W09,8,6,14,142,gender
Ａ群溶血性レンサ球菌咽頭炎,2002,9,2002-W09,45,37,82,142,gender
感染性胃腸炎,2002,9,2002-W09,547,515,1062,142,gender
水痘,2002,9,2002-W09,65,70,135,142,gender
手足口病,2002,9,2002-W09,3,3,6,142,gender
突発性発しん,2002,9,2002-W09,23,26,49,142,gender
ヘルパンギーナ,2002,9,2002-W09,1,0,1,142,gender
流行性耳下腺炎,2002,9,2002-W09,48,32,80,142,gender
川崎病,2002,9,2002-W09,1,1,2,142,gender
インフルエンザ,2007,5,2007-W05,671,573,1244,277,gender
RSウイルス感染症,2007,5,2007-W05,21,28,49,139,gender
咽頭結膜熱,2007,5,2007-W05,12,15,27,139,gender
Ａ群溶血性レンサ球菌咽頭炎,2007,5,2007-W05,137,140,277,139,gender
感染性胃腸炎,2007,5,2007-W05,445,472,917,139,gender
水痘,2007,5,2007-W05,117,100,217,139,gender
手足口病,2007,5,2007-W05,10,10,20,139,gender
突発性発しん,2007,5,2007-W05,32,46,78,139,gender
ヘルパンギーナ,2007,5,2007-W05,1,3,4,139,gender
流行性耳下腺炎,2007,5,2007-W05,21,23,44,139,gender
川崎病,2007,5,2007-W05,0,1,1,139,gender
インフルエンザ,2002,36,2002-W36,0,0,0,178,gender
RSウイルス感染症,2002,36,2002-W36,0,0,0,142,gender
咽頭結膜熱,2002,36,2002-W36,10,5,15,142,gender
Ａ群溶血性レンサ球菌咽頭炎,2002,36,2002-W36,11,21,32,142,gender
感染性胃腸炎,2002,36,2002-W36,157,96,253,142,gender
水痘,2002,36,2002-W36,29,24,53,142,gender
手足口病,2002,36,2002-W36,30,20,50,142,gender
突発性発しん,2002,36,2002-W36,41,40,81,142,gender
ヘルパンギーナ,2002,36,2002-W36,32,29,61,142,gender
流行性耳下腺炎,2002,36,2002-W36,30,17,47,142,gender
川崎病,2002,36,2002-W36,0,2,2,142,gender
インフルエンザ,2024,6,2024-W06,5323,4152,9475,415,gender
新型コロナウイルス感染症（COVID-19）,2024,6,2024-W06,1845,2042,3887,415,gender
RSウイルス感染症,2024,6,2024-W06,10,10,20,262,gender
咽頭結膜熱,2024,6,2024-W06,49,44,93,262,gender
Ａ群溶血性レンサ球菌咽頭炎,2024,6,2024-W06,605,469,1074,262,gender
感染性胃腸炎,2024,6,2024-W06,1096,1017,2113,262,gender
水痘,2024,6,2024-W06,31,22,53,262,gender
手足口病,2024,6,2024-W06,11,10,21,262,gender
突発性発しん,2024,6,2024-W06,19,24,43,262,gender
ヘルパンギーナ,2024,6,2024-W06,0,1,1,262,gender
流行性耳下腺炎,2024,6,2024-W06,6,7,13,262,gender
川崎病,2024,6,2024-W06,2,1,3,262,gender
インフルエンザ,2000,45,2000-W45,8,6,14,178,gender
RSウイルス感染症,2000,45,2000-W45,0,0,0,142,gender
咽頭結膜熱,2000,45,2000-W45,3,7,10,142,gender
Ａ群溶血性レンサ球菌咽頭炎,2000,45,2000-W45,37,24,61,142,gender
感染性胃腸炎,2000,45,2000-W45,195,203,398,142,gender
水痘,2000,45,2000-W45,51,47,98,142,gender
手足口病,2000,45,2000-W45,64,41,105,142,gender
突発性発しん,2000,45,2000-W45,31,24,55,142,gender
ヘルパンギーナ,2000,45,2000-W45,11,6,17,142,gender
流行性耳下腺炎,2000,45,2000-W45,79,66,145,142,gender
川崎病,2000,45,2000-W45,0,0,0,142,gender
インフルエンザ,2021,39,2021-W39,0,0,0,412,gender
RSウイルス感染症,2021,39,2021-W39,23,14,37,262,gender
咽頭結膜熱,2021,39,2021-W39,8,4,12,262,gender
Ａ群溶血性レンサ球菌咽頭炎,2021,39,2021-W39,34,27,61,262,gender
感染性胃腸炎,2021,39,2021-W39,311,293,604,262,gender
水痘,2021,39,2021-W39,12,14,26,262,gender
手足口病,2021,39,2021-W39,33,17,50,262,gender
突発性発しん,2021,39,2021-W39,58,40,98,262,gender
ヘルパンギーナ,2021,39,2021-W39,47,70,117,262,gender
流行性耳下腺炎,2021,39,2021-W39,8,3,11,262,gender
川崎病,2021,39,2021-W39,1,0,1,262,gender
インフルエンザ,2001,15,2001-W15,59,67,126,178,gender
RSウイルス感染症,2001,15,2001-W15,0,0,0,142,gender
咽頭結膜熱,2001,15,2001-W15,4,5,9,142,gender
Ａ群溶血性レンサ球菌咽頭炎,2001,15,2001-W15,28,26,54,142,gender
感染性胃腸炎,2001,15,2001-W15,284,249,533,142,gender
水痘,2001,15,2001-W15,90,89,179,142,gender
手足口病,2001,15,2001-W15,9,8,17,142,gender
突発性発しん,2001,15,2001-W15,36,30,66,142,gender
ヘルパンギーナ,2001,15,2001-W15,6,2,8,142,gender
流行性耳下腺炎,2001,15,2001-W15,62,55,117,142,gender
川崎病,2001,15,2001-W15,4,0,4,142,gender
インフルエンザ,2013,21,2013-W21,103,98,201,414,gender
RSウイルス感染症,2013,21,2013-W21,21,16,37,261,gender
咽頭結膜熱,2013,21,2013-W21,107,96,203,261,gender
Ａ群溶血性レンサ球菌咽頭炎,2013,21,2013-W21,411,356,767,261,gender
感染性胃腸炎,2013,21,2013-W21,1000,906,1906,261,gender
水痘,2013,21,2013-W21,175,167,342,261,gender
手足口病,2013,21,2013-W21,66,52,118,261,gender
突発性発しん,2013,21,2013-W21,110,104,214,261,gender
ヘルパンギーナ,2013,21,2013-W21,19,16,35,261,gender
流行性耳下腺炎,2013,21,2013-W21,34,27,61,261,gender
川崎病,2013,21,2013-W21,4,3,7,261,gender
インフルエンザ,2011,52,2011-W52,168,156,324,397,gender
RSウイルス感染症,2011,52,2011-W52,75,43,118,251,gender
咽頭結膜熱,2011,52,2011-W52,42,43,85,251,gender
Ａ群溶血性レンサ球菌咽頭炎,2011,52,2011-W52,181,172,353,251,gender
感染性胃腸炎,2011,52,2011-W52,1774,1704,3478,251,gender
水痘,2011,52,2011-W52,264,250,514,251,gender
手足口病,2011,52,2011-W52,9,12,21,251,gender
突発性発しん,2011,52,2011-W52,53,47,100,251,gender
ヘルパンギーナ,2011,52,2011-W52,2,1,3,251,gender
流行性耳下腺炎,2011,52,2011-W52,22,30,52,251,gender
川崎病,2011,52,2011-W52,3,0,3,251,gender
インフルエンザ,2015,26,2015-W26,8,5,13,414,gender
RSウイルス感染症,2015,26,2015-W26,6,3,9,261,gender
咽頭結膜熱,2015,26,2015-W26,90,98,188,261,gender
Ａ群溶血性レンサ球菌咽頭炎,2015,26,2015-W26,526,442,968,261,gender
感染性胃腸炎,2015,26,2015-W26,906,773,1679,261,gender
水痘,2015,26,2015-W26,79,69,148,261,gender
手足口病,2015,26,2015-W26,633,525,1158,261,gender
突発性発しん,2015,26,2015-W26,120,108,228,261,gender
ヘルパンギーナ,2015,26,2015-W26,147,122,269,261,gender
流行性耳下腺炎,2015,26,2015-W26,35,46,81,261,gender
川崎病,2015,26,2015-W26,1,3,4,261,gender
インフルエンザ,2010,2,2010-W02,712,676,1388,286,gender
RSウイルス感染症,2010,2,2010-W02,35,34,69,148,gender
咽頭結膜熱,2010,2,2010-W02,6,6,12,148,gender
Ａ群溶血性レンサ球菌咽頭炎,2010,2,2010-W02,84,99,183,148,gender
感染性胃腸炎,2010,2,2010-W02,937,881,1818,148,gender
水痘,2010,2,2010-W02,76,66,142,148,gender
手足口病,2010,2,2010-W02,4,6,10,148,gender
突発性発しん,2010,2,2010-W02,34,33,67,148,gender
ヘルパンギーナ,2010,2,2010-W02,1,2,3,148,gender
流行性耳下腺炎,2010,2,2010-W02,46,45,91,148,gender
川崎病,2010,2,2010-W02,1,0,1,148,gender
インフルエンザ,2019,18,2019-W18,117,112,229,338,gender
RSウイルス感染症,2019,18,2019-W18,12,18,30,205,gender
咽頭結膜熱,2019,18,2019-W18,5,11,16,205,gender
Ａ群溶血性レンサ球菌咽頭炎,2019,18,2019-W18,96,67,163,205,gender
感染性胃腸炎,2019,18,2019-W18,268,202,470,205,gender
水痘,2019,18,2019-W18,17,9,26,205,gender
手足口病,2019,18,2019-W18,5,7,12,205,gender
突発性発しん,2019,18,2019-W18,23,21,44,205,gender
ヘルパンギーナ,2019,18,2019-W18,1,0,1,205,gender
流行性耳下腺炎,2019,18,2019-W18,6,2,8,205,gender
川崎病,2019,18,2019-W18,1,0,1,205,gender
インフルエンザ,2014,48,2014-W48,825,672,1497,414,gender
RSウイルス感染症,2014,48,2014-W48,187,153,340,263,gender
咽頭結膜熱,2014,48,2014-W48,52,61,113,263,gender
Ａ群溶血性レンサ球菌咽頭炎,2014,48,2014-W48,411,375,786,263,gender
感染性胃腸炎,2014,48,2014-W48,1188,1120,2308,263,gender
水痘,2014,48,2014-W48,132,117,249,263,gender
手足口病,2014,48,2014-W48,58,41,99,263,gender
突発性発しん,2014,48,2014-W48,77,64,141,263,gender
ヘルパンギーナ,2014,48,2014-W48,12,10,22,263,gender
流行性耳下腺炎,2014,48,2014-W48,38,35,73,263,gender
川崎病,2014,48,2014-W48,3,2,5,263,gender
インフルエンザ,2008,31,2008-W31,3,1,4,286,gender
RSウイルス感染症,2008,31,2008-W31,6,8,14,148,gender
咽頭結膜熱,2008,31,2008-W31,77,55,132,148,gender
Ａ群溶血性レンサ球菌咽頭炎,2008,31,2008-W31,85,65,150,148,gender
感染性胃腸炎,2008,31,2008-W31,274,220,494,148,gender
水痘,2008,31,2008-W31,56,44,100,148,gender
手足口病,2008,31,2008-W31,132,117,249,148,gender
突発性発しん,2008,31,2008-W31,57,57,114,148,gender
ヘルパンギーナ,2008,31,2008-W31,364,345,709,148,gender
流行性耳下腺炎,2008,31,2008-W31,54,46,100,148,gender
川崎病,2008,31,2008-W31,4,0,4,148,gender
インフルエンザ,2007,12,2007-W12,3108,3099,6207,280,gender
RSウイルス感染症,2007,12,2007-W12,1,1,2,142,gender
咽頭結膜熱,2007,12,2007-W12,14,13,27,142,gender
Ａ群溶血性レンサ球菌咽頭炎,2007,12,2007-W12,126,129,255,142,gender
感染性胃腸炎,2007,12,2007-W12,417,346,763,142,gender
水痘,2007,12,2007-W12,97,82,179,142,gender
手足口病,2007,12,2007-W12,3,4,7,142,gender
突発性発しん,2007,12,2007-W12,27,20,47,142,gender
ヘルパンギーナ,2007,12,2007-W12,0,0,0,142,gender
流行性耳下腺炎,2007,12,2007-W12,11,12,23,142,gender
川崎病,2007,12,2007-W12,1,0,1,142,gender
インフルエンザ,2020,44,2020-W44,2,2,4,407,gender
RSウイルス感染症,2020,44,2020-W44,0,0,0,256,gender
咽頭結膜熱,2020,44,2020-W44,7,11,18,256,gender
Ａ群溶血性レンサ球菌咽頭炎,2020,44,2020-W44,63,50,113,256,gender
感染性胃腸炎,2020,44,2020-W44,294,263,557,256,gender
水痘,2020,44,2020-W44,21,24,45,256,gender
手足口病,2020,44,2020-W44,5,10,15,256,gender
突発性発しん,2020,44,2020-W44,66,66,132,256,gender
ヘルパンギーナ,2020,44,2020-W44,11,4,15,256,gender
流行性耳下腺炎,2020,44,2020-W44,8,4,12,256,gender
川崎病,2020,44,2020-W44,3,2,5,256,gender
インフルエンザ,2001,38,2001-W38,0,0,0,178,gender
RSウイルス感染症,2001,38,2001-W38,0,0,0,142,gender
咽頭結膜熱,2001,38,2001-W38,3,5,8,142,gender
Ａ群溶血性レンサ球菌咽頭炎,2001,38,2001-W38,16,17,33,142,gender
感染性胃腸炎,2001,38,2001-W38,130,107,237,142,gender
水痘,2001,38,2001-W38,25,24,49,142,gender
手足口病,2001,38,2001-W38,24,22,46,142,gender
突発性発しん,2001,38,2001-W38,38,42,80,142,gender
ヘルパンギーナ,2001,38,2001-W38,21,14,35,142,gender
流行性耳下腺炎,2001,38,2001-W38,43,29,72,142,gender
川崎病,2001,38,2001-W38,2,3,5,142,gender
インフルエンザ,2011,4,2011-W04,6752,6626,13378,417,gender
RSウイルス感染症,2011,4,2011-W04,56,40,96,262,gender
咽頭結膜熱,2011,4,2011-W04,50,34,84,262,gender
Ａ群溶血性レンサ球菌咽頭炎,2011,4,2011-W04,298,304,602,262,gender
感染性胃腸炎,2011,4,2011-W04,1525,1428,2953,262,gender
水痘,2011,4,2011-W04,152,155,307,262,gender
手足口病,2011,4,2011-W04,3,5,8,262,gender
突発性発しん,2011,4,2011-W04,61,76,137,262,gender
ヘルパンギーナ,2011,4,2011-W04,2,3,5,262,gender
流行性耳下腺炎,2011,4,2011-W04,48,43,91,262,gender
川崎病,2011,4,2011-W04,3,2,5,262,gender
インフルエンザ,2010,11,2010-W11,37,52,89,287,gender
RSウイルス感染症,2010,11,2010-W11,24,22,46,147,gender
咽頭結膜熱,2010,11,2010-W11,9,9,18,147,gender
Ａ群溶血性レンサ球菌咽頭炎,2010,11,2010-W11,115,131,246,147,gender
感染性胃腸炎,2010,11,2010-W11,831,764,1595,147,gender
水痘,2010,11,2010-W11,137,162,299,147,gender
手足口病,2010,11,2010-W11,16,13,29,147,gender
突発性発しん,2010,11,2010-W11,44,36,80,147,gender
ヘルパンギーナ,2010,11,2010-W11,3,3,6,147,gender
流行性耳下腺炎,2010,11,2010-W11,53,46,99,147,gender
川崎病,2010,11,2010-W11,1,2,3,147,gender
インフルエンザ,2014,8,2014-W08,6158,5753,11911,418,gender
RSウイルス感染症,2014,8,2014-W08,19,20,39,263,gender
咽頭結膜熱,2014,8,2014-W08,16,18,34,263,gender
Ａ群溶血性レンサ球菌咽頭炎,2014,8,2014-W08,273,268,541,263,gender
感染性胃腸炎,2014,8,2014-W08,774,754,1528,263,gender
水痘,2014,8,2014-W08,106,86,192,263,gender
手足口病,2014,8,2014-W08,5,4,9,263,gender
突発性発しん,2014,8,2014-W08,78,45,123,263,gender
ヘルパンギーナ,2014,8,2014-W08,3,0,3,263,gender
流行性耳下腺炎,2014,8,2014-W08,17,16,33,263,gender
川崎病,2014,8,2014-W08,2,1,3,263,gender
インフルエンザ,2022,37,2022-W37,5,3,8,412,gender
RSウイルス感染症,2022,37,2022-W37,275,253,528,260,gender
咽頭結膜熱,2022,37,2022-W37,9,4,13,260,gender
Ａ群溶血性レンサ球菌咽頭炎,2022,37,2022-W37,16,18,34,260,gender
感染性胃腸炎,2022,37,2022-W37,338,308,646,260,gender
水痘,2022,37,2022-W37,10,7,17,260,gender
手足口病,2022,37,2022-W37,643,631,1274,260,gender
突発性発しん,2022,37,2022-W37,32,35,67,260,gender
ヘルパンギーナ,2022,37,2022-W37,169,149,318,260,gender
流行性耳下腺炎,2022,37,2022-W37,6,1,7,260,gender
川崎病,2022,37,2022-W37,2,1,3,260,gender
インフルエンザ,2002,25,2002-W25,0,0,0,178,gender
RSウイルス感染症,2002,25,2002-W25,0,0,0,142,gender
咽頭結膜熱,2002,25,2002-W25,6,6,12,142,gender
Ａ群溶血性レンサ球菌咽頭炎,2002,25,2002-W25,55,60,115,142,gender
感染性胃腸炎,2002,25,2002-W25,224,194,418,142,gender
水痘,2002,25,2002-W25,98,68,166,142,gender
手足口病,2002,25,2002-W25,116,76,192,142,gender
突発性発しん,2002,25,2002-W25,44,37,81,142,gender
ヘルパンギーナ,2002,25,2002-W25,196,173,369,142,gender
流行性耳下腺炎,2002,25,2002-W25,62,41,103,142,gender
川崎病,2002,25,2002-W25,2,2,4,142,gender
インフルエンザ,2006,51,2006-W51,0,2,2,178,gender
RSウイルス感染症,2006,51,2006-W51,68,55,123,142,gender
咽頭結膜熱,2006,51,2006-W51,34,32,66,142,gender
Ａ群溶血性レンサ球菌咽頭炎,2006,51,2006-W51,118,120,238,142,gender
感染性胃腸炎,2006,51,2006-W51,1330,1296,2626,142,gender
水痘,2006,51,2006-W51,135,120,255,142,gender
手足口病,2006,51,2006-W51,23,14,37,142,gender
突発性発しん,2006,51,2006-W51,34,34,68,142,gender
ヘルパンギーナ,2006,51,2006-W51,7,1,8,142,gender
流行性耳下腺炎,2006,51,2006-W51,31,25,56,142,gender
川崎病,2006,51,2006-W51,1,0,1,142,gender
インフルエンザ,2004,22,2004-W22,0,0,0,178,gender
RSウイルス感染症,2004,22,2004-W22,5,3,8,142,gender
咽頭結膜熱,2004,22,2004-W22,29,24,53,142,gender
Ａ群溶血性レンサ球菌咽頭炎,2004,22,2004-W22,108,97,205,142,gender
感染性胃腸炎,2004,22,2004-W22,323,259,582,142,gender
水痘,2004,22,2004-W22,96,66,162,142,gender
手足口病,2004,22,2004-W22,2,6,8,142,gender
突発性発しん,2004,22,2004-W22,58,43,101,142,gender
ヘルパンギーナ,2004,22,2004-W22,37,47,84,142,gender
流行性耳下腺炎,2004,22,2004-W22,23,25,48,142,gender
川崎病,2004,22,2004-W22,2,2,4,142,gender
インフルエンザ,2016,16,2016-W16,585,601,1186,414,gender
RSウイルス感染症,2016,16,2016-W16,23,14,37,260,gender
咽頭結膜熱,2016,16,2016-W16,44,42,86,260,gender
Ａ群溶血性レンサ球菌咽頭炎,2016,16,2016-W16,396,367,763,260,gender
感染性胃腸炎,2016,16,2016-W16,952,830,1782,260,gender
水痘,2016,16,2016-W16,50,49,99,260,gender
手足口病,2016,16,2016-W16,14,8,22,260,gender
突発性発しん,2016,16,2016-W16,79,79,158,260,gender
ヘルパンギーナ,2016,16,2016-W16,0,4,4,260,gender
流行性耳下腺炎,2016,16,2016-W16,61,51,112,260,gender
川崎病,2016,16,2016-W16,2,1,3,260,gender
インフルエンザ,2024,30,2024-W30,61,50,111,417,gender
新型コロナウイルス感染症（COVID-19）,2024,30,2024-W30,1742,2061,3803,417,gender
RSウイルス感染症,2024,30,2024-W30,38,40,78,262,gender
咽頭結膜熱,2024,30,2024-W30,41,29,70,262,gender
Ａ群溶血性レンサ球菌咽頭炎,2024,30,2024-W30,248,224,472,262,gender
感染性胃腸炎,2024,30,2024-W30,405,355,760,262,gender
水痘,2024,30,2024-W30,32,30,62,262,gender
手足口病,2024,30,2024-W30,1961,1642,3603,262,gender
突発性発しん,2024,30,2024-W30,32,40,72,262,gender
ヘルパンギーナ,2024,30,2024-W30,362,314,676,262,gender
流行性耳下腺炎,2024,30,2024-W30,6,7,13,262,gender
川崎病,2024,30,2024-W30,1,3,4,262,gender
インフルエンザ,2019,35,2019-W35,43,57,100,408,gender
RSウイルス感染症,2019,35,2019-W35,343,273,616,255,gender
咽頭結膜熱,2019,35,2019-W35,39,33,72,255,gender
Ａ群溶血性レンサ球菌咽頭炎,2019,35,2019-W35,157,118,275,255,gender
感染性胃腸炎,2019,35,2019-W35,477,395,872,255,gender
水痘,2019,35,2019-W35,30,18,48,255,gender
手足口病,2019,35,2019-W35,351,298,649,255,gender
突発性発しん,2019,35,2019-W35,59,58,117,255,gender
ヘルパンギーナ,2019,35,2019-W35,232,226,458,255,gender
流行性耳下腺炎,2019,35,2019-W35,14,4,18,255,gender
川崎病,2019,35,2019-W35,2,2,4,255,gender
インフルエンザ,2017,46,2017-W46,194,166,360,415,gender
RSウイルス感染症,2017,46,2017-W46,43,39,82,261,gender
咽頭結膜熱,2017,46,2017-W46,88,84,172,261,gender
Ａ群溶血性レンサ球菌咽頭炎,2017,46,2017-W46,405,374,779,261,gender
感染性胃腸炎,2017,46,2017-W46,957,830,1787,261,gender
水痘,2017,46,2017-W46,97,70,167,261,gender
手足口病,2017,46,2017-W46,177,124,301,261,gender
突発性発しん,2017,46,2017-W46,68,68,136,261,gender
ヘルパンギーナ,2017,46,2017-W46,24,23,47,261,gender
流行性耳下腺炎,2017,46,2017-W46,28,20,48,261,gender
川崎病,2017,46,2017-W46,0,3,3,261,gender
インフルエンザ,2006,3,2006-W03,1519,1476,2995,178,gender
RSウイルス感染症,2006,3,2006-W03,19,12,31,142,gender
咽頭結膜熱,2006,3,2006-W03,19,18,37,142,gender
Ａ群溶血性レンサ球菌咽頭炎,2006,3,2006-W03,145,132,277,142,gender
感染性胃腸炎,2006,3,2006-W03,638,654,1292,142,gender
水痘,2006,3,2006-W03,86,66,152,142,gender
手足口病,2006,3,2006-W03,3,3,6,142,gender
突発性発しん,2006,3,2006-W03,40,31,71,142,gender
ヘルパンギーナ,2006,3,2006-W03,3,5,8,142,gender
流行性耳下腺炎,2006,3,2006-W03,45,44,89,142,gender
川崎病,2006,3,2006-W03,2,0,2,142,gender
インフルエンザ,2015,35,2015-W35,1,1,2,408,gender
RSウイルス感染症,2015,35,2015-W35,78,28,106,256,gender
咽頭結膜熱,2015,35,2015-W35,58,38,96,256,gender
Ａ群溶血性レンサ球菌咽頭炎,2015,35,2015-W35,140,148,288,256,gender
感染性胃腸炎,2015,35,2015-W35,448,391,839,256,gender
水痘,2015,35,2015-W35,36,20,56,256,gender
手足口病,2015,35,2015-W35,789,615,1404,256,gender
突発性発しん,2015,35,2015-W35,93,85,178,256,gender
ヘルパンギーナ,2015,35,2015-W35,171,148,319,256,gender
流行性耳下腺炎,2015,35,2015-W35,58,48,106,256,gender
川崎病,2015,35,2015-W35,1,2,3,256,gender
インフルエンザ,2016,28,2016-W28,2,7,9,410,gender
RSウイルス感染症,2016,28,2016-W28,23,13,36,259,gender
咽頭結膜熱,2016,28,2016-W28,106,77,183,259,gender
Ａ群溶血性レンサ球菌咽頭炎,2016,28,2016-W28,431,358,789,259,gender
感染性胃腸炎,2016,28,2016-W28,764,626,1390,259,gender
水痘,2016,28,2016-W28,48,31,79,259,gender
手足口病,2016,28,2016-W28,142,96,238,259,gender
突発性発しん,2016,28,2016-W28,88,79,167,259,gender
ヘルパンギーナ,2016,28,2016-W28,823,703,1526,259,gender
流行性耳下腺炎,2016,28,2016-W28,108,100,208,259,gender
川崎病,2016,28,2016-W28,6,2,8,259,gender
インフルエンザ,2008,22,2008-W22,15,22,37,285,gender
RSウイルス感染症,2008,22,2008-W22,0,0,0,147,gender
咽頭結膜熱,2008,22,2008-W22,45,44,89,147,gender
Ａ群溶血性レンサ球菌咽頭炎,2008,22,2008-W22,193,180,373,147,gender
感染性胃腸炎,2008,22,2008-W22,488,417,905,147,gender
水痘,2008,22,2008-W22,158,113,271,147,gender
手足口病,2008,22,2008-W22,23,23,46,147,gender
突発性発しん,2008,22,2008-W22,38,53,91,147,gender
ヘルパンギーナ,2008,22,2008-W22,17,16,33,147,gender
流行性耳下腺炎,2008,22,2008-W22,31,19,50,147,gender
川崎病,2008,22,2008-W22,0,0,0,147,gender
インフルエンザ,2008,1,2008-W01,317,250,567,260,gender
RSウイルス感染症,2008,1,2008-W01,5,12,17,134,gender
咽頭結膜熱,2008,1,2008-W01,8,3,11,134,gender
Ａ群溶血性レンサ球菌咽頭炎,2008,1,2008-W01,17,17,34,134,gender
感染性胃腸炎,2008,1,2008-W01,232,215,447,134,gender
水痘,2008,1,2008-W01,77,75,152,134,gender
手足口病,2008,1,2008-W01,0,1,1,134,gender
突発性発しん,2008,1,2008-W01,7,11,18,134,gender
ヘルパンギーナ,2008,1,2008-W01,0,1,1,134,gender
流行性耳下腺炎,2008,1,2008-W01,4,3,7,134,gender
川崎病,2008,1,2008-W01,0,0,0,134,gender
インフルエンザ,2021,14,2021-W14,0,1,1,413,gender
RSウイルス感染症,2021,14,2021-W14,19,18,37,259,gender
咽頭結膜熱,2021,14,2021-W14,10,7,17,259,gender
Ａ群溶血性レンサ球菌咽頭炎,2021,14,2021-W14,48,34,82,259,gender
感染性胃腸炎,2021,14,2021-W14,357,305,662,259,gender
水痘,2021,14,2021-W14,12,8,20,259,gender
手足口病,2021,14,2021-W14,3,3,6,259,gender
突発性発しん,2021,14,2021-W14,62,57,119,259,gender
ヘルパンギーナ,2021,14,2021-W14,2,3,5,259,gender
流行性耳下腺炎,2021,14,2021-W14,10,7,17,259,gender
川崎病,2021,14,2021-W14,1,1,2,259,gender
インフルエンザ,2011,41,2011-W41,14,13,27,410,gender
RSウイルス感染症,2011,41,2011-W41,83,54,137,258,gender
咽頭結膜熱,2011,41,2011-W41,19,9,28,258,gender
Ａ群溶血性レンサ球菌咽頭炎,2011,41,2011-W41,139,117,256,258,gender
感染性胃腸炎,2011,41,2011-W41,441,355,796,258,gender
水痘,2011,41,2011-W41,58,66,124,258,gender
手足口病,2011,41,2011-W41,179,142,321,258,gender
突発性発しん,2011,41,2011-W41,77,67,144,258,gender
ヘルパンギーナ,2011,41,2011-W41,45,30,75,258,gender
流行性耳下腺炎,2011,41,2011-W41,40,34,74,258,gender
川崎病,2011,41,2011-W41,2,1,3,258,gender
インフルエンザ,2013,32,2013-W32,2,3,5,390,gender
RSウイルス感染症,2013,32,2013-W32,64,69,133,252,gender
咽頭結膜熱,2013,32,2013-W32,73,49,122,252,gender
Ａ群溶血性レンサ球菌咽頭炎,2013,32,2013-W32,123,120,243,252,gender
感染性胃腸炎,2013,32,2013-W32,398,358,756,252,gender
水痘,2013,32,2013-W32,71,59,130,252,gender
手足口病,2013,32,2013-W32,1645,1376,3021,252,gender
突発性発しん,2013,32,2013-W32,85,64,149,252,gender
ヘルパンギーナ,2013,32,2013-W32,412,387,799,252,gender
流行性耳下腺炎,2013,32,2013-W32,23,18,41,252,gender
川崎病,2013,32,2013-W32,1,1,2,252,gender
インフルエンザ,2024,41,2024-W41,232,163,395,418,gender
新型コロナウイルス感染症（COVID-19）,2024,41,2024-W41,360,398,758,418,gender
RSウイルス感染症,2024,41,2024-W41,33,20,53,263,gender
咽頭結膜熱,2024,41,2024-W41,22,21,43,263,gender
Ａ群溶血性レンサ球菌咽頭炎,2024,41,2024-W41,236,178,414,263,gender
感染性胃腸炎,2024,41,2024-W41,403,295,698,263,gender
水痘,2024,41,2024-W41,12,21,33,263,gender
手足口病,2024,41,2024-W41,1761,1482,3243,263,gender
突発性発しん,2024,41,2024-W41,23,23,46,263,gender
ヘルパンギーナ,2024,41,2024-W41,55,53,108,263,gender
流行性耳下腺炎,2024,41,2024-W41,1,8,9,263,gender
川崎病,2024,41,2024-W41,0,1,1,263,gender
インフルエンザ,2014,14,2014-W14,989,1012,2001,418,gender
RSウイルス感染症,2014,14,2014-W14,17,9,26,263,gender
咽頭結膜熱,2014,14,2014-W14,20,13,33,263,gender
Ａ群溶血性レンサ球菌咽頭炎,2014,14,2014-W14,244,211,455,263,gender
感染性胃腸炎,2014,14,2014-W14,594,556,1150,263,gender
水痘,2014,14,2014-W14,99,70,169,263,gender
手足口病,2014,14,2014-W14,5,7,12,263,gender
突発性発しん,2014,14,2014-W14,76,70,146,263,gender
ヘルパンギーナ,2014,14,2014-W14,3,2,5,263,gender
流行性耳下腺炎,2014,14,2014-W14,24,16,40,263,gender
川崎病,2014,14,2014-W14,3,0,3,263,gender
インフルエンザ,2019,44,2019-W44,234,227,461,414,gender
RSウイルス感染症,2019,44,2019-W44,34,38,72,261,gender
咽頭結膜熱,2019,44,2019-W44,34,43,77,261,gender
Ａ群溶血性レンサ球菌咽頭炎,2019,44,2019-W44,323,262,585,261,gender
感染性胃腸炎,2019,44,2019-W44,547,443,990,261,gender
水痘,2019,44,2019-W44,54,51,105,261,gender
手足口病,2019,44,2019-W44,309,219,528,261,gender
突発性発しん,2019,44,2019-W44,46,58,104,261,gender
ヘルパンギーナ,2019,44,2019-W44,41,39,80,261,gender
流行性耳下腺炎,2019,44,2019-W44,13,9,22,261,gender
川崎病,2019,44,2019-W44,3,0,3,261,gender
インフルエンザ,2006,20,2006-W20,12,7,19,178,gender
RSウイルス感染症,2006,20,2006-W20,0,0,0,142,gender
咽頭結膜熱,2006,20,2006-W20,62,52,114,142,gender
Ａ群溶血性レンサ球菌咽頭炎,2006,20,2006-W20,180,170,350,142,gender
感染性胃腸炎,2006,20,2006-W20,371,321,692,142,gender
水痘,2006,20,2006-W20,90,90,180,142,gender
手足口病,2006,20,2006-W20,24,11,35,142,gender
突発性発しん,2006,20,2006-W20,58,40,98,142,gender
ヘルパンギーナ,2006,20,2006-W20,65,55,120,142,gender
流行性耳下腺炎,2006,20,2006-W20,51,47,98,142,gender
川崎病,2006,20,2006-W20,1,2,3,142,gender
インフルエンザ,2004,53,2004-W53,38,39,77,178,gender
RSウイルス感染症,2004,53,2004-W53,10,7,17,142,gender
咽頭結膜熱,2004,53,2004-W53,14,13,27,142,gender
Ａ群溶血性レンサ球菌咽頭炎,2004,53,2004-W53,42,37,79,142,gender
感染性胃腸炎,2004,53,2004-W53,684,695,1379,142,gender
水痘,2004,53,2004-W53,88,75,163,142,gender
手足口病,2004,53,2004-W53,17,13,30,142,gender
突発性発しん,2004,53,2004-W53,19,17,36,142,gender
ヘルパンギーナ,2004,53,2004-W53,2,0,2,142,gender
流行性耳下腺炎,2004,53,2004-W53,47,28,75,142,gender
川崎病,2004,53,2004-W53,0,0,0,142,gender
インフルエンザ,2017,9,2017-W09,2557,2624,5181,415,gender
RSウイルス感染症,2017,9,2017-W09,13,12,25,262,gender
咽頭結膜熱,2017,9,2017-W09,32,35,67,262,gender
Ａ群溶血性レンサ球菌咽頭炎,2017,9,2017-W09,268,246,514,262,gender
感染性胃腸炎,2017,9,2017-W09,984,875,1859,262,gender
水痘,2017,9,2017-W09,38,34,72,262,gender
手足口病,2017,9,2017-W09,11,6,17,262,gender
突発性発しん,2017,9,2017-W09,60,71,131,262,gender
ヘルパンギーナ,2017,9,2017-W09,0,1,1,262,gender
流行性耳下腺炎,2017,9,2017-W09,43,41,84,262,gender
川崎病,2017,9,2017-W09,3,3,6,262,gender
インフルエンザ,2000,27,2000-W27,0,0,0,178,gender
RSウイルス感染症,2000,27,2000-W27,0,0,0,142,gender
咽頭結膜熱,2000,27,2000-W27,9,14,23,142,gender
Ａ群溶血性レンサ球菌咽頭炎,2000,27,2000-W27,41,32,73,142,gender
感染性胃腸炎,2000,27,2000-W27,156,133,289,142,gender
水痘,2000,27,2000-W27,66,52,118,142,gender
手足口病,2000,27,2000-W27,273,215,488,142,gender
突発性発しん,2000,27,2000-W27,30,33,63,142,gender
ヘルパンギーナ,2000,27,2000-W27,468,425,893,142,gender
流行性耳下腺炎,2000,27,2000-W27,58,47,105,142,gender
川崎病,2000,27,2000-W27,1,1,2,142,gender
インフルエンザ,2012,5,2012-W05,9710,9229,18939,419,gender
RSウイルス感染症,2012,5,2012-W05,38,30,68,264,gender
咽頭結膜熱,2012,5,2012-W05,31,29,60,264,gender
Ａ群溶血性レンサ球菌咽頭炎,2012,5,2012-W05,286,243,529,264,gender
感染性胃腸炎,2012,5,2012-W05,1134,928,2062,264,gender
水痘,2012,5,2012-W05,149,129,278,264,gender
手足口病,2012,5,2012-W05,2,10,12,264,gender
突発性発しん,2012,5,2012-W05,59,65,124,264,gender
ヘルパンギーナ,2012,5,2012-W05,3,4,7,264,gender
流行性耳下腺炎,2012,5,2012-W05,27,12,39,264,gender
川崎病,2012,5,2012-W05,2,2,4,264,gender
インフルエンザ,2023,28,2023-W28,277,237,514,415,gender
新型コロナウイルス感染症（COVID-19）,2023,28,2023-W28,1609,1799,3408,415,gender
RSウイルス感染症,2023,28,2023-W28,334,296,630,261,gender
咽頭結膜熱,2023,28,2023-W28,66,37,103,261,gender
Ａ群溶血性レンサ球菌咽頭炎,2023,28,2023-W28,181,166,347,261,gender
感染性胃腸炎,2023,28,2023-W28,688,484,1172,261,gender
水痘,2023,28,2023-W28,17,14,31,261,gender
手足口病,2023,28,2023-W28,76,68,144,261,gender
突発性発しん,2023,28,2023-W28,34,40,74,261,gender
ヘルパンギーナ,2023,28,2023-W28,905,811,1716,261,gender
流行性耳下腺炎,2023,28,2023-W28,9,4,13,261,gender
川崎病,2023,28,2023-W28,3,2,5,261,gender
インフルエンザ,2020,35,2020-W35,0,0,0,411,gender
RSウイルス感染症,2020,35,2020-W35,0,0,0,259,gender
咽頭結膜熱,2020,35,2020-W35,15,10,25,259,gender
Ａ群溶血性レンサ球菌咽頭炎,2020,35,2020-W35,32,42,74,259,gender
感染性胃腸炎,2020,35,2020-W35,285,250,535,259,gender
水痘,2020,35,2020-W35,11,7,18,259,gender
手足口病,2020,35,2020-W35,15,11,26,259,gender
突発性発しん,2020,35,2020-W35,63,78,141,259,gender
ヘルパンギーナ,2020,35,2020-W35,12,6,18,259,gender
流行性耳下腺炎,2020,35,2020-W35,4,5,9,259,gender
川崎病,2020,35,2020-W35,1,3,4,259,gender
インフルエンザ,2001,49,2001-W49,17,7,24,178,gender
RSウイルス感染症,2001,49,2001-W49,0,0,0,142,gender
咽頭結膜熱,2001,49,2001-W49,6,3,9,142,gender
Ａ群溶血性レンサ球菌咽頭炎,2001,49,2001-W49,58,43,101,142,gender
感染性胃腸炎,2001,49,2001-W49,739,667,1406,142,gender
水痘,2001,49,2001-W49,117,87,204,142,gender
手足口病,2001,49,2001-W49,17,12,29,142,gender
突発性発しん,2001,49,2001-W49,36,29,65,142,gender
ヘルパンギーナ,2001,49,2001-W49,2,2,4,142,gender
流行性耳下腺炎,2001,49,2001-W49,73,60,133,142,gender
川崎病,2001,49,2001-W49,0,3,3,142,gender
インフルエンザ,2012,13,2012-W13,1715,1699,3414,418,gender
RSウイルス感染症,2012,13,2012-W13,18,8,26,263,gender
咽頭結膜熱,2012,13,2012-W13,17,14,31,263,gender
Ａ群溶血性レンサ球菌咽頭炎,2012,13,2012-W13,185,180,365,263,gender
感染性胃腸炎,2012,13,2012-W13,1143,1028,2171,263,gender
水痘,2012,13,2012-W13,144,112,256,263,gender
手足口病,2012,13,2012-W13,5,8,13,263,gender
突発性発しん,2012,13,2012-W13,92,68,160,263,gender
ヘルパンギーナ,2012,13,2012-W13,0,1,1,263,gender
流行性耳下腺炎,2012,13,2012-W13,26,20,46,263,gender
川崎病,2012,13,2012-W13,1,0,1,263,gender
インフルエンザ,2022,46,2022-W46,83,42,125,412,gender
RSウイルス感染症,2022,46,2022-W46,74,56,130,260,gender
咽頭結膜熱,2022,46,2022-W46,10,20,30,260,gender
Ａ群溶血性レンサ球菌咽頭炎,2022,46,2022-W46,29,32,61,260,gender
感染性胃腸炎,2022,46,2022-W46,821,659,1480,260,gender
水痘,2022,46,2022-W46,19,14,33,260,gender
手足口病,2022,46,2022-W46,41,42,83,260,gender
突発性発しん,2022,46,2022-W46,38,37,75,260,gender
ヘルパンギーナ,2022,46,2022-W46,18,10,28,260,gender
流行性耳下腺炎,2022,46,2022-W46,7,1,8,260,gender
川崎病,2022,46,2022-W46,1,0,1,260,gender
インフルエンザ,2000,19,2000-W19,5,4,9,178,gender
RSウイルス感染症,2000,19,2000-W19,0,0,0,142,gender
咽頭結膜熱,2000,19,2000-W19,5,4,9,142,gender
Ａ群溶血性レンサ球菌咽頭炎,2000,19,2000-W19,30,45,75,142,gender
感染性胃腸炎,2000,19,2000-W19,328,299,627,142,gender
水痘,2000,19,2000-W19,144,119,263,142,gender
手足口病,2000,19,2000-W19,8,8,16,142,gender
突発性発しん,2000,19,2000-W19,40,28,68,142,gender
ヘルパンギーナ,2000,19,2000-W19,13,12,25,142,gender
流行性耳下腺炎,2000,19,2000-W19,39,32,71,142,gender
川崎病,2000,19,2000-W19,1,0,1,142,gender
インフルエンザ,2011,30,2011-W30,3,0,3,415,gender
RSウイルス感染症,2011,30,2011-W30,33,29,62,262,gender
咽頭結膜熱,2011,30,2011-W30,105,77,182,262,gender
Ａ群溶血性レンサ球菌咽頭炎,2011,30,2011-W30,166,137,303,262,gender
感染性胃腸炎,2011,30,2011-W30,539,389,928,262,gender
水痘,2011,30,2011-W30,95,66,161,262,gender
手足口病,2011,30,2011-W30,1614,1264,2878,262,gender
突発性発しん,2011,30,2011-W30,95,94,189,262,gender
ヘルパンギーナ,2011,30,2011-W30,1128,976,2104,262,gender
流行性耳下腺炎,2011,30,2011-W30,56,38,94,262,gender
川崎病,2011,30,2011-W30,4,0,4,262,gender
インフルエンザ,2013,43,2013-W43,19,20,39,412,gender
RSウイルス感染症,2013,43,2013-W43,136,138,274,260,gender
咽頭結膜熱,2013,43,2013-W43,34,36,70,260,gender
Ａ群溶血性レンサ球菌咽頭炎,2013,43,2013-W43,164,128,292,260,gender
感染性胃腸炎,2013,43,2013-W43,474,456,930,260,gender
水痘,2013,43,2013-W43,68,65,133,260,gender
手足口病,2013,43,2013-W43,112,84,196,260,gender
突発性発しん,2013,43,2013-W43,75,90,165,260,gender
ヘルパンギーナ,2013,43,2013-W43,21,15,36,260,gender
流行性耳下腺炎,2013,43,2013-W43,15,15,30,260,gender
川崎病,2013,43,2013-W43,4,1,5,260,gender
インフルエンザ,2023,16,2023-W16,407,349,756,412,gender
RSウイルス感染症,2023,16,2023-W16,55,55,110,259,gender
咽頭結膜熱,2023,16,2023-W16,31,25,56,259,gender
Ａ群溶血性レンサ球菌咽頭炎,2023,16,2023-W16,121,69,190,259,gender
感染性胃腸炎,2023,16,2023-W16,737,617,1354,259,gender
水痘,2023,16,2023-W16,14,9,23,259,gender
手足口病,2023,16,2023-W16,36,16,52,259,gender
突発性発しん,2023,16,2023-W16,53,47,100,259,gender
ヘルパンギーナ,2023,16,2023-W16,21,27,48,259,gender
流行性耳下腺炎,2023,16,2023-W16,9,3,12,259,gender
川崎病,2023,16,2023-W16,1,1,2,259,gender
インフルエンザ,2005,2,2005-W02,88,96,184,178,gender
RSウイルス感染症,2005,2,2005-W02,8,3,11,142,gender
咽頭結膜熱,2005,2,2005-W02,10,7,17,142,gender
Ａ群溶血性レンサ球菌咽頭炎,2005,2,2005-W02,40,37,77,142,gender
感染性胃腸炎,2005,2,2005-W02,709,746,1455,142,gender
水痘,2005,2,2005-W02,105,98,203,142,gender
手足口病,2005,2,2005-W02,11,7,18,142,gender
突発性発しん,2005,2,2005-W02,46,30,76,142,gender
ヘルパンギーナ,2005,2,2005-W02,2,0,2,142,gender
流行性耳下腺炎,2005,2,2005-W02,68,55,123,142,gender
川崎病,2005,2,2005-W02,1,0,1,142,gender
インフルエンザ,2017,37,2017-W37,44,44,88,410,gender
RSウイルス感染症,2017,37,2017-W37,349,310,659,258,gender
咽頭結膜熱,2017,37,2017-W37,64,50,114,258,gender
Ａ群溶血性レンサ球菌咽頭炎,2017,37,2017-W37,208,202,410,258,gender
感染性胃腸炎,2017,37,2017-W37,513,418,931,258,gender
水痘,2017,37,2017-W37,29,21,50,258,gender
手足口病,2017,37,2017-W37,901,806,1707,258,gender
突発性発しん,2017,37,2017-W37,83,54,137,258,gender
ヘルパンギーナ,2017,37,2017-W37,183,145,328,258,gender
流行性耳下腺炎,2017,37,2017-W37,24,19,43,258,gender
川崎病,2017,37,2017-W37,2,3,5,258,gender
インフルエンザ,2025,11,2025-W11,430,435,865,418,gender
新型コロナウイルス感染症（COVID-19）,2025,11,2025-W11,506,627,1133,418,gender
RSウイルス感染症,2025,11,2025-W11,84,57,141,263,gender
咽頭結膜熱,2025,11,2025-W11,14,17,31,263,gender
Ａ群溶血性レンサ球菌咽頭炎,2025,11,2025-W11,365,258,623,263,gender
感染性胃腸炎,2025,11,2025-W11,1760,1552,3312,263,gender
水痘,2025,11,2025-W11,87,58,145,263,gender
手足口病,2025,11,2025-W11,7,5,12,263,gender
突発性発しん,2025,11,2025-W11,34,25,59,263,gender
ヘルパンギーナ,2025,11,2025-W11,2,2,4,263,gender
流行性耳下腺炎,2025,11,2025-W11,4,4,8,263,gender
川崎病,2025,11,2025-W11,2,0,2,263,gender
インフルエンザ,2015,44,2015-W44,26,33,59,411,gender
RSウイルス感染症,2015,44,2015-W44,178,181,359,261,gender
咽頭結膜熱,2015,44,2015-W44,39,30,69,261,gender
Ａ群溶血性レンサ球菌咽頭炎,2015,44,2015-W44,273,237,510,261,gender
感染性胃腸炎,2015,44,2015-W44,703,656,1359,261,gender
水痘,2015,44,2015-W44,52,50,102,261,gender
手足口病,2015,44,2015-W44,76,65,141,261,gender
突発性発しん,2015,44,2015-W44,85,72,157,261,gender
ヘルパンギーナ,2015,44,2015-W44,10,17,27,261,gender
流行性耳下腺炎,2015,44,2015-W44,74,69,143,261,gender
川崎病,2015,44,2015-W44,3,0,3,261,gender
インフルエンザ,2018,14,2018-W14,232,220,452,413,gender
RSウイルス感染症,2018,14,2018-W14,27,27,54,259,gender
咽頭結膜熱,2018,14,2018-W14,13,14,27,259,gender
Ａ群溶血性レンサ球菌咽頭炎,2018,14,2018-W14,262,219,481,259,gender
感染性胃腸炎,2018,14,2018-W14,640,577,1217,259,gender
水痘,2018,14,2018-W14,44,36,80,259,gender
手足口病,2018,14,2018-W14,8,6,14,259,gender
突発性発しん,2018,14,2018-W14,60,58,118,259,gender
ヘルパンギーナ,2018,14,2018-W14,4,1,5,259,gender
流行性耳下腺炎,2018,14,2018-W14,10,9,19,259,gender
川崎病,2018,14,2018-W14,3,2,5,259,gender
インフルエンザ,2014,25,2014-W25,4,1,5,409,gender
RSウイルス感染症,2014,25,2014-W25,13,21,34,261,gender
咽頭結膜熱,2014,25,2014-W25,116,113,229,261,gender
Ａ群溶血性レンサ球菌咽頭炎,2014,25,2014-W25,429,312,741,261,gender
感染性胃腸炎,2014,25,2014-W25,900,744,1644,261,gender
水痘,2014,25,2014-W25,154,116,270,261,gender
手足口病,2014,25,2014-W25,60,59,119,261,gender
突発性発しん,2014,25,2014-W25,143,103,246,261,gender
ヘルパンギーナ,2014,25,2014-W25,266,225,491,261,gender
流行性耳下腺炎,2014,25,2014-W25,30,28,58,261,gender
川崎病,2014,25,2014-W25,2,1,3,261,gender
インフルエンザ,2009,32,2009-W32,267,199,466,280,gender
RSウイルス感染症,2009,32,2009-W32,13,6,19,144,gender
咽頭結膜熱,2009,32,2009-W32,16,8,24,144,gender
Ａ群溶血性レンサ球菌咽頭炎,2009,32,2009-W32,40,46,86,144,gender
感染性胃腸炎,2009,32,2009-W32,204,200,404,144,gender
水痘,2009,32,2009-W32,36,38,74,144,gender
手足口病,2009,32,2009-W32,149,127,276,144,gender
突発性発しん,2009,32,2009-W32,50,53,103,144,gender
ヘルパンギーナ,2009,32,2009-W32,128,158,286,144,gender
流行性耳下腺炎,2009,32,2009-W32,68,71,139,144,gender
川崎病,2009,32,2009-W32,1,0,1,144,gender
インフルエンザ,2023,2,2023-W02,1175,999,2174,410,gender
RSウイルス感染症,2023,2,2023-W02,7,14,21,261,gender
咽頭結膜熱,2023,2,2023-W02,7,8,15,261,gender
Ａ群溶血性レンサ球菌咽頭炎,2023,2,2023-W02,29,10,39,261,gender
感染性胃腸炎,2023,2,2023-W02,1136,1031,2167,261,gender
水痘,2023,2,2023-W02,14,4,18,261,gender
手足口病,2023,2,2023-W02,7,2,9,261,gender
突発性発しん,2023,2,2023-W02,38,30,68,261,gender
ヘルパンギーナ,2023,2,2023-W02,0,1,1,261,gender
流行性耳下腺炎,2023,2,2023-W02,6,1,7,261,gender
川崎病,2023,2,2023-W02,1,0,1,261,gender
インフルエンザ,2006,11,2006-W11,246,238,484,178,gender
RSウイルス感染症,2006,11,2006-W11,1,2,3,142,gender
咽頭結膜熱,2006,11,2006-W11,23,23,46,142,gender
Ａ群溶血性レンサ球菌咽頭炎,2006,11,2006-W11,176,177,353,142,gender
感染性胃腸炎,2006,11,2006-W11,565,521,1086,142,gender
水痘,2006,11,2006-W11,115,86,201,142,gender
手足口病,2006,11,2006-W11,1,2,3,142,gender
突発性発しん,2006,11,2006-W11,28,31,59,142,gender
ヘルパンギーナ,2006,11,2006-W11,5,7,12,142,gender
流行性耳下腺炎,2006,11,2006-W11,62,59,121,142,gender
川崎病,2006,11,2006-W11,0,1,1,142,gender
インフルエンザ,2017,38,2017-W38,22,45,67,413,gender
RSウイルス感染症,2017,38,2017-W38,232,209,441,261,gender
咽頭結膜熱,2017,38,2017-W38,46,42,88,261,gender
Ａ群溶血性レンサ球菌咽頭炎,2017,38,2017-W38,165,153,318,261,gender
感染性胃腸炎,2017,38,2017-W38,395,315,710,261,gender
水痘,2017,38,2017-W38,23,20,43,261,gender
手足口病,2017,38,2017-W38,590,485,1075,261,gender
突発性発しん,2017,38,2017-W38,65,59,124,261,gender
ヘルパンギーナ,2017,38,2017-W38,107,112,219,261,gender
流行性耳下腺炎,2017,38,2017-W38,21,17,38,261,gender
川崎病,2017,38,2017-W38,2,1,3,261,gender
インフルエンザ,2023,19,2023-W19,217,180,397,415,gender
新型コロナウイルス感染症（COVID-19）,2023,19,2023-W19,479,517,996,415,gender
RSウイルス感染症,2023,19,2023-W19,53,42,95,261,gender
咽頭結膜熱,2023,19,2023-W19,64,58,122,261,gender
Ａ群溶血性レンサ球菌咽頭炎,2023,19,2023-W19,178,115,293,261,gender
感染性胃腸炎,2023,19,2023-W19,846,686,1532,261,gender
水痘,2023,19,2023-W19,30,19,49,261,gender
手足口病,2023,19,2023-W19,18,26,44,261,gender
突発性発しん,2023,19,2023-W19,59,55,114,261,gender
ヘルパンギーナ,2023,19,2023-W19,33,31,64,261,gender
流行性耳下腺炎,2023,19,2023-W19,6,3,9,261,gender
川崎病,2023,19,2023-W19,2,1,3,261,gender
インフルエンザ,2000,16,2000-W16,3,3,6,178,gender
RSウイルス感染症,2000,16,2000-W16,0,0,0,142,gender
咽頭結膜熱,2000,16,2000-W16,0,1,1,142,gender
Ａ群溶血性レンサ球菌咽頭炎,2000,16,2000-W16,64,52,116,142,gender
感染性胃腸炎,2000,16,2000-W16,392,380,772,142,gender
水痘,2000,16,2000-W16,88,92,180,142,gender
手足口病,2000,16,2000-W16,15,5,20,142,gender
突発性発しん,2000,16,2000-W16,41,33,74,142,gender
ヘルパンギーナ,2000,16,2000-W16,10,7,17,142,gender
流行性耳下腺炎,2000,16,2000-W16,26,28,54,142,gender
川崎病,2000,16,2000-W16,1,0,1,142,gender
インフルエンザ,2012,22,2012-W22,26,16,42,415,gender
RSウイルス感染症,2012,22,2012-W22,15,22,37,261,gender
咽頭結膜熱,2012,22,2012-W22,93,65,158,261,gender
Ａ群溶血性レンサ球菌咽頭炎,2012,22,2012-W22,452,420,872,261,gender
感染性胃腸炎,2012,22,2012-W22,1376,1161,2537,261,gender
水痘,2012,22,2012-W22,150,130,280,261,gender
手足口病,2012,22,2012-W22,35,46,81,261,gender
突発性発しん,2012,22,2012-W22,116,97,213,261,gender
ヘルパンギーナ,2012,22,2012-W22,43,26,69,261,gender
流行性耳下腺炎,2012,22,2012-W22,40,35,75,261,gender
川崎病,2012,22,2012-W22,3,3,6,261,gender
インフルエンザ,2010,51,2010-W51,319,346,665,285,gender
RSウイルス感染症,2010,51,2010-W51,64,51,115,148,gender
咽頭結膜熱,2010,51,2010-W51,45,38,83,148,gender
Ａ群溶血性レンサ球菌咽頭炎,2010,51,2010-W51,218,201,419,148,gender
感染性胃腸炎,2010,51,2010-W51,1260,1258,2518,148,gender
水痘,2010,51,2010-W51,165,143,308,148,gender
手足口病,2010,51,2010-W51,15,14,29,148,gender
突発性発しん,2010,51,2010-W51,36,31,67,148,gender
ヘルパンギーナ,2010,51,2010-W51,2,2,4,148,gender
流行性耳下腺炎,2010,51,2010-W51,22,19,41,148,gender
川崎病,2010,51,2010-W51,1,1,2,148,gender
インフルエンザ,2023,27,2023-W27,255,252,507,416,gender
新型コロナウイルス感染症（COVID-19）,2023,27,2023-W27,1558,1594,3152,416,gender
RSウイルス感染症,2023,27,2023-W27,356,348,704,261,gender
咽頭結膜熱,2023,27,2023-W27,52,40,92,261,gender
Ａ群溶血性レンサ球菌咽頭炎,2023,27,2023-W27,192,154,346,261,gender
感染性胃腸炎,2023,27,2023-W27,643,521,1164,261,gender
水痘,2023,27,2023-W27,21,14,35,261,gender
手足口病,2023,27,2023-W27,121,86,207,261,gender
突発性発しん,2023,27,2023-W27,36,43,79,261,gender
ヘルパンギーナ,2023,27,2023-W27,1065,1023,2088,261,gender
流行性耳下腺炎,2023,27,2023-W27,11,10,21,261,gender
川崎病,2023,27,2023-W27,3,2,5,261,gender
インフルエンザ,2017,6,2017-W06,5393,5420,10813,413,gender
RSウイルス感染症,2017,6,2017-W06,12,10,22,260,gender
咽頭結膜熱,2017,6,2017-W06,27,26,53,260,gender
Ａ群溶血性レンサ球菌咽頭炎,2017,6,2017-W06,258,215,473,260,gender
感染性胃腸炎,2017,6,2017-W06,746,624,1370,260,gender
水痘,2017,6,2017-W06,27,21,48,260,gender
手足口病,2017,6,2017-W06,15,6,21,260,gender
突発性発しん,2017,6,2017-W06,50,57,107,260,gender
ヘルパンギーナ,2017,6,2017-W06,0,0,0,260,gender
流行性耳下腺炎,2017,6,2017-W06,37,31,68,260,gender
川崎病,2017,6,2017-W06,2,1,3,260,gender
インフルエンザ,2000,28,2000-W28,0,0,0,178,gender
RSウイルス感染症,2000,28,2000-W28,0,0,0,142,gender
咽頭結膜熱,2000,28,2000-W28,10,14,24,142,gender
Ａ群溶血性レンサ球菌咽頭炎,2000,28,2000-W28,41,43,84,142,gender
感染性胃腸炎,2000,28,2000-W28,150,109,259,142,gender
水痘,2000,28,2000-W28,59,69,128,142,gender
手足口病,2000,28,2000-W28,303,232,535,142,gender
突発性発しん,2000,28,2000-W28,38,38,76,142,gender
ヘルパンギーナ,2000,28,2000-W28,501,466,967,142,gender
流行性耳下腺炎,2000,28,2000-W28,53,36,89,142,gender
川崎病,2000,28,2000-W28,0,0,0,142,gender
インフルエンザ,2022,49,2022-W49,112,91,203,409,gender
RSウイルス感染症,2022,49,2022-W49,45,23,68,259,gender
咽頭結膜熱,2022,49,2022-W49,27,19,46,259,gender
Ａ群溶血性レンサ球菌咽頭炎,2022,49,2022-W49,28,20,48,259,gender
感染性胃腸炎,2022,49,2022-W49,1062,907,1969,259,gender
水痘,2022,49,2022-W49,27,13,40,259,gender
手足口病,2022,49,2022-W49,37,27,64,259,gender
突発性発しん,2022,49,2022-W49,29,36,65,259,gender
ヘルパンギーナ,2022,49,2022-W49,6,3,9,259,gender
流行性耳下腺炎,2022,49,2022-W49,6,5,11,259,gender
川崎病,2022,49,2022-W49,0,1,1,259,gender
インフルエンザ,2003,35,2003-W35,0,0,0,178,gender
RSウイルス感染症,2003,35,2003-W35,0,0,0,142,gender
咽頭結膜熱,2003,35,2003-W35,18,8,26,142,gender
Ａ群溶血性レンサ球菌咽頭炎,2003,35,2003-W35,14,14,28,142,gender
感染性胃腸炎,2003,35,2003-W35,110,112,222,142,gender
水痘,2003,35,2003-W35,32,22,54,142,gender
手足口病,2003,35,2003-W35,93,85,178,142,gender
突発性発しん,2003,35,2003-W35,52,53,105,142,gender
ヘルパンギーナ,2003,35,2003-W35,75,70,145,142,gender
流行性耳下腺炎,2003,35,2003-W35,12,3,15,142,gender
川崎病,2003,35,2003-W35,0,1,1,142,gender
インフルエンザ,2001,46,2001-W46,3,4,7,178,gender
RSウイルス感染症,2001,46,2001-W46,0,0,0,142,gender
咽頭結膜熱,2001,46,2001-W46,7,5,12,142,gender
Ａ群溶血性レンサ球菌咽頭炎,2001,46,2001-W46,46,44,90,142,gender
感染性胃腸炎,2001,46,2001-W46,379,330,709,142,gender
水痘,2001,46,2001-W46,57,52,109,142,gender
手足口病,2001,46,2001-W46,24,17,41,142,gender
突発性発しん,2001,46,2001-W46,37,38,75,142,gender
ヘルパンギーナ,2001,46,2001-W46,9,10,19,142,gender
流行性耳下腺炎,2001,46,2001-W46,54,52,106,142,gender
川崎病,2001,46,2001-W46,1,1,2,142,gender
インフルエンザ,2005,32,2005-W32,0,0,0,178,gender
RSウイルス感染症,2005,32,2005-W32,8,5,13,142,gender
咽頭結膜熱,2005,32,2005-W32,20,30,50,142,gender
Ａ群溶血性レンサ球菌咽頭炎,2005,32,2005-W32,55,35,90,142,gender
感染性胃腸炎,2005,32,2005-W32,155,109,264,142,gender
水痘,2005,32,2005-W32,36,31,67,142,gender
手足口病,2005,32,2005-W32,59,62,121,142,gender
突発性発しん,2005,32,2005-W32,38,32,70,142,gender
ヘルパンギーナ,2005,32,2005-W32,110,94,204,142,gender
流行性耳下腺炎,2005,32,2005-W32,63,77,140,142,gender
川崎病,2005,32,2005-W32,0,1,1,142,gender
インフルエンザ,2019,4,2019-W04,13290,13345,26635,415,gender
RSウイルス感染症,2019,4,2019-W04,22,28,50,262,gender
咽頭結膜熱,2019,4,2019-W04,27,24,51,262,gender
Ａ群溶血性レンサ球菌咽頭炎,2019,4,2019-W04,333,309,642,262,gender
感染性胃腸炎,2019,4,2019-W04,1072,995,2067,262,gender
水痘,2019,4,2019-W04,63,48,111,262,gender
手足口病,2019,4,2019-W04,13,15,28,262,gender
突発性発しん,2019,4,2019-W04,49,35,84,262,gender
ヘルパンギーナ,2019,4,2019-W04,3,3,6,262,gender
流行性耳下腺炎,2019,4,2019-W04,13,10,23,262,gender
川崎病,2019,4,2019-W04,1,3,4,262,gender
インフルエンザ,2007,41,2007-W41,16,8,24,285,gender
RSウイルス感染症,2007,41,2007-W41,7,8,15,149,gender
咽頭結膜熱,2007,41,2007-W41,14,7,21,149,gender
Ａ群溶血性レンサ球菌咽頭炎,2007,41,2007-W41,75,70,145,149,gender
感染性胃腸炎,2007,41,2007-W41,280,219,499,149,gender
水痘,2007,41,2007-W41,17,34,51,149,gender
手足口病,2007,41,2007-W41,64,49,113,149,gender
突発性発しん,2007,41,2007-W41,50,31,81,149,gender
ヘルパンギーナ,2007,41,2007-W41,31,25,56,149,gender
流行性耳下腺炎,2007,41,2007-W41,21,18,39,149,gender
川崎病,2007,41,2007-W41,1,3,4,149,gender
インフルエンザ,2018,25,2018-W25,15,20,35,416,gender
RSウイルス感染症,2018,25,2018-W25,39,43,82,262,gender
咽頭結膜熱,2018,25,2018-W25,106,92,198,262,gender
Ａ群溶血性レンサ球菌咽頭炎,2018,25,2018-W25,444,386,830,262,gender
感染性胃腸炎,2018,25,2018-W25,956,831,1787,262,gender
水痘,2018,25,2018-W25,42,42,84,262,gender
手足口病,2018,25,2018-W25,66,51,117,262,gender
突発性発しん,2018,25,2018-W25,111,72,183,262,gender
ヘルパンギーナ,2018,25,2018-W25,59,80,139,262,gender
流行性耳下腺炎,2018,25,2018-W25,25,18,43,262,gender
川崎病,2018,25,2018-W25,3,2,5,262,gender
インフルエンザ,2025,20,2025-W20,98,76,174,419,gender
新型コロナウイルス感染症（COVID-19）,2025,20,2025-W20,146,138,284,419,gender
RSウイルス感染症,2025,20,2025-W20,14,8,22,264,gender
咽頭結膜熱,2025,20,2025-W20,43,34,77,264,gender
Ａ群溶血性レンサ球菌咽頭炎,2025,20,2025-W20,705,460,1165,264,gender
感染性胃腸炎,2025,20,2025-W20,1056,927,1983,264,gender
水痘,2025,20,2025-W20,127,109,236,264,gender
手足口病,2025,20,2025-W20,28,19,47,264,gender
突発性発しん,2025,20,2025-W20,38,50,88,264,gender
ヘルパンギーナ,2025,20,2025-W20,5,5,10,264,gender
流行性耳下腺炎,2025,20,2025-W20,17,12,29,264,gender
川崎病,2025,20,2025-W20,0,1,1,264,gender
インフルエンザ,2010,20,2010-W20,12,13,25,287,gender
RSウイルス感染症,2010,20,2010-W20,6,8,14,149,gender
咽頭結膜熱,2010,20,2010-W20,23,16,39,149,gender
Ａ群溶血性レンサ球菌咽頭炎,2010,20,2010-W20,158,137,295,149,gender
感染性胃腸炎,2010,20,2010-W20,574,551,1125,149,gender
水痘,2010,20,2010-W20,124,98,222,149,gender
手足口病,2010,20,2010-W20,56,47,103,149,gender
突発性発しん,2010,20,2010-W20,42,53,95,149,gender
ヘルパンギーナ,2010,20,2010-W20,31,30,61,149,gender
流行性耳下腺炎,2010,20,2010-W20,71,62,133,149,gender
川崎病,2010,20,2010-W20,1,0,1,149,gender
インフルエンザ,2002,14,2002-W14,53,37,90,178,gender
RSウイルス感染症,2002,14,2002-W14,0,0,0,142,gender
咽頭結膜熱,2002,14,2002-W14,1,1,2,142,gender
Ａ群溶血性レンサ球菌咽頭炎,2002,14,2002-W14,30,32,62,142,gender
感染性胃腸炎,2002,14,2002-W14,245,257,502,142,gender
水痘,2002,14,2002-W14,64,75,139,142,gender
手足口病,2002,14,2002-W14,13,12,25,142,gender
突発性発しん,2002,14,2002-W14,45,43,88,142,gender
ヘルパンギーナ,2002,14,2002-W14,5,3,8,142,gender
流行性耳下腺炎,2002,14,2002-W14,49,45,94,142,gender
川崎病,2002,14,2002-W14,1,0,1,142,gender
インフルエンザ,2009,43,2009-W43,3784,3517,7301,288,gender
RSウイルス感染症,2009,43,2009-W43,6,6,12,148,gender
咽頭結膜熱,2009,43,2009-W43,6,5,11,148,gender
Ａ群溶血性レンサ球菌咽頭炎,2009,43,2009-W43,65,49,114,148,gender
感染性胃腸炎,2009,43,2009-W43,163,161,324,148,gender
水痘,2009,43,2009-W43,42,30,72,148,gender
手足口病,2009,43,2009-W43,38,37,75,148,gender
突発性発しん,2009,43,2009-W43,46,47,93,148,gender
ヘルパンギーナ,2009,43,2009-W43,12,17,29,148,gender
流行性耳下腺炎,2009,43,2009-W43,65,52,117,148,gender
川崎病,2009,43,2009-W43,0,2,2,148,gender
インフルエンザ,2004,13,2004-W13,24,19,43,178,gender
RSウイルス感染症,2004,13,2004-W13,1,0,1,142,gender
咽頭結膜熱,2004,13,2004-W13,9,12,21,142,gender
Ａ群溶血性レンサ球菌咽頭炎,2004,13,2004-W13,109,72,181,142,gender
感染性胃腸炎,2004,13,2004-W13,515,486,1001,142,gender
水痘,2004,13,2004-W13,94,92,186,142,gender
手足口病,2004,13,2004-W13,1,1,2,142,gender
突発性発しん,2004,13,2004-W13,32,36,68,142,gender
ヘルパンギーナ,2004,13,2004-W13,0,1,1,142,gender
流行性耳下腺炎,2004,13,2004-W13,16,17,33,142,gender
川崎病,2004,13,2004-W13,1,0,1,142,gender
インフルエンザ,2017,49,2017-W49,1144,1045,2189,416,gender
RSウイルス感染症,2017,49,2017-W49,41,64,105,262,gender
咽頭結膜熱,2017,49,2017-W49,114,72,186,262,gender
Ａ群溶血性レンサ球菌咽頭炎,2017,49,2017-W49,532,447,979,262,gender
感染性胃腸炎,2017,49,2017-W49,1722,1580,3302,262,gender
水痘,2017,49,2017-W49,100,76,176,262,gender
手足口病,2017,49,2017-W49,90,94,184,262,gender
突発性発しん,2017,49,2017-W49,63,69,132,262,gender
ヘルパンギーナ,2017,49,2017-W49,3,7,10,262,gender
流行性耳下腺炎,2017,49,2017-W49,21,10,31,262,gender
川崎病,2017,49,2017-W49,2,3,5,262,gender
インフルエンザ,2020,3,2020-W03,2431,2458,4889,416,gender
RSウイルス感染症,2020,3,2020-W03,20,11,31,262,gender
咽頭結膜熱,2020,3,2020-W03,23,18,41,262,gender
Ａ群溶血性レンサ球菌咽頭炎,2020,3,2020-W03,332,303,635,262,gender
感染性胃腸炎,2020,3,2020-W03,1082,983,2065,262,gender
水痘,2020,3,2020-W03,43,28,71,262,gender
手足口病,2020,3,2020-W03,14,12,26,262,gender
突発性発しん,2020,3,2020-W03,56,41,97,262,gender
ヘルパンギーナ,2020,3,2020-W03,10,5,15,262,gender
流行性耳下腺炎,2020,3,2020-W03,4,7,11,262,gender
川崎病,2020,3,2020-W03,7,0,7,262,gender
インフルエンザ,2016,27,2016-W27,6,3,9,414,gender
RSウイルス感染症,2016,27,2016-W27,14,11,25,261,gender
咽頭結膜熱,2016,27,2016-W27,80,68,148,261,gender
Ａ群溶血性レンサ球菌咽頭炎,2016,27,2016-W27,381,347,728,261,gender
感染性胃腸炎,2016,27,2016-W27,786,656,1442,261,gender
水痘,2016,27,2016-W27,60,56,116,261,gender
手足口病,2016,27,2016-W27,112,79,191,261,gender
突発性発しん,2016,27,2016-W27,74,88,162,261,gender
ヘルパンギーナ,2016,27,2016-W27,554,501,1055,261,gender
流行性耳下腺炎,2016,27,2016-W27,129,94,223,261,gender
川崎病,2016,27,2016-W27,0,1,1,261,gender
インフルエンザ,2008,13,2008-W13,113,120,233,288,gender
RSウイルス感染症,2008,13,2008-W13,6,6,12,149,gender
咽頭結膜熱,2008,13,2008-W13,19,13,32,149,gender
Ａ群溶血性レンサ球菌咽頭炎,2008,13,2008-W13,142,122,264,149,gender
感染性胃腸炎,2008,13,2008-W13,746,665,1411,149,gender
水痘,2008,13,2008-W13,114,87,201,149,gender
手足口病,2008,13,2008-W13,4,3,7,149,gender
突発性発しん,2008,13,2008-W13,39,45,84,149,gender
ヘルパンギーナ,2008,13,2008-W13,1,1,2,149,gender
流行性耳下腺炎,2008,13,2008-W13,42,30,72,149,gender
川崎病,2008,13,2008-W13,1,2,3,149,gender
インフルエンザ,2005,43,2005-W43,1,1,2,178,gender
RSウイルス感染症,2005,43,2005-W43,20,13,33,142,gender
咽頭結膜熱,2005,43,2005-W43,20,21,41,142,gender
Ａ群溶血性レンサ球菌咽頭炎,2005,43,2005-W43,69,69,138,142,gender
感染性胃腸炎,2005,43,2005-W43,253,204,457,142,gender
水痘,2005,43,2005-W43,59,54,113,142,gender
手足口病,2005,43,2005-W43,28,25,53,142,gender
突発性発しん,2005,43,2005-W43,44,50,94,142,gender
ヘルパンギーナ,2005,43,2005-W43,13,17,30,142,gender
流行性耳下腺炎,2005,43,2005-W43,76,77,153,142,gender
川崎病,2005,43,2005-W43,1,1,2,142,gender
インフルエンザ,2007,30,2007-W30,2,0,2,287,gender
RSウイルス感染症,2007,30,2007-W30,3,1,4,150,gender
咽頭結膜熱,2007,30,2007-W30,69,47,116,150,gender
Ａ群溶血性レンサ球菌咽頭炎,2007,30,2007-W30,109,84,193,150,gender
感染性胃腸炎,2007,30,2007-W30,322,230,552,150,gender
水痘,2007,30,2007-W30,44,45,89,150,gender
手足口病,2007,30,2007-W30,241,166,407,150,gender
突発性発しん,2007,30,2007-W30,57,50,107,150,gender
ヘルパンギーナ,2007,30,2007-W30,619,530,1149,150,gender
流行性耳下腺炎,2007,30,2007-W30,25,21,46,150,gender
川崎病,2007,30,2007-W30,0,0,0,150,gender
インフルエンザ,2016,19,2016-W19,55,44,99,413,gender
RSウイルス感染症,2016,19,2016-W19,8,6,14,261,gender
咽頭結膜熱,2016,19,2016-W19,84,63,147,261,gender
Ａ群溶血性レンサ球菌咽頭炎,2016,19,2016-W19,377,317,694,261,gender
感染性胃腸炎,2016,19,2016-W19,766,675,1441,261,gender
水痘,2016,19,2016-W19,67,56,123,261,gender
手足口病,2016,19,2016-W19,9,10,19,261,gender
突発性発しん,2016,19,2016-W19,108,88,196,261,gender
ヘルパンギーナ,2016,19,2016-W19,8,12,20,261,gender
流行性耳下腺炎,2016,19,2016-W19,77,67,144,261,gender
川崎病,2016,19,2016-W19,2,2,4,261,gender
インフルエンザ,2022,38,2022-W38,4,3,7,414,gender
RSウイルス感染症,2022,38,2022-W38,215,188,403,261,gender
咽頭結膜熱,2022,38,2022-W38,2,1,3,261,gender
Ａ群溶血性レンサ球菌咽頭炎,2022,38,2022-W38,21,23,44,261,gender
感染性胃腸炎,2022,38,2022-W38,234,215,449,261,gender
水痘,2022,38,2022-W38,5,6,11,261,gender
手足口病,2022,38,2022-W38,423,349,772,261,gender
突発性発しん,2022,38,2022-W38,26,23,49,261,gender
ヘルパンギーナ,2022,38,2022-W38,78,70,148,261,gender
流行性耳下腺炎,2022,38,2022-W38,7,3,10,261,gender
川崎病,2022,38,2022-W38,1,1,2,261,gender
インフルエンザ,2003,44,2003-W44,1,2,3,178,gender
RSウイルス感染症,2003,44,2003-W44,0,0,0,142,gender
咽頭結膜熱,2003,44,2003-W44,11,11,22,142,gender
Ａ群溶血性レンサ球菌咽頭炎,2003,44,2003-W44,47,43,90,142,gender
感染性胃腸炎,2003,44,2003-W44,315,298,613,142,gender
水痘,2003,44,2003-W44,64,46,110,142,gender
手足口病,2003,44,2003-W44,12,13,25,142,gender
突発性発しん,2003,44,2003-W44,32,31,63,142,gender
ヘルパンギーナ,2003,44,2003-W44,8,8,16,142,gender
流行性耳下腺炎,2003,44,2003-W44,15,5,20,142,gender
川崎病,2003,44,2003-W44,0,0,0,142,gender
インフルエンザ,2014,7,2014-W07,5845,5898,11743,413,gender
RSウイルス感染症,2014,7,2014-W07,22,16,38,259,gender
咽頭結膜熱,2014,7,2014-W07,22,18,40,259,gender
Ａ群溶血性レンサ球菌咽頭炎,2014,7,2014-W07,194,180,374,259,gender
感染性胃腸炎,2014,7,2014-W07,718,635,1353,259,gender
水痘,2014,7,2014-W07,101,83,184,259,gender
手足口病,2014,7,2014-W07,8,8,16,259,gender
突発性発しん,2014,7,2014-W07,40,38,78,259,gender
ヘルパンギーナ,2014,7,2014-W07,3,1,4,259,gender
流行性耳下腺炎,2014,7,2014-W07,18,16,34,259,gender
川崎病,2014,7,2014-W07,1,1,2,259,gender
インフルエンザ,2001,37,2001-W37,0,0,0,178,gender
RSウイルス感染症,2001,37,2001-W37,0,0,0,142,gender
咽頭結膜熱,2001,37,2001-W37,6,11,17,142,gender
Ａ群溶血性レンサ球菌咽頭炎,2001,37,2001-W37,6,14,20,142,gender
感染性胃腸炎,2001,37,2001-W37,114,118,232,142,gender
水痘,2001,37,2001-W37,21,19,40,142,gender
手足口病,2001,37,2001-W37,17,6,23,142,gender
突発性発しん,2001,37,2001-W37,43,46,89,142,gender
ヘルパンギーナ,2001,37,2001-W37,17,17,34,142,gender
流行性耳下腺炎,2001,37,2001-W37,41,32,73,142,gender
川崎病,2001,37,2001-W37,0,0,0,142,gender
インフルエンザ,2021,25,2021-W25,0,0,0,411,gender
RSウイルス感染症,2021,25,2021-W25,656,582,1238,259,gender
咽頭結膜熱,2021,25,2021-W25,25,23,48,259,gender
Ａ群溶血性レンサ球菌咽頭炎,2021,25,2021-W25,47,47,94,259,gender
感染性胃腸炎,2021,25,2021-W25,523,480,1003,259,gender
水痘,2021,25,2021-W25,8,13,21,259,gender
手足口病,2021,25,2021-W25,8,10,18,259,gender
突発性発しん,2021,25,2021-W25,75,45,120,259,gender
ヘルパンギーナ,2021,25,2021-W25,10,9,19,259,gender
流行性耳下腺炎,2021,25,2021-W25,10,6,16,259,gender
川崎病,2021,25,2021-W25,4,2,6,259,gender
インフルエンザ,2010,49,2010-W49,146,155,301,289,gender
RSウイルス感染症,2010,49,2010-W49,62,46,108,150,gender
咽頭結膜熱,2010,49,2010-W49,43,46,89,150,gender
Ａ群溶血性レンサ球菌咽頭炎,2010,49,2010-W49,185,200,385,150,gender
感染性胃腸炎,2010,49,2010-W49,1478,1424,2902,150,gender
水痘,2010,49,2010-W49,123,128,251,150,gender
手足口病,2010,49,2010-W49,12,7,19,150,gender
突発性発しん,2010,49,2010-W49,44,37,81,150,gender
ヘルパンギーナ,2010,49,2010-W49,7,8,15,150,gender
流行性耳下腺炎,2010,49,2010-W49,28,28,56,150,gender
川崎病,2010,49,2010-W49,2,1,3,150,gender
インフルエンザ,2003,13,2003-W13,62,58,120,178,gender
RSウイルス感染症,2003,13,2003-W13,0,0,0,142,gender
咽頭結膜熱,2003,13,2003-W13,1,3,4,142,gender
Ａ群溶血性レンサ球菌咽頭炎,2003,13,2003-W13,34,23,57,142,gender
感染性胃腸炎,2003,13,2003-W13,429,417,846,142,gender
水痘,2003,13,2003-W13,74,54,128,142,gender
手足口病,2003,13,2003-W13,4,6,10,142,gender
突発性発しん,2003,13,2003-W13,39,32,71,142,gender
ヘルパンギーナ,2003,13,2003-W13,1,1,2,142,gender
流行性耳下腺炎,2003,13,2003-W13,22,15,37,142,gender
川崎病,2003,13,2003-W13,0,1,1,142,gender
インフルエンザ,2011,27,2011-W27,3,12,15,417,gender
RSウイルス感染症,2011,27,2011-W27,11,13,24,263,gender
咽頭結膜熱,2011,27,2011-W27,125,75,200,263,gender
Ａ群溶血性レンサ球菌咽頭炎,2011,27,2011-W27,244,195,439,263,gender
感染性胃腸炎,2011,27,2011-W27,607,478,1085,263,gender
水痘,2011,27,2011-W27,150,143,293,263,gender
手足口病,2011,27,2011-W27,708,617,1325,263,gender
突発性発しん,2011,27,2011-W27,104,79,183,263,gender
ヘルパンギーナ,2011,27,2011-W27,472,413,885,263,gender
流行性耳下腺炎,2011,27,2011-W27,82,63,145,263,gender
川崎病,2011,27,2011-W27,3,6,9,263,gender
インフルエンザ,2018,9,2018-W09,2484,2504,4988,414,gender
RSウイルス感染症,2018,9,2018-W09,41,34,75,261,gender
咽頭結膜熱,2018,9,2018-W09,18,13,31,261,gender
Ａ群溶血性レンサ球菌咽頭炎,2018,9,2018-W09,364,321,685,261,gender
感染性胃腸炎,2018,9,2018-W09,705,616,1321,261,gender
水痘,2018,9,2018-W09,35,43,78,261,gender
手足口病,2018,9,2018-W09,2,4,6,261,gender
突発性発しん,2018,9,2018-W09,53,47,100,261,gender
ヘルパンギーナ,2018,9,2018-W09,4,2,6,261,gender
流行性耳下腺炎,2018,9,2018-W09,11,6,17,261,gender
川崎病,2018,9,2018-W09,3,2,5,261,gender
インフルエンザ,2017,20,2017-W20,117,134,251,414,gender
RSウイルス感染症,2017,20,2017-W20,34,18,52,262,gender
咽頭結膜熱,2017,20,2017-W20,88,69,157,262,gender
Ａ群溶血性レンサ球菌咽頭炎,2017,20,2017-W20,459,402,861,262,gender
感染性胃腸炎,2017,20,2017-W20,1174,984,2158,262,gender
水痘,2017,20,2017-W20,52,52,104,262,gender
手足口病,2017,20,2017-W20,49,47,96,262,gender
突発性発しん,2017,20,2017-W20,75,95,170,262,gender
ヘルパンギーナ,2017,20,2017-W20,7,12,19,262,gender
流行性耳下腺炎,2017,20,2017-W20,38,33,71,262,gender
川崎病,2017,20,2017-W20,2,0,2,262,gender
インフルエンザ,2015,53,2015-W53,93,75,168,391,gender
RSウイルス感染症,2015,53,2015-W53,55,58,113,243,gender
咽頭結膜熱,2015,53,2015-W53,30,27,57,243,gender
Ａ群溶血性レンサ球菌咽頭炎,2015,53,2015-W53,126,148,274,243,gender
感染性胃腸炎,2015,53,2015-W53,631,545,1176,243,gender
水痘,2015,53,2015-W53,51,47,98,243,gender
手足口病,2015,53,2015-W53,2,1,3,243,gender
突発性発しん,2015,53,2015-W53,29,24,53,243,gender
ヘルパンギーナ,2015,53,2015-W53,1,1,2,243,gender
流行性耳下腺炎,2015,53,2015-W53,34,29,63,243,gender
川崎病,2015,53,2015-W53,1,1,2,243,gender
インフルエンザ,2013,7,2013-W07,1871,1931,3802,417,gender
RSウイルス感染症,2013,7,2013-W07,40,33,73,262,gender
咽頭結膜熱,2013,7,2013-W07,22,24,46,262,gender
Ａ群溶血性レンサ球菌咽頭炎,2013,7,2013-W07,258,237,495,262,gender
感染性胃腸炎,2013,7,2013-W07,990,962,1952,262,gender
水痘,2013,7,2013-W07,94,65,159,262,gender
手足口病,2013,7,2013-W07,8,6,14,262,gender
突発性発しん,2013,7,2013-W07,68,49,117,262,gender
ヘルパンギーナ,2013,7,2013-W07,1,1,2,262,gender
流行性耳下腺炎,2013,7,2013-W07,24,20,44,262,gender
川崎病,2013,7,2013-W07,3,1,4,262,gender
インフルエンザ,2008,44,2008-W44,3,8,11,283,gender
RSウイルス感染症,2008,44,2008-W44,80,76,156,145,gender
咽頭結膜熱,2008,44,2008-W44,14,13,27,145,gender
Ａ群溶血性レンサ球菌咽頭炎,2008,44,2008-W44,127,107,234,145,gender
感染性胃腸炎,2008,44,2008-W44,356,322,678,145,gender
水痘,2008,44,2008-W44,53,58,111,145,gender
手足口病,2008,44,2008-W44,72,57,129,145,gender
突発性発しん,2008,44,2008-W44,56,46,102,145,gender
ヘルパンギーナ,2008,44,2008-W44,6,8,14,145,gender
流行性耳下腺炎,2008,44,2008-W44,38,32,70,145,gender
川崎病,2008,44,2008-W44,0,0,0,145,gender
インフルエンザ,2005,14,2005-W14,196,200,396,178,gender
RSウイルス感染症,2005,14,2005-W14,4,2,6,142,gender
咽頭結膜熱,2005,14,2005-W14,8,6,14,142,gender
Ａ群溶血性レンサ球菌咽頭炎,2005,14,2005-W14,62,62,124,142,gender
感染性胃腸炎,2005,14,2005-W14,401,331,732,142,gender
水痘,2005,14,2005-W14,71,67,138,142,gender
手足口病,2005,14,2005-W14,8,1,9,142,gender
突発性発しん,2005,14,2005-W14,42,43,85,142,gender
ヘルパンギーナ,2005,14,2005-W14,4,2,6,142,gender
流行性耳下腺炎,2005,14,2005-W14,70,72,142,142,gender
川崎病,2005,14,2005-W14,1,3,4,142,gender
インフルエンザ,2006,37,2006-W37,0,0,0,178,gender
RSウイルス感染症,2006,37,2006-W37,2,2,4,142,gender
咽頭結膜熱,2006,37,2006-W37,22,27,49,142,gender
Ａ群溶血性レンサ球菌咽頭炎,2006,37,2006-W37,56,52,108,142,gender
感染性胃腸炎,2006,37,2006-W37,180,142,322,142,gender
水痘,2006,37,2006-W37,27,19,46,142,gender
手足口病,2006,37,2006-W37,64,57,121,142,gender
突発性発しん,2006,37,2006-W37,46,54,100,142,gender
ヘルパンギーナ,2006,37,2006-W37,15,30,45,142,gender
流行性耳下腺炎,2006,37,2006-W37,31,21,52,142,gender
川崎病,2006,37,2006-W37,1,2,3,142,gender
インフルエンザ,2009,14,2009-W14,760,669,1429,287,gender
RSウイルス感染症,2009,14,2009-W14,2,3,5,147,gender
咽頭結膜熱,2009,14,2009-W14,14,9,23,147,gender
Ａ群溶血性レンサ球菌咽頭炎,2009,14,2009-W14,101,117,218,147,gender
感染性胃腸炎,2009,14,2009-W14,455,378,833,147,gender
水痘,2009,14,2009-W14,89,72,161,147,gender
手足口病,2009,14,2009-W14,9,9,18,147,gender
突発性発しん,2009,14,2009-W14,50,42,92,147,gender
ヘルパンギーナ,2009,14,2009-W14,4,3,7,147,gender
流行性耳下腺炎,2009,14,2009-W14,60,51,111,147,gender
川崎病,2009,14,2009-W14,0,0,0,147,gender
インフルエンザ,2004,44,2004-W44,13,23,36,178,gender
RSウイルス感染症,2004,44,2004-W44,6,8,14,142,gender
咽頭結膜熱,2004,44,2004-W44,11,6,17,142,gender
Ａ群溶血性レンサ球菌咽頭炎,2004,44,2004-W44,51,37,88,142,gender
感染性胃腸炎,2004,44,2004-W44,211,195,406,142,gender
水痘,2004,44,2004-W44,48,40,88,142,gender
手足口病,2004,44,2004-W44,63,65,128,142,gender
突発性発しん,2004,44,2004-W44,35,40,75,142,gender
ヘルパンギーナ,2004,44,2004-W44,12,7,19,142,gender
流行性耳下腺炎,2004,44,2004-W44,42,46,88,142,gender
川崎病,2004,44,2004-W44,1,1,2,142,gender
インフルエンザ,2020,22,2020-W22,0,0,0,412,gender
RSウイルス感染症,2020,22,2020-W22,0,0,0,259,gender
咽頭結膜熱,2020,22,2020-W22,0,0,0,259,gender
Ａ群溶血性レンサ球菌咽頭炎,2020,22,2020-W22,35,29,64,259,gender
感染性胃腸炎,2020,22,2020-W22,168,151,319,259,gender
水痘,2020,22,2020-W22,7,4,11,259,gender
手足口病,2020,22,2020-W22,9,9,18,259,gender
突発性発しん,2020,22,2020-W22,45,41,86,259,gender
ヘルパンギーナ,2020,22,2020-W22,2,4,6,259,gender
流行性耳下腺炎,2020,22,2020-W22,10,3,13,259,gender
川崎病,2020,22,2020-W22,2,0,2,259,gender
インフルエンザ,2022,51,2022-W51,544,396,940,412,gender
RSウイルス感染症,2022,51,2022-W51,20,11,31,261,gender
咽頭結膜熱,2022,51,2022-W51,27,24,51,261,gender
Ａ群溶血性レンサ球菌咽頭炎,2022,51,2022-W51,28,24,52,261,gender
感染性胃腸炎,2022,51,2022-W51,1450,1327,2777,261,gender
水痘,2022,51,2022-W51,13,9,22,261,gender
手足口病,2022,51,2022-W51,19,19,38,261,gender
突発性発しん,2022,51,2022-W51,26,27,53,261,gender
ヘルパンギーナ,2022,51,2022-W51,3,5,8,261,gender
流行性耳下腺炎,2022,51,2022-W51,7,4,11,261,gender
川崎病,2022,51,2022-W51,3,0,3,261,gender
インフルエンザ,2000,30,2000-W30,0,0,0,178,gender
RSウイルス感染症,2000,30,2000-W30,0,0,0,142,gender
咽頭結膜熱,2000,30,2000-W30,20,11,31,142,gender
Ａ群溶血性レンサ球菌咽頭炎,2000,30,2000-W30,18,12,30,142,gender
感染性胃腸炎,2000,30,2000-W30,104,91,195,142,gender
水痘,2000,30,2000-W30,45,38,83,142,gender
手足口病,2000,30,2000-W30,275,234,509,142,gender
突発性発しん,2000,30,2000-W30,35,35,70,142,gender
ヘルパンギーナ,2000,30,2000-W30,291,280,571,142,gender
流行性耳下腺炎,2000,30,2000-W30,57,47,104,142,gender
川崎病,2000,30,2000-W30,1,1,2,142,gender
インフルエンザ,2011,19,2011-W19,153,155,308,416,gender
RSウイルス感染症,2011,19,2011-W19,4,6,10,262,gender
咽頭結膜熱,2011,19,2011-W19,52,35,87,262,gender
Ａ群溶血性レンサ球菌咽頭炎,2011,19,2011-W19,359,301,660,262,gender
感染性胃腸炎,2011,19,2011-W19,1004,874,1878,262,gender
水痘,2011,19,2011-W19,209,194,403,262,gender
手足口病,2011,19,2011-W19,12,6,18,262,gender
突発性発しん,2011,19,2011-W19,90,86,176,262,gender
ヘルパンギーナ,2011,19,2011-W19,8,6,14,262,gender
流行性耳下腺炎,2011,19,2011-W19,60,42,102,262,gender
川崎病,2011,19,2011-W19,4,0,4,262,gender
インフルエンザ,2002,43,2002-W43,0,1,1,178,gender
RSウイルス感染症,2002,43,2002-W43,0,0,0,142,gender
咽頭結膜熱,2002,43,2002-W43,5,4,9,142,gender
Ａ群溶血性レンサ球菌咽頭炎,2002,43,2002-W43,28,27,55,142,gender
感染性胃腸炎,2002,43,2002-W43,196,182,378,142,gender
水痘,2002,43,2002-W43,37,36,73,142,gender
手足口病,2002,43,2002-W43,34,18,52,142,gender
突発性発しん,2002,43,2002-W43,33,43,76,142,gender
ヘルパンギーナ,2002,43,2002-W43,14,5,19,142,gender
流行性耳下腺炎,2002,43,2002-W43,27,29,56,142,gender
川崎病,2002,43,2002-W43,0,2,2,142,gender
インフルエンザ,2007,16,2007-W16,411,340,751,284,gender
RSウイルス感染症,2007,16,2007-W16,4,5,9,147,gender
咽頭結膜熱,2007,16,2007-W16,39,28,67,147,gender
Ａ群溶血性レンサ球菌咽頭炎,2007,16,2007-W16,147,116,263,147,gender
感染性胃腸炎,2007,16,2007-W16,420,405,825,147,gender
水痘,2007,16,2007-W16,109,79,188,147,gender
手足口病,2007,16,2007-W16,6,2,8,147,gender
突発性発しん,2007,16,2007-W16,46,47,93,147,gender
ヘルパンギーナ,2007,16,2007-W16,11,4,15,147,gender
流行性耳下腺炎,2007,16,2007-W16,16,11,27,147,gender
川崎病,2007,16,2007-W16,0,0,0,147,gender
インフルエンザ,2024,19,2024-W19,43,39,82,419,gender
新型コロナウイルス感染症（COVID-19）,2024,19,2024-W19,450,505,955,419,gender
RSウイルス感染症,2024,19,2024-W19,162,124,286,264,gender
咽頭結膜熱,2024,19,2024-W19,57,36,93,264,gender
Ａ群溶血性レンサ球菌咽頭炎,2024,19,2024-W19,394,354,748,264,gender
感染性胃腸炎,2024,19,2024-W19,537,475,1012,264,gender
水痘,2024,19,2024-W19,36,32,68,264,gender
手足口病,2024,19,2024-W19,34,36,70,264,gender
突発性発しん,2024,19,2024-W19,44,40,84,264,gender
ヘルパンギーナ,2024,19,2024-W19,4,1,5,264,gender
流行性耳下腺炎,2024,19,2024-W19,9,11,20,264,gender
川崎病,2024,19,2024-W19,9,1,10,264,gender
インフルエンザ,2008,35,2008-W35,0,2,2,282,gender
RSウイルス感染症,2008,35,2008-W35,8,4,12,146,gender
咽頭結膜熱,2008,35,2008-W35,41,30,71,146,gender
Ａ群溶血性レンサ球菌咽頭炎,2008,35,2008-W35,53,46,99,146,gender
感染性胃腸炎,2008,35,2008-W35,219,204,423,146,gender
水痘,2008,35,2008-W35,20,13,33,146,gender
手足口病,2008,35,2008-W35,71,48,119,146,gender
突発性発しん,2008,35,2008-W35,65,46,111,146,gender
ヘルパンギーナ,2008,35,2008-W35,101,90,191,146,gender
流行性耳下腺炎,2008,35,2008-W35,46,31,77,146,gender
川崎病,2008,35,2008-W35,0,0,0,146,gender
インフルエンザ,2010,6,2010-W06,359,395,754,286,gender
RSウイルス感染症,2010,6,2010-W06,46,45,91,147,gender
咽頭結膜熱,2010,6,2010-W06,8,10,18,147,gender
Ａ群溶血性レンサ球菌咽頭炎,2010,6,2010-W06,153,141,294,147,gender
感染性胃腸炎,2010,6,2010-W06,939,857,1796,147,gender
水痘,2010,6,2010-W06,81,68,149,147,gender
手足口病,2010,6,2010-W06,7,7,14,147,gender
突発性発しん,2010,6,2010-W06,33,32,65,147,gender
ヘルパンギーナ,2010,6,2010-W06,0,0,0,147,gender
流行性耳下腺炎,2010,6,2010-W06,35,34,69,147,gender
川崎病,2010,6,2010-W06,1,2,3,147,gender
インフルエンザ,2017,51,2017-W51,2904,2917,5821,415,gender
RSウイルス感染症,2017,51,2017-W51,58,45,103,262,gender
咽頭結膜熱,2017,51,2017-W51,106,78,184,262,gender
Ａ群溶血性レンサ球菌咽頭炎,2017,51,2017-W51,516,458,974,262,gender
感染性胃腸炎,2017,51,2017-W51,1739,1585,3324,262,gender
水痘,2017,51,2017-W51,74,71,145,262,gender
手足口病,2017,51,2017-W51,56,41,97,262,gender
突発性発しん,2017,51,2017-W51,54,61,115,262,gender
ヘルパンギーナ,2017,51,2017-W51,5,5,10,262,gender
流行性耳下腺炎,2017,51,2017-W51,11,5,16,262,gender
川崎病,2017,51,2017-W51,5,4,9,262,gender
インフルエンザ,2015,22,2015-W22,19,17,36,415,gender
RSウイルス感染症,2015,22,2015-W22,11,4,15,261,gender
咽頭結膜熱,2015,22,2015-W22,119,124,243,261,gender
Ａ群溶血性レンサ球菌咽頭炎,2015,22,2015-W22,598,509,1107,261,gender
感染性胃腸炎,2015,22,2015-W22,975,936,1911,261,gender
水痘,2015,22,2015-W22,96,75,171,261,gender
手足口病,2015,22,2015-W22,145,125,270,261,gender
突発性発しん,2015,22,2015-W22,121,98,219,261,gender
ヘルパンギーナ,2015,22,2015-W22,30,26,56,261,gender
流行性耳下腺炎,2015,22,2015-W22,40,28,68,261,gender
川崎病,2015,22,2015-W22,1,2,3,261,gender
インフルエンザ,2013,25,2013-W25,13,15,28,414,gender
RSウイルス感染症,2013,25,2013-W25,10,14,24,261,gender
咽頭結膜熱,2013,25,2013-W25,137,121,258,261,gender
Ａ群溶血性レンサ球菌咽頭炎,2013,25,2013-W25,344,263,607,261,gender
感染性胃腸炎,2013,25,2013-W25,674,566,1240,261,gender
水痘,2013,25,2013-W25,143,154,297,261,gender
手足口病,2013,25,2013-W25,300,236,536,261,gender
突発性発しん,2013,25,2013-W25,106,100,206,261,gender
ヘルパンギーナ,2013,25,2013-W25,86,97,183,261,gender
流行性耳下腺炎,2013,25,2013-W25,45,31,76,261,gender
川崎病,2013,25,2013-W25,1,8,9,261,gender
インフルエンザ,2001,11,2001-W11,391,429,820,178,gender
RSウイルス感染症,2001,11,2001-W11,0,0,0,142,gender
咽頭結膜熱,2001,11,2001-W11,2,2,4,142,gender
Ａ群溶血性レンサ球菌咽頭炎,2001,11,2001-W11,30,33,63,142,gender
感染性胃腸炎,2001,11,2001-W11,488,482,970,142,gender
水痘,2001,11,2001-W11,86,91,177,142,gender
手足口病,2001,11,2001-W11,2,1,3,142,gender
突発性発しん,2001,11,2001-W11,28,22,50,142,gender
ヘルパンギーナ,2001,11,2001-W11,10,6,16,142,gender
流行性耳下腺炎,2001,11,2001-W11,85,57,142,142,gender
川崎病,2001,11,2001-W11,0,0,0,142,gender
インフルエンザ,2010,38,2010-W38,8,12,20,286,gender
RSウイルス感染症,2010,38,2010-W38,7,4,11,148,gender
咽頭結膜熱,2010,38,2010-W38,13,5,18,148,gender
Ａ群溶血性レンサ球菌咽頭炎,2010,38,2010-W38,57,49,106,148,gender
感染性胃腸炎,2010,38,2010-W38,244,165,409,148,gender
水痘,2010,38,2010-W38,30,24,54,148,gender
手足口病,2010,38,2010-W38,60,34,94,148,gender
突発性発しん,2010,38,2010-W38,46,46,92,148,gender
ヘルパンギーナ,2010,38,2010-W38,27,22,49,148,gender
流行性耳下腺炎,2010,38,2010-W38,31,22,53,148,gender
川崎病,2010,38,2010-W38,0,0,0,148,gender
インフルエンザ,2000,41,2000-W41,1,1,2,178,gender
RSウイルス感染症,2000,41,2000-W41,0,0,0,142,gender
咽頭結膜熱,2000,41,2000-W41,2,2,4,142,gender
Ａ群溶血性レンサ球菌咽頭炎,2000,41,2000-W41,19,20,39,142,gender
感染性胃腸炎,2000,41,2000-W41,128,123,251,142,gender
水痘,2000,41,2000-W41,22,17,39,142,gender
手足口病,2000,41,2000-W41,93,67,160,142,gender
突発性発しん,2000,41,2000-W41,34,29,63,142,gender
ヘルパンギーナ,2000,41,2000-W41,16,12,28,142,gender
流行性耳下腺炎,2000,41,2000-W41,43,48,91,142,gender
川崎病,2000,41,2000-W41,0,1,1,142,gender
インフルエンザ,2024,2,2024-W02,2111,2081,4192,414,gender
新型コロナウイルス感染症（COVID-19）,2024,2,2024-W02,1112,1227,2339,414,gender
RSウイルス感染症,2024,2,2024-W02,4,1,5,261,gender
咽頭結膜熱,2024,2,2024-W02,116,127,243,261,gender
Ａ群溶血性レンサ球菌咽頭炎,2024,2,2024-W02,399,346,745,261,gender
感染性胃腸炎,2024,2,2024-W02,1074,982,2056,261,gender
水痘,2024,2,2024-W02,23,27,50,261,gender
手足口病,2024,2,2024-W02,17,8,25,261,gender
突発性発しん,2024,2,2024-W02,36,27,63,261,gender
ヘルパンギーナ,2024,2,2024-W02,3,1,4,261,gender
流行性耳下腺炎,2024,2,2024-W02,8,8,16,261,gender
川崎病,2024,2,2024-W02,1,2,3,261,gender
インフルエンザ,2002,32,2002-W32,0,0,0,178,gender
RSウイルス感染症,2002,32,2002-W32,0,0,0,142,gender
咽頭結膜熱,2002,32,2002-W32,15,15,30,142,gender
Ａ群溶血性レンサ球菌咽頭炎,2002,32,2002-W32,8,8,16,142,gender
感染性胃腸炎,2002,32,2002-W32,108,85,193,142,gender
水痘,2002,32,2002-W32,31,32,63,142,gender
手足口病,2002,32,2002-W32,57,45,102,142,gender
突発性発しん,2002,32,2002-W32,37,35,72,142,gender
ヘルパンギーナ,2002,32,2002-W32,84,82,166,142,gender
流行性耳下腺炎,2002,32,2002-W32,41,33,74,142,gender
川崎病,2002,32,2002-W32,0,0,0,142,gender
インフルエンザ,2020,53,2020-W53,0,1,1,387,gender
RSウイルス感染症,2020,53,2020-W53,2,2,4,241,gender
咽頭結膜熱,2020,53,2020-W53,11,5,16,241,gender
Ａ群溶血性レンサ球菌咽頭炎,2020,53,2020-W53,22,31,53,241,gender
感染性胃腸炎,2020,53,2020-W53,156,135,291,241,gender
水痘,2020,53,2020-W53,4,4,8,241,gender
手足口病,2020,53,2020-W53,1,1,2,241,gender
突発性発しん,2020,53,2020-W53,30,18,48,241,gender
ヘルパンギーナ,2020,53,2020-W53,2,1,3,241,gender
流行性耳下腺炎,2020,53,2020-W53,4,0,4,241,gender
川崎病,2020,53,2020-W53,0,2,2,241,gender
インフルエンザ,2007,1,2007-W01,4,9,13,272,gender
RSウイルス感染症,2007,1,2007-W01,36,36,72,138,gender
咽頭結膜熱,2007,1,2007-W01,6,8,14,138,gender
Ａ群溶血性レンサ球菌咽頭炎,2007,1,2007-W01,38,22,60,138,gender
感染性胃腸炎,2007,1,2007-W01,246,229,475,138,gender
水痘,2007,1,2007-W01,105,100,205,138,gender
手足口病,2007,1,2007-W01,2,3,5,138,gender
突発性発しん,2007,1,2007-W01,12,19,31,138,gender
ヘルパンギーナ,2007,1,2007-W01,0,0,0,138,gender
流行性耳下腺炎,2007,1,2007-W01,23,12,35,138,gender
川崎病,2007,1,2007-W01,1,0,1,138,gender
インフルエンザ,2022,20,2022-W20,0,1,1,407,gender
RSウイルス感染症,2022,20,2022-W20,6,5,11,257,gender
咽頭結膜熱,2022,20,2022-W20,21,13,34,257,gender
Ａ群溶血性レンサ球菌咽頭炎,2022,20,2022-W20,24,11,35,257,gender
感染性胃腸炎,2022,20,2022-W20,853,746,1599,257,gender
水痘,2022,20,2022-W20,5,9,14,257,gender
手足口病,2022,20,2022-W20,14,9,23,257,gender
突発性発しん,2022,20,2022-W20,71,71,142,257,gender
ヘルパンギーナ,2022,20,2022-W20,1,1,2,257,gender
流行性耳下腺炎,2022,20,2022-W20,9,11,20,257,gender
川崎病,2022,20,2022-W20,1,0,1,257,gender
インフルエンザ,2007,28,2007-W28,2,1,3,287,gender
RSウイルス感染症,2007,28,2007-W28,2,0,2,149,gender
咽頭結膜熱,2007,28,2007-W28,60,56,116,149,gender
Ａ群溶血性レンサ球菌咽頭炎,2007,28,2007-W28,135,100,235,149,gender
感染性胃腸炎,2007,28,2007-W28,361,330,691,149,gender
水痘,2007,28,2007-W28,64,56,120,149,gender
手足口病,2007,28,2007-W28,154,122,276,149,gender
突発性発しん,2007,28,2007-W28,54,52,106,149,gender
ヘルパンギーナ,2007,28,2007-W28,421,364,785,149,gender
流行性耳下腺炎,2007,28,2007-W28,30,26,56,149,gender
川崎病,2007,28,2007-W28,5,2,7,149,gender
インフルエンザ,2024,27,2024-W27,57,63,120,419,gender
新型コロナウイルス感染症（COVID-19）,2024,27,2024-W27,1376,1618,2994,419,gender
RSウイルス感染症,2024,27,2024-W27,70,55,125,264,gender
咽頭結膜熱,2024,27,2024-W27,59,44,103,264,gender
Ａ群溶血性レンサ球菌咽頭炎,2024,27,2024-W27,398,335,733,264,gender
感染性胃腸炎,2024,27,2024-W27,560,511,1071,264,gender
水痘,2024,27,2024-W27,26,23,49,264,gender
手足口病,2024,27,2024-W27,1999,1690,3689,264,gender
突発性発しん,2024,27,2024-W27,47,50,97,264,gender
ヘルパンギーナ,2024,27,2024-W27,452,383,835,264,gender
流行性耳下腺炎,2024,27,2024-W27,20,18,38,264,gender
川崎病,2024,27,2024-W27,1,0,1,264,gender
インフルエンザ,2019,22,2019-W22,74,69,143,415,gender
RSウイルス感染症,2019,22,2019-W22,37,30,67,261,gender
咽頭結膜熱,2019,22,2019-W22,89,84,173,261,gender
Ａ群溶血性レンサ球菌咽頭炎,2019,22,2019-W22,462,359,821,261,gender
感染性胃腸炎,2019,22,2019-W22,1093,907,2000,261,gender
水痘,2019,22,2019-W22,86,51,137,261,gender
手足口病,2019,22,2019-W22,86,87,173,261,gender
突発性発しん,2019,22,2019-W22,71,74,145,261,gender
ヘルパンギーナ,2019,22,2019-W22,14,19,33,261,gender
流行性耳下腺炎,2019,22,2019-W22,13,11,24,261,gender
川崎病,2019,22,2019-W22,4,2,6,261,gender
インフルエンザ,2006,46,2006-W46,1,2,3,178,gender
RSウイルス感染症,2006,46,2006-W46,13,9,22,142,gender
咽頭結膜熱,2006,46,2006-W46,16,8,24,142,gender
Ａ群溶血性レンサ球菌咽頭炎,2006,46,2006-W46,128,107,235,142,gender
感染性胃腸炎,2006,46,2006-W46,1151,1151,2302,142,gender
水痘,2006,46,2006-W46,63,55,118,142,gender
手足口病,2006,46,2006-W46,36,26,62,142,gender
突発性発しん,2006,46,2006-W46,45,26,71,142,gender
ヘルパンギーナ,2006,46,2006-W46,3,2,5,142,gender
流行性耳下腺炎,2006,46,2006-W46,23,22,45,142,gender
川崎病,2006,46,2006-W46,0,1,1,142,gender
インフルエンザ,2009,3,2009-W03,2415,2321,4736,286,gender
RSウイルス感染症,2009,3,2009-W03,5,3,8,147,gender
咽頭結膜熱,2009,3,2009-W03,7,12,19,147,gender
Ａ群溶血性レンサ球菌咽頭炎,2009,3,2009-W03,130,112,242,147,gender
感染性胃腸炎,2009,3,2009-W03,518,462,980,147,gender
水痘,2009,3,2009-W03,87,75,162,147,gender
手足口病,2009,3,2009-W03,2,2,4,147,gender
突発性発しん,2009,3,2009-W03,38,39,77,147,gender
ヘルパンギーナ,2009,3,2009-W03,3,1,4,147,gender
流行性耳下腺炎,2009,3,2009-W03,26,35,61,147,gender
川崎病,2009,3,2009-W03,1,0,1,147,gender
インフルエンザ,2004,35,2004-W35,0,0,0,178,gender
RSウイルス感染症,2004,35,2004-W35,0,1,1,142,gender
咽頭結膜熱,2004,35,2004-W35,23,15,38,142,gender
Ａ群溶血性レンサ球菌咽頭炎,2004,35,2004-W35,13,15,28,142,gender
感染性胃腸炎,2004,35,2004-W35,143,137,280,142,gender
水痘,2004,35,2004-W35,23,23,46,142,gender
手足口病,2004,35,2004-W35,34,46,80,142,gender
突発性発しん,2004,35,2004-W35,60,60,120,142,gender
ヘルパンギーナ,2004,35,2004-W35,36,37,73,142,gender
流行性耳下腺炎,2004,35,2004-W35,42,28,70,142,gender
川崎病,2004,35,2004-W35,0,0,0,142,gender
インフルエンザ,2024,28,2024-W28,62,73,135,419,gender
新型コロナウイルス感染症（COVID-19）,2024,28,2024-W28,1466,1714,3180,419,gender
RSウイルス感染症,2024,28,2024-W28,62,54,116,264,gender
咽頭結膜熱,2024,28,2024-W28,54,45,99,264,gender
Ａ群溶血性レンサ球菌咽頭炎,2024,28,2024-W28,295,276,571,264,gender
感染性胃腸炎,2024,28,2024-W28,515,475,990,264,gender
水痘,2024,28,2024-W28,27,24,51,264,gender
手足口病,2024,28,2024-W28,2386,1940,4326,264,gender
突発性発しん,2024,28,2024-W28,36,38,74,264,gender
ヘルパンギーナ,2024,28,2024-W28,467,407,874,264,gender
流行性耳下腺炎,2024,28,2024-W28,10,10,20,264,gender
川崎病,2024,28,2024-W28,4,0,4,264,gender
インフルエンザ,2007,27,2007-W27,4,2,6,288,gender
RSウイルス感染症,2007,27,2007-W27,3,4,7,150,gender
咽頭結膜熱,2007,27,2007-W27,74,68,142,150,gender
Ａ群溶血性レンサ球菌咽頭炎,2007,27,2007-W27,157,112,269,150,gender
感染性胃腸炎,2007,27,2007-W27,357,317,674,150,gender
水痘,2007,27,2007-W27,82,76,158,150,gender
手足口病,2007,27,2007-W27,105,85,190,150,gender
突発性発しん,2007,27,2007-W27,59,53,112,150,gender
ヘルパンギーナ,2007,27,2007-W27,232,214,446,150,gender
流行性耳下腺炎,2007,27,2007-W27,29,32,61,150,gender
川崎病,2007,27,2007-W27,0,1,1,150,gender
インフルエンザ,2015,13,2015-W13,321,315,636,415,gender
RSウイルス感染症,2015,13,2015-W13,24,20,44,262,gender
咽頭結膜熱,2015,13,2015-W13,35,21,56,262,gender
Ａ群溶血性レンサ球菌咽頭炎,2015,13,2015-W13,408,348,756,262,gender
感染性胃腸炎,2015,13,2015-W13,983,904,1887,262,gender
水痘,2015,13,2015-W13,101,86,187,262,gender
手足口病,2015,13,2015-W13,9,17,26,262,gender
突発性発しん,2015,13,2015-W13,80,82,162,262,gender
ヘルパンギーナ,2015,13,2015-W13,2,5,7,262,gender
流行性耳下腺炎,2015,13,2015-W13,32,25,57,262,gender
川崎病,2015,13,2015-W13,3,0,3,262,gender
インフルエンザ,2018,43,2018-W43,31,36,67,416,gender
RSウイルス感染症,2018,43,2018-W43,102,70,172,262,gender
咽頭結膜熱,2018,43,2018-W43,25,23,48,262,gender
Ａ群溶血性レンサ球菌咽頭炎,2018,43,2018-W43,331,271,602,262,gender
感染性胃腸炎,2018,43,2018-W43,751,587,1338,262,gender
水痘,2018,43,2018-W43,28,29,57,262,gender
手足口病,2018,43,2018-W43,178,194,372,262,gender
突発性発しん,2018,43,2018-W43,70,59,129,262,gender
ヘルパンギーナ,2018,43,2018-W43,42,39,81,262,gender
流行性耳下腺炎,2018,43,2018-W43,10,10,20,262,gender
川崎病,2018,43,2018-W43,1,3,4,262,gender
インフルエンザ,2006,49,2006-W49,1,2,3,178,gender
RSウイルス感染症,2006,49,2006-W49,36,28,64,142,gender
咽頭結膜熱,2006,49,2006-W49,14,20,34,142,gender
Ａ群溶血性レンサ球菌咽頭炎,2006,49,2006-W49,97,90,187,142,gender
感染性胃腸炎,2006,49,2006-W49,1952,1944,3896,142,gender
水痘,2006,49,2006-W49,86,84,170,142,gender
手足口病,2006,49,2006-W49,33,21,54,142,gender
突発性発しん,2006,49,2006-W49,34,30,64,142,gender
ヘルパンギーナ,2006,49,2006-W49,6,2,8,142,gender
流行性耳下腺炎,2006,49,2006-W49,33,26,59,142,gender
川崎病,2006,49,2006-W49,1,0,1,142,gender
インフルエンザ,2023,41,2023-W41,3473,3260,6733,416,gender
新型コロナウイルス感染症（COVID-19）,2023,41,2023-W41,465,506,971,416,gender
RSウイルス感染症,2023,41,2023-W41,5,6,11,261,gender
咽頭結膜熱,2023,41,2023-W41,297,238,535,261,gender
Ａ群溶血性レンサ球菌咽頭炎,2023,41,2023-W41,282,250,532,261,gender
感染性胃腸炎,2023,41,2023-W41,405,344,749,261,gender
水痘,2023,41,2023-W41,9,10,19,261,gender
手足口病,2023,41,2023-W41,234,183,417,261,gender
突発性発しん,2023,41,2023-W41,35,36,71,261,gender
ヘルパンギーナ,2023,41,2023-W41,21,33,54,261,gender
流行性耳下腺炎,2023,41,2023-W41,5,6,11,261,gender
川崎病,2023,41,2023-W41,3,1,4,261,gender
インフルエンザ,2021,1,2021-W01,3,0,3,404,gender
RSウイルス感染症,2021,1,2021-W01,1,0,1,256,gender
咽頭結膜熱,2021,1,2021-W01,22,18,40,256,gender
Ａ群溶血性レンサ球菌咽頭炎,2021,1,2021-W01,44,35,79,256,gender
感染性胃腸炎,2021,1,2021-W01,327,279,606,256,gender
水痘,2021,1,2021-W01,21,24,45,256,gender
手足口病,2021,1,2021-W01,2,3,5,256,gender
突発性発しん,2021,1,2021-W01,57,45,102,256,gender
ヘルパンギーナ,2021,1,2021-W01,2,4,6,256,gender
流行性耳下腺炎,2021,1,2021-W01,3,6,9,256,gender
川崎病,2021,1,2021-W01,0,0,0,256,gender
インフルエンザ,2013,14,2013-W14,169,168,337,414,gender
RSウイルス感染症,2013,14,2013-W14,12,14,26,260,gender
咽頭結膜熱,2013,14,2013-W14,34,29,63,260,gender
Ａ群溶血性レンサ球菌咽頭炎,2013,14,2013-W14,273,225,498,260,gender
感染性胃腸炎,2013,14,2013-W14,1035,965,2000,260,gender
水痘,2013,14,2013-W14,108,81,189,260,gender
手足口病,2013,14,2013-W14,8,10,18,260,gender
突発性発しん,2013,14,2013-W14,89,67,156,260,gender
ヘルパンギーナ,2013,14,2013-W14,2,1,3,260,gender
流行性耳下腺炎,2013,14,2013-W14,29,22,51,260,gender
川崎病,2013,14,2013-W14,4,2,6,260,gender
インフルエンザ,2021,32,2021-W32,0,0,0,383,gender
RSウイルス感染症,2021,32,2021-W32,300,246,546,246,gender
咽頭結膜熱,2021,32,2021-W32,14,8,22,246,gender
Ａ群溶血性レンサ球菌咽頭炎,2021,32,2021-W32,28,26,54,246,gender
感染性胃腸炎,2021,32,2021-W32,182,146,328,246,gender
水痘,2021,32,2021-W32,6,12,18,246,gender
手足口病,2021,32,2021-W32,4,6,10,246,gender
突発性発しん,2021,32,2021-W32,29,33,62,246,gender
ヘルパンギーナ,2021,32,2021-W32,7,12,19,246,gender
流行性耳下腺炎,2021,32,2021-W32,12,2,14,246,gender
川崎病,2021,32,2021-W32,6,3,9,246,gender
インフルエンザ,2002,2,2002-W02,50,37,87,178,gender
RSウイルス感染症,2002,2,2002-W02,0,0,0,142,gender
咽頭結膜熱,2002,2,2002-W02,1,2,3,142,gender
Ａ群溶血性レンサ球菌咽頭炎,2002,2,2002-W02,33,30,63,142,gender
感染性胃腸炎,2002,2,2002-W02,490,487,977,142,gender
水痘,2002,2,2002-W02,146,151,297,142,gender
手足口病,2002,2,2002-W02,6,9,15,142,gender
突発性発しん,2002,2,2002-W02,36,35,71,142,gender
ヘルパンギーナ,2002,2,2002-W02,5,3,8,142,gender
流行性耳下腺炎,2002,2,2002-W02,75,62,137,142,gender
川崎病,2002,2,2002-W02,0,1,1,142,gender
インフルエンザ,2001,20,2001-W20,0,1,1,178,gender
RSウイルス感染症,2001,20,2001-W20,0,0,0,142,gender
咽頭結膜熱,2001,20,2001-W20,7,4,11,142,gender
Ａ群溶血性レンサ球菌咽頭炎,2001,20,2001-W20,46,38,84,142,gender
感染性胃腸炎,2001,20,2001-W20,244,170,414,142,gender
水痘,2001,20,2001-W20,92,83,175,142,gender
手足口病,2001,20,2001-W20,15,11,26,142,gender
突発性発しん,2001,20,2001-W20,40,37,77,142,gender
ヘルパンギーナ,2001,20,2001-W20,8,5,13,142,gender
流行性耳下腺炎,2001,20,2001-W20,88,79,167,142,gender
川崎病,2001,20,2001-W20,1,2,3,142,gender
インフルエンザ,2022,11,2022-W11,0,0,0,403,gender
RSウイルス感染症,2022,11,2022-W11,1,2,3,254,gender
咽頭結膜熱,2022,11,2022-W11,1,1,2,254,gender
Ａ群溶血性レンサ球菌咽頭炎,2022,11,2022-W11,20,14,34,254,gender
感染性胃腸炎,2022,11,2022-W11,540,467,1007,254,gender
水痘,2022,11,2022-W11,4,5,9,254,gender
手足口病,2022,11,2022-W11,2,2,4,254,gender
突発性発しん,2022,11,2022-W11,24,31,55,254,gender
ヘルパンギーナ,2022,11,2022-W11,2,0,2,254,gender
流行性耳下腺炎,2022,11,2022-W11,4,3,7,254,gender
川崎病,2022,11,2022-W11,2,0,2,254,gender
インフルエンザ,2012,44,2012-W44,14,6,20,416,gender
RSウイルス感染症,2012,44,2012-W44,101,70,171,261,gender
咽頭結膜熱,2012,44,2012-W44,48,29,77,261,gender
Ａ群溶血性レンサ球菌咽頭炎,2012,44,2012-W44,203,170,373,261,gender
感染性胃腸炎,2012,44,2012-W44,760,713,1473,261,gender
水痘,2012,44,2012-W44,73,68,141,261,gender
手足口病,2012,44,2012-W44,54,49,103,261,gender
突発性発しん,2012,44,2012-W44,64,82,146,261,gender
ヘルパンギーナ,2012,44,2012-W44,12,13,25,261,gender
流行性耳下腺炎,2012,44,2012-W44,24,24,48,261,gender
川崎病,2012,44,2012-W44,2,4,6,261,gender
インフルエンザ,2010,37,2010-W37,13,15,28,279,gender
RSウイルス感染症,2010,37,2010-W37,5,6,11,146,gender
咽頭結膜熱,2010,37,2010-W37,26,17,43,146,gender
Ａ群溶血性レンサ球菌咽頭炎,2010,37,2010-W37,62,43,105,146,gender
感染性胃腸炎,2010,37,2010-W37,332,267,599,146,gender
水痘,2010,37,2010-W37,22,28,50,146,gender
手足口病,2010,37,2010-W37,82,64,146,146,gender
突発性発しん,2010,37,2010-W37,54,59,113,146,gender
ヘルパンギーナ,2010,37,2010-W37,47,44,91,146,gender
流行性耳下腺炎,2010,37,2010-W37,52,37,89,146,gender
川崎病,2010,37,2010-W37,0,0,0,146,gender
インフルエンザ,2014,43,2014-W43,14,18,32,414,gender
RSウイルス感染症,2014,43,2014-W43,116,102,218,264,gender
咽頭結膜熱,2014,43,2014-W43,38,35,73,264,gender
Ａ群溶血性レンサ球菌咽頭炎,2014,43,2014-W43,295,224,519,264,gender
感染性胃腸炎,2014,43,2014-W43,585,489,1074,264,gender
水痘,2014,43,2014-W43,84,80,164,264,gender
手足口病,2014,43,2014-W43,74,64,138,264,gender
突発性発しん,2014,43,2014-W43,87,92,179,264,gender
ヘルパンギーナ,2014,43,2014-W43,30,28,58,264,gender
流行性耳下腺炎,2014,43,2014-W43,42,30,72,264,gender
川崎病,2014,43,2014-W43,3,0,3,264,gender
インフルエンザ,2019,13,2019-W13,172,173,345,414,gender
RSウイルス感染症,2019,13,2019-W13,33,24,57,260,gender
咽頭結膜熱,2019,13,2019-W13,19,24,43,260,gender
Ａ群溶血性レンサ球菌咽頭炎,2019,13,2019-W13,223,209,432,260,gender
感染性胃腸炎,2019,13,2019-W13,765,761,1526,260,gender
水痘,2019,13,2019-W13,65,53,118,260,gender
手足口病,2019,13,2019-W13,8,8,16,260,gender
突発性発しん,2019,13,2019-W13,48,51,99,260,gender
ヘルパンギーナ,2019,13,2019-W13,1,3,4,260,gender
流行性耳下腺炎,2019,13,2019-W13,9,7,16,260,gender
川崎病,2019,13,2019-W13,0,1,1,260,gender
インフルエンザ,2024,16,2024-W16,263,241,504,418,gender
新型コロナウイルス感染症（COVID-19）,2024,16,2024-W16,546,613,1159,418,gender
RSウイルス感染症,2024,16,2024-W16,298,242,540,263,gender
咽頭結膜熱,2024,16,2024-W16,39,29,68,263,gender
Ａ群溶血性レンサ球菌咽頭炎,2024,16,2024-W16,495,437,932,263,gender
感染性胃腸炎,2024,16,2024-W16,626,557,1183,263,gender
水痘,2024,16,2024-W16,20,14,34,263,gender
手足口病,2024,16,2024-W16,10,12,22,263,gender
突発性発しん,2024,16,2024-W16,46,44,90,263,gender
ヘルパンギーナ,2024,16,2024-W16,0,3,3,263,gender
流行性耳下腺炎,2024,16,2024-W16,8,10,18,263,gender
川崎病,2024,16,2024-W16,1,1,2,263,gender
インフルエンザ,2007,19,2007-W19,45,47,92,284,gender
RSウイルス感染症,2007,19,2007-W19,4,3,7,149,gender
咽頭結膜熱,2007,19,2007-W19,69,41,110,149,gender
Ａ群溶血性レンサ球菌咽頭炎,2007,19,2007-W19,159,141,300,149,gender
感染性胃腸炎,2007,19,2007-W19,378,389,767,149,gender
水痘,2007,19,2007-W19,210,193,403,149,gender
手足口病,2007,19,2007-W19,16,14,30,149,gender
突発性発しん,2007,19,2007-W19,57,51,108,149,gender
ヘルパンギーナ,2007,19,2007-W19,14,14,28,149,gender
流行性耳下腺炎,2007,19,2007-W19,25,34,59,149,gender
川崎病,2007,19,2007-W19,3,0,3,149,gender
インフルエンザ,2016,30,2016-W30,1,4,5,414,gender
RSウイルス感染症,2016,30,2016-W30,34,32,66,260,gender
咽頭結膜熱,2016,30,2016-W30,80,61,141,260,gender
Ａ群溶血性レンサ球菌咽頭炎,2016,30,2016-W30,296,216,512,260,gender
感染性胃腸炎,2016,30,2016-W30,650,547,1197,260,gender
水痘,2016,30,2016-W30,42,42,84,260,gender
手足口病,2016,30,2016-W30,118,107,225,260,gender
突発性発しん,2016,30,2016-W30,62,72,134,260,gender
ヘルパンギーナ,2016,30,2016-W30,829,770,1599,260,gender
流行性耳下腺炎,2016,30,2016-W30,149,111,260,260,gender
川崎病,2016,30,2016-W30,2,2,4,260,gender
インフルエンザ,2015,5,2015-W05,3808,4036,7844,416,gender
RSウイルス感染症,2015,5,2015-W05,53,44,97,263,gender
咽頭結膜熱,2015,5,2015-W05,23,14,37,263,gender
Ａ群溶血性レンサ球菌咽頭炎,2015,5,2015-W05,351,341,692,263,gender
感染性胃腸炎,2015,5,2015-W05,1110,1134,2244,263,gender
水痘,2015,5,2015-W05,36,53,89,263,gender
手足口病,2015,5,2015-W05,16,13,29,263,gender
突発性発しん,2015,5,2015-W05,62,64,126,263,gender
ヘルパンギーナ,2015,5,2015-W05,2,4,6,263,gender
流行性耳下腺炎,2015,5,2015-W05,41,25,66,263,gender
川崎病,2015,5,2015-W05,5,1,6,263,gender
インフルエンザ,2010,9,2010-W09,87,92,179,287,gender
RSウイルス感染症,2010,9,2010-W09,43,34,77,148,gender
咽頭結膜熱,2010,9,2010-W09,15,9,24,148,gender
Ａ群溶血性レンサ球菌咽頭炎,2010,9,2010-W09,149,137,286,148,gender
感染性胃腸炎,2010,9,2010-W09,863,764,1627,148,gender
水痘,2010,9,2010-W09,146,125,271,148,gender
手足口病,2010,9,2010-W09,5,3,8,148,gender
突発性発しん,2010,9,2010-W09,49,33,82,148,gender
ヘルパンギーナ,2010,9,2010-W09,6,1,7,148,gender
流行性耳下腺炎,2010,9,2010-W09,45,63,108,148,gender
川崎病,2010,9,2010-W09,3,0,3,148,gender
インフルエンザ,2003,22,2003-W22,0,1,1,178,gender
RSウイルス感染症,2003,22,2003-W22,0,0,0,142,gender
咽頭結膜熱,2003,22,2003-W22,17,19,36,142,gender
Ａ群溶血性レンサ球菌咽頭炎,2003,22,2003-W22,69,65,134,142,gender
感染性胃腸炎,2003,22,2003-W22,308,267,575,142,gender
水痘,2003,22,2003-W22,85,92,177,142,gender
手足口病,2003,22,2003-W22,55,62,117,142,gender
突発性発しん,2003,22,2003-W22,36,43,79,142,gender
ヘルパンギーナ,2003,22,2003-W22,24,19,43,142,gender
流行性耳下腺炎,2003,22,2003-W22,14,15,29,142,gender
川崎病,2003,22,2003-W22,3,2,5,142,gender
インフルエンザ,2001,51,2001-W51,19,13,32,178,gender
RSウイルス感染症,2001,51,2001-W51,0,0,0,142,gender
咽頭結膜熱,2001,51,2001-W51,3,5,8,142,gender
Ａ群溶血性レンサ球菌咽頭炎,2001,51,2001-W51,58,43,101,142,gender
感染性胃腸炎,2001,51,2001-W51,797,876,1673,142,gender
水痘,2001,51,2001-W51,121,104,225,142,gender
手足口病,2001,51,2001-W51,10,7,17,142,gender
突発性発しん,2001,51,2001-W51,30,35,65,142,gender
ヘルパンギーナ,2001,51,2001-W51,10,8,18,142,gender
流行性耳下腺炎,2001,51,2001-W51,77,60,137,142,gender
川崎病,2001,51,2001-W51,1,1,2,142,gender
インフルエンザ,2023,30,2023-W30,263,237,500,416,gender
新型コロナウイルス感染症（COVID-19）,2023,30,2023-W30,2121,2494,4615,416,gender
RSウイルス感染症,2023,30,2023-W30,171,137,308,261,gender
咽頭結膜熱,2023,30,2023-W30,61,42,103,261,gender
Ａ群溶血性レンサ球菌咽頭炎,2023,30,2023-W30,194,155,349,261,gender
感染性胃腸炎,2023,30,2023-W30,540,426,966,261,gender
水痘,2023,30,2023-W30,7,21,28,261,gender
手足口病,2023,30,2023-W30,92,78,170,261,gender
突発性発しん,2023,30,2023-W30,29,36,65,261,gender
ヘルパンギーナ,2023,30,2023-W30,436,404,840,261,gender
流行性耳下腺炎,2023,30,2023-W30,8,7,15,261,gender
川崎病,2023,30,2023-W30,3,1,4,261,gender
インフルエンザ,2011,16,2011-W16,1171,1082,2253,415,gender
RSウイルス感染症,2011,16,2011-W16,13,12,25,261,gender
咽頭結膜熱,2011,16,2011-W16,33,16,49,261,gender
Ａ群溶血性レンサ球菌咽頭炎,2011,16,2011-W16,409,312,721,261,gender
感染性胃腸炎,2011,16,2011-W16,1254,1140,2394,261,gender
水痘,2011,16,2011-W16,130,103,233,261,gender
手足口病,2011,16,2011-W16,7,1,8,261,gender
突発性発しん,2011,16,2011-W16,96,102,198,261,gender
ヘルパンギーナ,2011,16,2011-W16,1,5,6,261,gender
流行性耳下腺炎,2011,16,2011-W16,36,24,60,261,gender
川崎病,2011,16,2011-W16,1,3,4,261,gender
インフルエンザ,2001,3,2001-W03,42,31,73,178,gender
RSウイルス感染症,2001,3,2001-W03,0,0,0,142,gender
咽頭結膜熱,2001,3,2001-W03,4,3,7,142,gender
Ａ群溶血性レンサ球菌咽頭炎,2001,3,2001-W03,37,26,63,142,gender
感染性胃腸炎,2001,3,2001-W03,542,584,1126,142,gender
水痘,2001,3,2001-W03,92,78,170,142,gender
手足口病,2001,3,2001-W03,7,5,12,142,gender
突発性発しん,2001,3,2001-W03,42,28,70,142,gender
ヘルパンギーナ,2001,3,2001-W03,2,3,5,142,gender
流行性耳下腺炎,2001,3,2001-W03,69,53,122,142,gender
川崎病,2001,3,2001-W03,2,0,2,142,gender
インフルエンザ,2021,43,2021-W43,0,0,0,411,gender
RSウイルス感染症,2021,43,2021-W43,9,5,14,259,gender
咽頭結膜熱,2021,43,2021-W43,12,13,25,259,gender
Ａ群溶血性レンサ球菌咽頭炎,2021,43,2021-W43,45,39,84,259,gender
感染性胃腸炎,2021,43,2021-W43,404,347,751,259,gender
水痘,2021,43,2021-W43,12,10,22,259,gender
手足口病,2021,43,2021-W43,51,39,90,259,gender
突発性発しん,2021,43,2021-W43,53,53,106,259,gender
ヘルパンギーナ,2021,43,2021-W43,136,114,250,259,gender
流行性耳下腺炎,2021,43,2021-W43,5,3,8,259,gender
川崎病,2021,43,2021-W43,2,0,2,259,gender
インフルエンザ,2018,32,2018-W32,7,2,9,367,gender
RSウイルス感染症,2018,32,2018-W32,209,186,395,239,gender
咽頭結膜熱,2018,32,2018-W32,33,25,58,239,gender
Ａ群溶血性レンサ球菌咽頭炎,2018,32,2018-W32,167,137,304,239,gender
感染性胃腸炎,2018,32,2018-W32,472,360,832,239,gender
水痘,2018,32,2018-W32,20,21,41,239,gender
手足口病,2018,32,2018-W32,137,133,270,239,gender
突発性発しん,2018,32,2018-W32,53,51,104,239,gender
ヘルパンギーナ,2018,32,2018-W32,303,324,627,239,gender
流行性耳下腺炎,2018,32,2018-W32,13,8,21,239,gender
川崎病,2018,32,2018-W32,3,0,3,239,gender
インフルエンザ,2006,38,2006-W38,0,1,1,178,gender
RSウイルス感染症,2006,38,2006-W38,3,2,5,142,gender
咽頭結膜熱,2006,38,2006-W38,27,22,49,142,gender
Ａ群溶血性レンサ球菌咽頭炎,2006,38,2006-W38,41,35,76,142,gender
感染性胃腸炎,2006,38,2006-W38,175,142,317,142,gender
水痘,2006,38,2006-W38,24,27,51,142,gender
手足口病,2006,38,2006-W38,82,65,147,142,gender
突発性発しん,2006,38,2006-W38,44,39,83,142,gender
ヘルパンギーナ,2006,38,2006-W38,16,22,38,142,gender
流行性耳下腺炎,2006,38,2006-W38,30,26,56,142,gender
川崎病,2006,38,2006-W38,1,0,1,142,gender
インフルエンザ,2017,11,2017-W11,2145,2072,4217,413,gender
RSウイルス感染症,2017,11,2017-W11,19,17,36,260,gender
咽頭結膜熱,2017,11,2017-W11,36,22,58,260,gender
Ａ群溶血性レンサ球菌咽頭炎,2017,11,2017-W11,320,299,619,260,gender
感染性胃腸炎,2017,11,2017-W11,1100,1004,2104,260,gender
水痘,2017,11,2017-W11,41,42,83,260,gender
手足口病,2017,11,2017-W11,9,1,10,260,gender
突発性発しん,2017,11,2017-W11,58,80,138,260,gender
ヘルパンギーナ,2017,11,2017-W11,3,0,3,260,gender
流行性耳下腺炎,2017,11,2017-W11,37,27,64,260,gender
川崎病,2017,11,2017-W11,5,2,7,260,gender
インフルエンザ,2005,25,2005-W25,2,0,2,178,gender
RSウイルス感染症,2005,25,2005-W25,5,6,11,142,gender
咽頭結膜熱,2005,25,2005-W25,58,64,122,142,gender
Ａ群溶血性レンサ球菌咽頭炎,2005,25,2005-W25,122,96,218,142,gender
感染性胃腸炎,2005,25,2005-W25,282,238,520,142,gender
水痘,2005,25,2005-W25,111,95,206,142,gender
手足口病,2005,25,2005-W25,103,85,188,142,gender
突発性発しん,2005,25,2005-W25,49,44,93,142,gender
ヘルパンギーナ,2005,25,2005-W25,267,258,525,142,gender
流行性耳下腺炎,2005,25,2005-W25,117,89,206,142,gender
川崎病,2005,25,2005-W25,0,1,1,142,gender
インフルエンザ,2009,25,2009-W25,13,17,30,285,gender
RSウイルス感染症,2009,25,2009-W25,5,5,10,148,gender
咽頭結膜熱,2009,25,2009-W25,33,22,55,148,gender
Ａ群溶血性レンサ球菌咽頭炎,2009,25,2009-W25,173,138,311,148,gender
感染性胃腸炎,2009,25,2009-W25,373,303,676,148,gender
水痘,2009,25,2009-W25,89,75,164,148,gender
手足口病,2009,25,2009-W25,19,14,33,148,gender
突発性発しん,2009,25,2009-W25,62,58,120,148,gender
ヘルパンギーナ,2009,25,2009-W25,20,7,27,148,gender
流行性耳下腺炎,2009,25,2009-W25,75,66,141,148,gender
川崎病,2009,25,2009-W25,0,0,0,148,gender
インフルエンザ,2014,32,2014-W32,3,1,4,396,gender
RSウイルス感染症,2014,32,2014-W32,23,15,38,253,gender
咽頭結膜熱,2014,32,2014-W32,66,48,114,253,gender
Ａ群溶血性レンサ球菌咽頭炎,2014,32,2014-W32,132,104,236,253,gender
感染性胃腸炎,2014,32,2014-W32,450,383,833,253,gender
水痘,2014,32,2014-W32,53,46,99,253,gender
手足口病,2014,32,2014-W32,156,146,302,253,gender
突発性発しん,2014,32,2014-W32,102,84,186,253,gender
ヘルパンギーナ,2014,32,2014-W32,673,604,1277,253,gender
流行性耳下腺炎,2014,32,2014-W32,45,37,82,253,gender
川崎病,2014,32,2014-W32,1,2,3,253,gender
インフルエンザ,2013,8,2013-W08,1304,1307,2611,417,gender
RSウイルス感染症,2013,8,2013-W08,35,24,59,264,gender
咽頭結膜熱,2013,8,2013-W08,28,25,53,264,gender
Ａ群溶血性レンサ球菌咽頭炎,2013,8,2013-W08,354,268,622,264,gender
感染性胃腸炎,2013,8,2013-W08,1361,1166,2527,264,gender
水痘,2013,8,2013-W08,137,113,250,264,gender
手足口病,2013,8,2013-W08,7,7,14,264,gender
突発性発しん,2013,8,2013-W08,72,81,153,264,gender
ヘルパンギーナ,2013,8,2013-W08,6,2,8,264,gender
流行性耳下腺炎,2013,8,2013-W08,27,11,38,264,gender
川崎病,2013,8,2013-W08,2,1,3,264,gender
インフルエンザ,2016,4,2016-W04,5522,5260,10782,415,gender
RSウイルス感染症,2016,4,2016-W04,75,52,127,261,gender
咽頭結膜熱,2016,4,2016-W04,31,17,48,261,gender
Ａ群溶血性レンサ球菌咽頭炎,2016,4,2016-W04,469,392,861,261,gender
感染性胃腸炎,2016,4,2016-W04,1218,1089,2307,261,gender
水痘,2016,4,2016-W04,78,63,141,261,gender
手足口病,2016,4,2016-W04,13,6,19,261,gender
突発性発しん,2016,4,2016-W04,53,51,104,261,gender
ヘルパンギーナ,2016,4,2016-W04,0,0,0,261,gender
流行性耳下腺炎,2016,4,2016-W04,83,59,142,261,gender
川崎病,2016,4,2016-W04,2,3,5,261,gender
インフルエンザ,2016,41,2016-W41,45,53,98,413,gender
RSウイルス感染症,2016,41,2016-W41,275,252,527,260,gender
咽頭結膜熱,2016,41,2016-W41,29,19,48,260,gender
Ａ群溶血性レンサ球菌咽頭炎,2016,41,2016-W41,184,140,324,260,gender
感染性胃腸炎,2016,41,2016-W41,566,486,1052,260,gender
水痘,2016,41,2016-W41,37,35,72,260,gender
手足口病,2016,41,2016-W41,244,179,423,260,gender
突発性発しん,2016,41,2016-W41,70,53,123,260,gender
ヘルパンギーナ,2016,41,2016-W41,101,105,206,260,gender
流行性耳下腺炎,2016,41,2016-W41,126,89,215,260,gender
川崎病,2016,41,2016-W41,5,2,7,260,gender
インフルエンザ,2012,35,2012-W35,6,3,9,406,gender
RSウイルス感染症,2012,35,2012-W35,122,129,251,259,gender
咽頭結膜熱,2012,35,2012-W35,60,58,118,259,gender
Ａ群溶血性レンサ球菌咽頭炎,2012,35,2012-W35,109,92,201,259,gender
感染性胃腸炎,2012,35,2012-W35,511,430,941,259,gender
水痘,2012,35,2012-W35,40,27,67,259,gender
手足口病,2012,35,2012-W35,75,79,154,259,gender
突発性発しん,2012,35,2012-W35,124,115,239,259,gender
ヘルパンギーナ,2012,35,2012-W35,164,160,324,259,gender
流行性耳下腺炎,2012,35,2012-W35,40,26,66,259,gender
川崎病,2012,35,2012-W35,2,1,3,259,gender
インフルエンザ,2010,46,2010-W46,68,75,143,286,gender
RSウイルス感染症,2010,46,2010-W46,17,22,39,148,gender
咽頭結膜熱,2010,46,2010-W46,19,20,39,148,gender
Ａ群溶血性レンサ球菌咽頭炎,2010,46,2010-W46,146,148,294,148,gender
感染性胃腸炎,2010,46,2010-W46,977,922,1899,148,gender
水痘,2010,46,2010-W46,68,73,141,148,gender
手足口病,2010,46,2010-W46,17,17,34,148,gender
突発性発しん,2010,46,2010-W46,44,29,73,148,gender
ヘルパンギーナ,2010,46,2010-W46,7,4,11,148,gender
流行性耳下腺炎,2010,46,2010-W46,42,29,71,148,gender
川崎病,2010,46,2010-W46,1,2,3,148,gender
インフルエンザ,2020,13,2020-W13,41,32,73,414,gender
RSウイルス感染症,2020,13,2020-W13,4,4,8,260,gender
咽頭結膜熱,2020,13,2020-W13,16,18,34,260,gender
Ａ群溶血性レンサ球菌咽頭炎,2020,13,2020-W13,196,176,372,260,gender
感染性胃腸炎,2020,13,2020-W13,348,307,655,260,gender
水痘,2020,13,2020-W13,35,32,67,260,gender
手足口病,2020,13,2020-W13,5,5,10,260,gender
突発性発しん,2020,13,2020-W13,50,35,85,260,gender
ヘルパンギーナ,2020,13,2020-W13,4,5,9,260,gender
流行性耳下腺炎,2020,13,2020-W13,9,7,16,260,gender
川崎病,2020,13,2020-W13,1,0,1,260,gender
インフルエンザ,2011,28,2011-W28,2,1,3,415,gender
RSウイルス感染症,2011,28,2011-W28,29,13,42,261,gender
咽頭結膜熱,2011,28,2011-W28,147,117,264,261,gender
Ａ群溶血性レンサ球菌咽頭炎,2011,28,2011-W28,227,190,417,261,gender
感染性胃腸炎,2011,28,2011-W28,565,466,1031,261,gender
水痘,2011,28,2011-W28,149,123,272,261,gender
手足口病,2011,28,2011-W28,1206,971,2177,261,gender
突発性発しん,2011,28,2011-W28,105,95,200,261,gender
ヘルパンギーナ,2011,28,2011-W28,933,854,1787,261,gender
流行性耳下腺炎,2011,28,2011-W28,68,41,109,261,gender
川崎病,2011,28,2011-W28,5,3,8,261,gender
インフルエンザ,2018,6,2018-W06,8201,8175,16376,414,gender
RSウイルス感染症,2018,6,2018-W06,38,30,68,262,gender
咽頭結膜熱,2018,6,2018-W06,26,28,54,262,gender
Ａ群溶血性レンサ球菌咽頭炎,2018,6,2018-W06,403,330,733,262,gender
感染性胃腸炎,2018,6,2018-W06,704,609,1313,262,gender
水痘,2018,6,2018-W06,27,38,65,262,gender
手足口病,2018,6,2018-W06,4,9,13,262,gender
突発性発しん,2018,6,2018-W06,58,51,109,262,gender
ヘルパンギーナ,2018,6,2018-W06,4,5,9,262,gender
流行性耳下腺炎,2018,6,2018-W06,14,8,22,262,gender
川崎病,2018,6,2018-W06,1,1,2,262,gender
インフルエンザ,2025,24,2025-W24,64,32,96,418,gender
新型コロナウイルス感染症（COVID-19）,2025,24,2025-W24,157,185,342,418,gender
RSウイルス感染症,2025,24,2025-W24,13,17,30,263,gender
咽頭結膜熱,2025,24,2025-W24,87,56,143,263,gender
Ａ群溶血性レンサ球菌咽頭炎,2025,24,2025-W24,607,451,1058,263,gender
感染性胃腸炎,2025,24,2025-W24,912,768,1680,263,gender
水痘,2025,24,2025-W24,148,139,287,263,gender
手足口病,2025,24,2025-W24,26,25,51,263,gender
突発性発しん,2025,24,2025-W24,48,59,107,263,gender
ヘルパンギーナ,2025,24,2025-W24,12,10,22,263,gender
流行性耳下腺炎,2025,24,2025-W24,18,11,29,263,gender
川崎病,2025,24,2025-W24,5,3,8,263,gender
インフルエンザ,2018,21,2018-W21,35,31,66,415,gender
RSウイルス感染症,2018,21,2018-W21,26,20,46,261,gender
咽頭結膜熱,2018,21,2018-W21,109,95,204,261,gender
Ａ群溶血性レンサ球菌咽頭炎,2018,21,2018-W21,479,354,833,261,gender
感染性胃腸炎,2018,21,2018-W21,1071,946,2017,261,gender
水痘,2018,21,2018-W21,94,71,165,261,gender
手足口病,2018,21,2018-W21,20,22,42,261,gender
突発性発しん,2018,21,2018-W21,99,82,181,261,gender
ヘルパンギーナ,2018,21,2018-W21,15,11,26,261,gender
流行性耳下腺炎,2018,21,2018-W21,19,14,33,261,gender
川崎病,2018,21,2018-W21,3,3,6,261,gender
インフルエンザ,2007,45,2007-W45,92,93,185,288,gender
RSウイルス感染症,2007,45,2007-W45,32,29,61,150,gender
咽頭結膜熱,2007,45,2007-W45,13,7,20,150,gender
Ａ群溶血性レンサ球菌咽頭炎,2007,45,2007-W45,120,107,227,150,gender
感染性胃腸炎,2007,45,2007-W45,438,376,814,150,gender
水痘,2007,45,2007-W45,62,79,141,150,gender
手足口病,2007,45,2007-W45,33,30,63,150,gender
突発性発しん,2007,45,2007-W45,62,35,97,150,gender
ヘルパンギーナ,2007,45,2007-W45,19,16,35,150,gender
流行性耳下腺炎,2007,45,2007-W45,20,13,33,150,gender
川崎病,2007,45,2007-W45,0,1,1,150,gender
インフルエンザ,2005,36,2005-W36,0,0,0,178,gender
RSウイルス感染症,2005,36,2005-W36,1,2,3,142,gender
咽頭結膜熱,2005,36,2005-W36,35,27,62,142,gender
Ａ群溶血性レンサ球菌咽頭炎,2005,36,2005-W36,29,21,50,142,gender
感染性胃腸炎,2005,36,2005-W36,183,169,352,142,gender
水痘,2005,36,2005-W36,19,31,50,142,gender
手足口病,2005,36,2005-W36,30,17,47,142,gender
突発性発しん,2005,36,2005-W36,47,42,89,142,gender
ヘルパンギーナ,2005,36,2005-W36,53,37,90,142,gender
流行性耳下腺炎,2005,36,2005-W36,75,57,132,142,gender
川崎病,2005,36,2005-W36,0,0,0,142,gender
インフルエンザ,2001,42,2001-W42,1,0,1,178,gender
RSウイルス感染症,2001,42,2001-W42,0,0,0,142,gender
咽頭結膜熱,2001,42,2001-W42,4,5,9,142,gender
Ａ群溶血性レンサ球菌咽頭炎,2001,42,2001-W42,18,20,38,142,gender
感染性胃腸炎,2001,42,2001-W42,152,162,314,142,gender
水痘,2001,42,2001-W42,32,33,65,142,gender
手足口病,2001,42,2001-W42,20,20,40,142,gender
突発性発しん,2001,42,2001-W42,34,40,74,142,gender
ヘルパンギーナ,2001,42,2001-W42,6,10,16,142,gender
流行性耳下腺炎,2001,42,2001-W42,46,50,96,142,gender
川崎病,2001,42,2001-W42,0,0,0,142,gender
インフルエンザ,2012,18,2012-W18,82,115,197,401,gender
RSウイルス感染症,2012,18,2012-W18,11,6,17,251,gender
咽頭結膜熱,2012,18,2012-W18,24,15,39,251,gender
Ａ群溶血性レンサ球菌咽頭炎,2012,18,2012-W18,159,126,285,251,gender
感染性胃腸炎,2012,18,2012-W18,679,611,1290,251,gender
水痘,2012,18,2012-W18,65,49,114,251,gender
手足口病,2012,18,2012-W18,19,9,28,251,gender
突発性発しん,2012,18,2012-W18,49,48,97,251,gender
ヘルパンギーナ,2012,18,2012-W18,2,2,4,251,gender
流行性耳下腺炎,2012,18,2012-W18,17,14,31,251,gender
川崎病,2012,18,2012-W18,1,0,1,251,gender
インフルエンザ,2003,31,2003-W31,0,0,0,178,gender
RSウイルス感染症,2003,31,2003-W31,0,0,0,142,gender
咽頭結膜熱,2003,31,2003-W31,38,30,68,142,gender
Ａ群溶血性レンサ球菌咽頭炎,2003,31,2003-W31,24,27,51,142,gender
感染性胃腸炎,2003,31,2003-W31,128,116,244,142,gender
水痘,2003,31,2003-W31,52,34,86,142,gender
手足口病,2003,31,2003-W31,264,256,520,142,gender
突発性発しん,2003,31,2003-W31,39,29,68,142,gender
ヘルパンギーナ,2003,31,2003-W31,250,223,473,142,gender
流行性耳下腺炎,2003,31,2003-W31,15,12,27,142,gender
川崎病,2003,31,2003-W31,1,0,1,142,gender
インフルエンザ,2021,50,2021-W50,3,3,6,412,gender
RSウイルス感染症,2021,50,2021-W50,4,10,14,260,gender
咽頭結膜熱,2021,50,2021-W50,17,13,30,260,gender
Ａ群溶血性レンサ球菌咽頭炎,2021,50,2021-W50,58,48,106,260,gender
感染性胃腸炎,2021,50,2021-W50,1109,1008,2117,260,gender
水痘,2021,50,2021-W50,20,13,33,260,gender
手足口病,2021,50,2021-W50,87,93,180,260,gender
突発性発しん,2021,50,2021-W50,30,38,68,260,gender
ヘルパンギーナ,2021,50,2021-W50,43,29,72,260,gender
流行性耳下腺炎,2021,50,2021-W50,2,4,6,260,gender
川崎病,2021,50,2021-W50,4,0,4,260,gender
インフルエンザ,2017,2,2017-W02,3076,3219,6295,415,gender
RSウイルス感染症,2017,2,2017-W02,16,7,23,263,gender
咽頭結膜熱,2017,2,2017-W02,30,36,66,263,gender
Ａ群溶血性レンサ球菌咽頭炎,2017,2,2017-W02,185,163,348,263,gender
感染性胃腸炎,2017,2,2017-W02,853,814,1667,263,gender
水痘,2017,2,2017-W02,51,47,98,263,gender
手足口病,2017,2,2017-W02,13,9,22,263,gender
突発性発しん,2017,2,2017-W02,64,61,125,263,gender
ヘルパンギーナ,2017,2,2017-W02,1,0,1,263,gender
流行性耳下腺炎,2017,2,2017-W02,62,59,121,263,gender
川崎病,2017,2,2017-W02,1,2,3,263,gender
インフルエンザ,2023,23,2023-W23,372,329,701,415,gender
新型コロナウイルス感染症（COVID-19）,2023,23,2023-W23,1227,1260,2487,415,gender
RSウイルス感染症,2023,23,2023-W23,225,223,448,261,gender
咽頭結膜熱,2023,23,2023-W23,76,54,130,261,gender
Ａ群溶血性レンサ球菌咽頭炎,2023,23,2023-W23,272,215,487,261,gender
感染性胃腸炎,2023,23,2023-W23,1038,761,1799,261,gender
水痘,2023,23,2023-W23,16,9,25,261,gender
手足口病,2023,23,2023-W23,88,82,170,261,gender
突発性発しん,2023,23,2023-W23,37,39,76,261,gender
ヘルパンギーナ,2023,23,2023-W23,548,459,1007,261,gender
流行性耳下腺炎,2023,23,2023-W23,20,12,32,261,gender
川崎病,2023,23,2023-W23,0,0,0,261,gender
インフルエンザ,2012,26,2012-W26,2,1,3,418,gender
RSウイルス感染症,2012,26,2012-W26,12,14,26,263,gender
咽頭結膜熱,2012,26,2012-W26,98,94,192,263,gender
Ａ群溶血性レンサ球菌咽頭炎,2012,26,2012-W26,423,336,759,263,gender
感染性胃腸炎,2012,26,2012-W26,1039,907,1946,263,gender
水痘,2012,26,2012-W26,151,136,287,263,gender
手足口病,2012,26,2012-W26,142,116,258,263,gender
突発性発しん,2012,26,2012-W26,99,99,198,263,gender
ヘルパンギーナ,2012,26,2012-W26,399,348,747,263,gender
流行性耳下腺炎,2012,26,2012-W26,49,35,84,263,gender
川崎病,2012,26,2012-W26,3,1,4,263,gender
インフルエンザ,2013,48,2013-W48,94,79,173,415,gender
RSウイルス感染症,2013,48,2013-W48,135,110,245,261,gender
咽頭結膜熱,2013,48,2013-W48,93,79,172,261,gender
Ａ群溶血性レンサ球菌咽頭炎,2013,48,2013-W48,296,240,536,261,gender
感染性胃腸炎,2013,48,2013-W48,1981,1965,3946,261,gender
水痘,2013,48,2013-W48,165,186,351,261,gender
手足口病,2013,48,2013-W48,35,30,65,261,gender
突発性発しん,2013,48,2013-W48,81,72,153,261,gender
ヘルパンギーナ,2013,48,2013-W48,13,7,20,261,gender
流行性耳下腺炎,2013,48,2013-W48,28,12,40,261,gender
川崎病,2013,48,2013-W48,4,1,5,261,gender
インフルエンザ,2006,15,2006-W15,49,38,87,178,gender
RSウイルス感染症,2006,15,2006-W15,1,1,2,142,gender
咽頭結膜熱,2006,15,2006-W15,23,16,39,142,gender
Ａ群溶血性レンサ球菌咽頭炎,2006,15,2006-W15,159,127,286,142,gender
感染性胃腸炎,2006,15,2006-W15,482,387,869,142,gender
水痘,2006,15,2006-W15,117,111,228,142,gender
手足口病,2006,15,2006-W15,2,1,3,142,gender
突発性発しん,2006,15,2006-W15,50,34,84,142,gender
ヘルパンギーナ,2006,15,2006-W15,9,10,19,142,gender
流行性耳下腺炎,2006,15,2006-W15,74,38,112,142,gender
川崎病,2006,15,2006-W15,1,1,2,142,gender
インフルエンザ,2023,6,2023-W06,2143,1865,4008,413,gender
RSウイルス感染症,2023,6,2023-W06,6,4,10,260,gender
咽頭結膜熱,2023,6,2023-W06,11,8,19,260,gender
Ａ群溶血性レンサ球菌咽頭炎,2023,6,2023-W06,48,33,81,260,gender
感染性胃腸炎,2023,6,2023-W06,908,841,1749,260,gender
水痘,2023,6,2023-W06,6,6,12,260,gender
手足口病,2023,6,2023-W06,7,10,17,260,gender
突発性発しん,2023,6,2023-W06,27,29,56,260,gender
ヘルパンギーナ,2023,6,2023-W06,3,1,4,260,gender
流行性耳下腺炎,2023,6,2023-W06,4,5,9,260,gender
川崎病,2023,6,2023-W06,1,0,1,260,gender
インフルエンザ,2009,36,2009-W36,583,481,1064,290,gender
RSウイルス感染症,2009,36,2009-W36,15,12,27,150,gender
咽頭結膜熱,2009,36,2009-W36,5,4,9,150,gender
Ａ群溶血性レンサ球菌咽頭炎,2009,36,2009-W36,29,30,59,150,gender
感染性胃腸炎,2009,36,2009-W36,229,193,422,150,gender
水痘,2009,36,2009-W36,26,18,44,150,gender
手足口病,2009,36,2009-W36,102,74,176,150,gender
突発性発しん,2009,36,2009-W36,36,52,88,150,gender
ヘルパンギーナ,2009,36,2009-W36,99,70,169,150,gender
流行性耳下腺炎,2009,36,2009-W36,49,29,78,150,gender
川崎病,2009,36,2009-W36,1,0,1,150,gender
インフルエンザ,2016,52,2016-W52,1744,1844,3588,396,gender
RSウイルス感染症,2016,52,2016-W52,13,14,27,249,gender
咽頭結膜熱,2016,52,2016-W52,40,36,76,249,gender
Ａ群溶血性レンサ球菌咽頭炎,2016,52,2016-W52,164,154,318,249,gender
感染性胃腸炎,2016,52,2016-W52,1258,1247,2505,249,gender
水痘,2016,52,2016-W52,62,52,114,249,gender
手足口病,2016,52,2016-W52,25,12,37,249,gender
突発性発しん,2016,52,2016-W52,23,33,56,249,gender
ヘルパンギーナ,2016,52,2016-W52,6,0,6,249,gender
流行性耳下腺炎,2016,52,2016-W52,40,40,80,249,gender
川崎病,2016,52,2016-W52,2,3,5,249,gender
インフルエンザ,2005,9,2005-W09,2384,2445,4829,178,gender
RSウイルス感染症,2005,9,2005-W09,5,2,7,142,gender
咽頭結膜熱,2005,9,2005-W09,4,8,12,142,gender
Ａ群溶血性レンサ球菌咽頭炎,2005,9,2005-W09,75,51,126,142,gender
感染性胃腸炎,2005,9,2005-W09,433,418,851,142,gender
水痘,2005,9,2005-W09,62,54,116,142,gender
手足口病,2005,9,2005-W09,5,7,12,142,gender
突発性発しん,2005,9,2005-W09,32,21,53,142,gender
ヘルパンギーナ,2005,9,2005-W09,1,4,5,142,gender
流行性耳下腺炎,2005,9,2005-W09,40,38,78,142,gender
川崎病,2005,9,2005-W09,0,0,0,142,gender
インフルエンザ,2014,21,2014-W21,26,23,49,414,gender
RSウイルス感染症,2014,21,2014-W21,13,3,16,263,gender
咽頭結膜熱,2014,21,2014-W21,78,66,144,263,gender
Ａ群溶血性レンサ球菌咽頭炎,2014,21,2014-W21,496,397,893,263,gender
感染性胃腸炎,2014,21,2014-W21,1063,870,1933,263,gender
水痘,2014,21,2014-W21,156,168,324,263,gender
手足口病,2014,21,2014-W21,35,26,61,263,gender
突発性発しん,2014,21,2014-W21,95,100,195,263,gender
ヘルパンギーナ,2014,21,2014-W21,17,12,29,263,gender
流行性耳下腺炎,2014,21,2014-W21,33,25,58,263,gender
川崎病,2014,21,2014-W21,3,1,4,263,gender
インフルエンザ,2021,21,2021-W21,0,0,0,406,gender
RSウイルス感染症,2021,21,2021-W21,178,190,368,258,gender
咽頭結膜熱,2021,21,2021-W21,32,29,61,258,gender
Ａ群溶血性レンサ球菌咽頭炎,2021,21,2021-W21,44,43,87,258,gender
感染性胃腸炎,2021,21,2021-W21,577,481,1058,258,gender
水痘,2021,21,2021-W21,13,15,28,258,gender
手足口病,2021,21,2021-W21,9,7,16,258,gender
突発性発しん,2021,21,2021-W21,78,67,145,258,gender
ヘルパンギーナ,2021,21,2021-W21,7,6,13,258,gender
流行性耳下腺炎,2021,21,2021-W21,5,5,10,258,gender
川崎病,2021,21,2021-W21,1,2,3,258,gender
インフルエンザ,2023,52,2023-W52,3889,3825,7714,403,gender
新型コロナウイルス感染症（COVID-19）,2023,52,2023-W52,674,723,1397,403,gender
RSウイルス感染症,2023,52,2023-W52,2,2,4,252,gender
咽頭結膜熱,2023,52,2023-W52,252,229,481,252,gender
Ａ群溶血性レンサ球菌咽頭炎,2023,52,2023-W52,633,543,1176,252,gender
感染性胃腸炎,2023,52,2023-W52,1243,1143,2386,252,gender
水痘,2023,52,2023-W52,28,23,51,252,gender
手足口病,2023,52,2023-W52,37,23,60,252,gender
突発性発しん,2023,52,2023-W52,16,22,38,252,gender
ヘルパンギーナ,2023,52,2023-W52,2,2,4,252,gender
流行性耳下腺炎,2023,52,2023-W52,2,4,6,252,gender
川崎病,2023,52,2023-W52,3,1,4,252,gender
インフルエンザ,2001,33,2001-W33,0,0,0,178,gender
RSウイルス感染症,2001,33,2001-W33,0,0,0,142,gender
咽頭結膜熱,2001,33,2001-W33,6,5,11,142,gender
Ａ群溶血性レンサ球菌咽頭炎,2001,33,2001-W33,9,6,15,142,gender
感染性胃腸炎,2001,33,2001-W33,62,30,92,142,gender
水痘,2001,33,2001-W33,12,8,20,142,gender
手足口病,2001,33,2001-W33,8,14,22,142,gender
突発性発しん,2001,33,2001-W33,17,16,33,142,gender
ヘルパンギーナ,2001,33,2001-W33,27,37,64,142,gender
流行性耳下腺炎,2001,33,2001-W33,33,30,63,142,gender
川崎病,2001,33,2001-W33,0,1,1,142,gender
インフルエンザ,2014,3,2014-W03,2382,2257,4639,415,gender
RSウイルス感染症,2014,3,2014-W03,48,37,85,262,gender
咽頭結膜熱,2014,3,2014-W03,28,30,58,262,gender
Ａ群溶血性レンサ球菌咽頭炎,2014,3,2014-W03,201,203,404,262,gender
感染性胃腸炎,2014,3,2014-W03,1494,1442,2936,262,gender
水痘,2014,3,2014-W03,102,99,201,262,gender
手足口病,2014,3,2014-W03,8,5,13,262,gender
突発性発しん,2014,3,2014-W03,63,86,149,262,gender
ヘルパンギーナ,2014,3,2014-W03,2,0,2,262,gender
流行性耳下腺炎,2014,3,2014-W03,18,16,34,262,gender
川崎病,2014,3,2014-W03,1,0,1,262,gender
インフルエンザ,2003,40,2003-W40,0,0,0,178,gender
RSウイルス感染症,2003,40,2003-W40,0,0,0,142,gender
咽頭結膜熱,2003,40,2003-W40,11,5,16,142,gender
Ａ群溶血性レンサ球菌咽頭炎,2003,40,2003-W40,22,18,40,142,gender
感染性胃腸炎,2003,40,2003-W40,175,170,345,142,gender
水痘,2003,40,2003-W40,21,24,45,142,gender
手足口病,2003,40,2003-W40,43,27,70,142,gender
突発性発しん,2003,40,2003-W40,48,42,90,142,gender
ヘルパンギーナ,2003,40,2003-W40,36,27,63,142,gender
流行性耳下腺炎,2003,40,2003-W40,8,11,19,142,gender
川崎病,2003,40,2003-W40,0,0,0,142,gender
インフルエンザ,2007,34,2007-W34,0,0,0,282,gender
RSウイルス感染症,2007,34,2007-W34,2,2,4,145,gender
咽頭結膜熱,2007,34,2007-W34,14,16,30,145,gender
Ａ群溶血性レンサ球菌咽頭炎,2007,34,2007-W34,39,33,72,145,gender
感染性胃腸炎,2007,34,2007-W34,248,206,454,145,gender
水痘,2007,34,2007-W34,36,25,61,145,gender
手足口病,2007,34,2007-W34,98,59,157,145,gender
突発性発しん,2007,34,2007-W34,33,43,76,145,gender
ヘルパンギーナ,2007,34,2007-W34,93,88,181,145,gender
流行性耳下腺炎,2007,34,2007-W34,13,19,32,145,gender
川崎病,2007,34,2007-W34,3,1,4,145,gender
インフルエンザ,2008,17,2008-W17,70,65,135,288,gender
RSウイルス感染症,2008,17,2008-W17,3,2,5,150,gender
咽頭結膜熱,2008,17,2008-W17,22,24,46,150,gender
Ａ群溶血性レンサ球菌咽頭炎,2008,17,2008-W17,200,165,365,150,gender
感染性胃腸炎,2008,17,2008-W17,599,502,1101,150,gender
水痘,2008,17,2008-W17,127,104,231,150,gender
手足口病,2008,17,2008-W17,5,6,11,150,gender
突発性発しん,2008,17,2008-W17,63,63,126,150,gender
ヘルパンギーナ,2008,17,2008-W17,4,4,8,150,gender
流行性耳下腺炎,2008,17,2008-W17,23,23,46,150,gender
川崎病,2008,17,2008-W17,2,1,3,150,gender
インフルエンザ,2005,47,2005-W47,15,18,33,178,gender
RSウイルス感染症,2005,47,2005-W47,22,27,49,142,gender
咽頭結膜熱,2005,47,2005-W47,29,27,56,142,gender
Ａ群溶血性レンサ球菌咽頭炎,2005,47,2005-W47,108,114,222,142,gender
感染性胃腸炎,2005,47,2005-W47,647,564,1211,142,gender
水痘,2005,47,2005-W47,73,63,136,142,gender
手足口病,2005,47,2005-W47,24,15,39,142,gender
突発性発しん,2005,47,2005-W47,39,46,85,142,gender
ヘルパンギーナ,2005,47,2005-W47,8,7,15,142,gender
流行性耳下腺炎,2005,47,2005-W47,96,83,179,142,gender
川崎病,2005,47,2005-W47,0,0,0,142,gender
インフルエンザ,2004,29,2004-W29,0,0,0,178,gender
RSウイルス感染症,2004,29,2004-W29,2,2,4,142,gender
咽頭結膜熱,2004,29,2004-W29,88,85,173,142,gender
Ａ群溶血性レンサ球菌咽頭炎,2004,29,2004-W29,41,34,75,142,gender
感染性胃腸炎,2004,29,2004-W29,171,141,312,142,gender
水痘,2004,29,2004-W29,26,34,60,142,gender
手足口病,2004,29,2004-W29,121,107,228,142,gender
突発性発しん,2004,29,2004-W29,40,48,88,142,gender
ヘルパンギーナ,2004,29,2004-W29,449,450,899,142,gender
流行性耳下腺炎,2004,29,2004-W29,52,30,82,142,gender
川崎病,2004,29,2004-W29,0,0,0,142,gender
インフルエンザ,2018,50,2018-W50,581,536,1117,417,gender
RSウイルス感染症,2018,50,2018-W50,41,31,72,263,gender
咽頭結膜熱,2018,50,2018-W50,68,70,138,263,gender
Ａ群溶血性レンサ球菌咽頭炎,2018,50,2018-W50,466,390,856,263,gender
感染性胃腸炎,2018,50,2018-W50,1747,1572,3319,263,gender
水痘,2018,50,2018-W50,106,96,202,263,gender
手足口病,2018,50,2018-W50,110,99,209,263,gender
突発性発しん,2018,50,2018-W50,52,54,106,263,gender
ヘルパンギーナ,2018,50,2018-W50,12,6,18,263,gender
流行性耳下腺炎,2018,50,2018-W50,9,6,15,263,gender
川崎病,2018,50,2018-W50,3,1,4,263,gender
インフルエンザ,2016,23,2016-W23,16,11,27,413,gender
RSウイルス感染症,2016,23,2016-W23,16,11,27,259,gender
咽頭結膜熱,2016,23,2016-W23,137,123,260,259,gender
Ａ群溶血性レンサ球菌咽頭炎,2016,23,2016-W23,474,418,892,259,gender
感染性胃腸炎,2016,23,2016-W23,1012,901,1913,259,gender
水痘,2016,23,2016-W23,80,49,129,259,gender
手足口病,2016,23,2016-W23,42,37,79,259,gender
突発性発しん,2016,23,2016-W23,102,107,209,259,gender
ヘルパンギーナ,2016,23,2016-W23,50,53,103,259,gender
流行性耳下腺炎,2016,23,2016-W23,93,81,174,259,gender
川崎病,2016,23,2016-W23,1,4,5,259,gender
インフルエンザ,2008,29,2008-W29,1,5,6,282,gender
RSウイルス感染症,2008,29,2008-W29,0,2,2,147,gender
咽頭結膜熱,2008,29,2008-W29,81,71,152,147,gender
Ａ群溶血性レンサ球菌咽頭炎,2008,29,2008-W29,109,90,199,147,gender
感染性胃腸炎,2008,29,2008-W29,349,232,581,147,gender
水痘,2008,29,2008-W29,83,67,150,147,gender
手足口病,2008,29,2008-W29,159,141,300,147,gender
突発性発しん,2008,29,2008-W29,48,45,93,147,gender
ヘルパンギーナ,2008,29,2008-W29,538,494,1032,147,gender
流行性耳下腺炎,2008,29,2008-W29,41,46,87,147,gender
川崎病,2008,29,2008-W29,0,2,2,147,gender
インフルエンザ,2014,50,2014-W50,2141,2051,4192,413,gender
RSウイルス感染症,2014,50,2014-W50,248,224,472,262,gender
咽頭結膜熱,2014,50,2014-W50,86,54,140,262,gender
Ａ群溶血性レンサ球菌咽頭炎,2014,50,2014-W50,398,347,745,262,gender
感染性胃腸炎,2014,50,2014-W50,1672,1609,3281,262,gender
水痘,2014,50,2014-W50,154,168,322,262,gender
手足口病,2014,50,2014-W50,68,46,114,262,gender
突発性発しん,2014,50,2014-W50,69,52,121,262,gender
ヘルパンギーナ,2014,50,2014-W50,9,0,9,262,gender
流行性耳下腺炎,2014,50,2014-W50,40,26,66,262,gender
川崎病,2014,50,2014-W50,2,5,7,262,gender
インフルエンザ,2020,7,2020-W07,1295,1185,2480,415,gender
RSウイルス感染症,2020,7,2020-W07,29,25,54,261,gender
咽頭結膜熱,2020,7,2020-W07,35,34,69,261,gender
Ａ群溶血性レンサ球菌咽頭炎,2020,7,2020-W07,452,441,893,261,gender
感染性胃腸炎,2020,7,2020-W07,965,898,1863,261,gender
水痘,2020,7,2020-W07,66,65,131,261,gender
手足口病,2020,7,2020-W07,13,11,24,261,gender
突発性発しん,2020,7,2020-W07,39,39,78,261,gender
ヘルパンギーナ,2020,7,2020-W07,3,2,5,261,gender
流行性耳下腺炎,2020,7,2020-W07,6,5,11,261,gender
川崎病,2020,7,2020-W07,1,1,2,261,gender
インフルエンザ,2006,8,2006-W08,788,764,1552,178,gender
RSウイルス感染症,2006,8,2006-W08,1,4,5,142,gender
咽頭結膜熱,2006,8,2006-W08,31,24,55,142,gender
Ａ群溶血性レンサ球菌咽頭炎,2006,8,2006-W08,175,140,315,142,gender
感染性胃腸炎,2006,8,2006-W08,544,519,1063,142,gender
水痘,2006,8,2006-W08,85,80,165,142,gender
手足口病,2006,8,2006-W08,3,2,5,142,gender
突発性発しん,2006,8,2006-W08,32,36,68,142,gender
ヘルパンギーナ,2006,8,2006-W08,1,1,2,142,gender
流行性耳下腺炎,2006,8,2006-W08,41,42,83,142,gender
川崎病,2006,8,2006-W08,0,1,1,142,gender
インフルエンザ,2003,4,2003-W04,2415,2277,4692,178,gender
RSウイルス感染症,2003,4,2003-W04,0,0,0,142,gender
咽頭結膜熱,2003,4,2003-W04,4,3,7,142,gender
Ａ群溶血性レンサ球菌咽頭炎,2003,4,2003-W04,42,46,88,142,gender
感染性胃腸炎,2003,4,2003-W04,561,496,1057,142,gender
水痘,2003,4,2003-W04,81,69,150,142,gender
手足口病,2003,4,2003-W04,3,3,6,142,gender
突発性発しん,2003,4,2003-W04,31,21,52,142,gender
ヘルパンギーナ,2003,4,2003-W04,3,2,5,142,gender
流行性耳下腺炎,2003,4,2003-W04,14,7,21,142,gender
川崎病,2003,4,2003-W04,0,0,0,142,gender
インフルエンザ,2009,47,2009-W47,3583,3322,6905,288,gender
RSウイルス感染症,2009,47,2009-W47,22,13,35,148,gender
咽頭結膜熱,2009,47,2009-W47,6,13,19,148,gender
Ａ群溶血性レンサ球菌咽頭炎,2009,47,2009-W47,54,51,105,148,gender
感染性胃腸炎,2009,47,2009-W47,269,205,474,148,gender
水痘,2009,47,2009-W47,50,57,107,148,gender
手足口病,2009,47,2009-W47,30,16,46,148,gender
突発性発しん,2009,47,2009-W47,46,30,76,148,gender
ヘルパンギーナ,2009,47,2009-W47,6,5,11,148,gender
流行性耳下腺炎,2009,47,2009-W47,47,32,79,148,gender
川崎病,2009,47,2009-W47,0,0,0,148,gender
インフルエンザ,2004,17,2004-W17,4,4,8,178,gender
RSウイルス感染症,2004,17,2004-W17,2,2,4,142,gender
咽頭結膜熱,2004,17,2004-W17,9,13,22,142,gender
Ａ群溶血性レンサ球菌咽頭炎,2004,17,2004-W17,97,107,204,142,gender
感染性胃腸炎,2004,17,2004-W17,353,349,702,142,gender
水痘,2004,17,2004-W17,80,77,157,142,gender
手足口病,2004,17,2004-W17,6,3,9,142,gender
突発性発しん,2004,17,2004-W17,46,39,85,142,gender
ヘルパンギーナ,2004,17,2004-W17,6,8,14,142,gender
流行性耳下腺炎,2004,17,2004-W17,25,13,38,142,gender
川崎病,2004,17,2004-W17,0,3,3,142,gender
インフルエンザ,2013,39,2013-W39,1,0,1,414,gender
RSウイルス感染症,2013,39,2013-W39,148,97,245,262,gender
咽頭結膜熱,2013,39,2013-W39,38,28,66,262,gender
Ａ群溶血性レンサ球菌咽頭炎,2013,39,2013-W39,116,93,209,262,gender
感染性胃腸炎,2013,39,2013-W39,402,334,736,262,gender
水痘,2013,39,2013-W39,56,56,112,262,gender
手足口病,2013,39,2013-W39,185,140,325,262,gender
突発性発しん,2013,39,2013-W39,68,69,137,262,gender
ヘルパンギーナ,2013,39,2013-W39,39,35,74,262,gender
流行性耳下腺炎,2013,39,2013-W39,29,19,48,262,gender
川崎病,2013,39,2013-W39,1,0,1,262,gender
インフルエンザ,2002,10,2002-W10,588,596,1184,178,gender
RSウイルス感染症,2002,10,2002-W10,0,0,0,142,gender
咽頭結膜熱,2002,10,2002-W10,8,3,11,142,gender
Ａ群溶血性レンサ球菌咽頭炎,2002,10,2002-W10,32,41,73,142,gender
感染性胃腸炎,2002,10,2002-W10,517,460,977,142,gender
水痘,2002,10,2002-W10,68,67,135,142,gender
手足口病,2002,10,2002-W10,7,7,14,142,gender
突発性発しん,2002,10,2002-W10,30,21,51,142,gender
ヘルパンギーナ,2002,10,2002-W10,3,3,6,142,gender
流行性耳下腺炎,2002,10,2002-W10,45,36,81,142,gender
川崎病,2002,10,2002-W10,0,0,0,142,gender
インフルエンザ,2010,24,2010-W24,12,3,15,285,gender
RSウイルス感染症,2010,24,2010-W24,5,4,9,148,gender
咽頭結膜熱,2010,24,2010-W24,33,24,57,148,gender
Ａ群溶血性レンサ球菌咽頭炎,2010,24,2010-W24,154,120,274,148,gender
感染性胃腸炎,2010,24,2010-W24,483,427,910,148,gender
水痘,2010,24,2010-W24,143,132,275,148,gender
手足口病,2010,24,2010-W24,119,68,187,148,gender
突発性発しん,2010,24,2010-W24,50,45,95,148,gender
ヘルパンギーナ,2010,24,2010-W24,144,137,281,148,gender
流行性耳下腺炎,2010,24,2010-W24,103,78,181,148,gender
川崎病,2010,24,2010-W24,0,1,1,148,gender
インフルエンザ,2013,36,2013-W36,0,2,2,408,gender
RSウイルス感染症,2013,36,2013-W36,123,89,212,258,gender
咽頭結膜熱,2013,36,2013-W36,80,60,140,258,gender
Ａ群溶血性レンサ球菌咽頭炎,2013,36,2013-W36,108,94,202,258,gender
感染性胃腸炎,2013,36,2013-W36,434,340,774,258,gender
水痘,2013,36,2013-W36,65,47,112,258,gender
手足口病,2013,36,2013-W36,391,346,737,258,gender
突発性発しん,2013,36,2013-W36,95,109,204,258,gender
ヘルパンギーナ,2013,36,2013-W36,111,118,229,258,gender
流行性耳下腺炎,2013,36,2013-W36,33,25,58,258,gender
川崎病,2013,36,2013-W36,1,3,4,258,gender
インフルエンザ,2011,45,2011-W45,9,14,23,411,gender
RSウイルス感染症,2011,45,2011-W45,40,36,76,263,gender
咽頭結膜熱,2011,45,2011-W45,31,25,56,263,gender
Ａ群溶血性レンサ球菌咽頭炎,2011,45,2011-W45,230,206,436,263,gender
感染性胃腸炎,2011,45,2011-W45,748,627,1375,263,gender
水痘,2011,45,2011-W45,152,130,282,263,gender
手足口病,2011,45,2011-W45,105,74,179,263,gender
突発性発しん,2011,45,2011-W45,95,90,185,263,gender
ヘルパンギーナ,2011,45,2011-W45,7,14,21,263,gender
流行性耳下腺炎,2011,45,2011-W45,54,36,90,263,gender
川崎病,2011,45,2011-W45,5,1,6,263,gender
インフルエンザ,2021,10,2021-W10,1,1,2,412,gender
RSウイルス感染症,2021,10,2021-W10,15,10,25,260,gender
咽頭結膜熱,2021,10,2021-W10,9,6,15,260,gender
Ａ群溶血性レンサ球菌咽頭炎,2021,10,2021-W10,49,45,94,260,gender
感染性胃腸炎,2021,10,2021-W10,386,318,704,260,gender
水痘,2021,10,2021-W10,14,10,24,260,gender
手足口病,2021,10,2021-W10,3,2,5,260,gender
突発性発しん,2021,10,2021-W10,45,50,95,260,gender
ヘルパンギーナ,2021,10,2021-W10,4,1,5,260,gender
流行性耳下腺炎,2021,10,2021-W10,7,4,11,260,gender
川崎病,2021,10,2021-W10,0,2,2,260,gender
インフルエンザ,2008,5,2008-W05,1497,1555,3052,288,gender
RSウイルス感染症,2008,5,2008-W05,10,6,16,150,gender
咽頭結膜熱,2008,5,2008-W05,15,10,25,150,gender
Ａ群溶血性レンサ球菌咽頭炎,2008,5,2008-W05,150,127,277,150,gender
感染性胃腸炎,2008,5,2008-W05,754,755,1509,150,gender
水痘,2008,5,2008-W05,82,78,160,150,gender
手足口病,2008,5,2008-W05,4,5,9,150,gender
突発性発しん,2008,5,2008-W05,38,41,79,150,gender
ヘルパンギーナ,2008,5,2008-W05,2,1,3,150,gender
流行性耳下腺炎,2008,5,2008-W05,12,20,32,150,gender
川崎病,2008,5,2008-W05,5,1,6,150,gender
インフルエンザ,2020,8,2020-W08,1097,988,2085,414,gender
RSウイルス感染症,2020,8,2020-W08,19,27,46,262,gender
咽頭結膜熱,2020,8,2020-W08,44,30,74,262,gender
Ａ群溶血性レンサ球菌咽頭炎,2020,8,2020-W08,515,482,997,262,gender
感染性胃腸炎,2020,8,2020-W08,944,858,1802,262,gender
水痘,2020,8,2020-W08,50,54,104,262,gender
手足口病,2020,8,2020-W08,4,11,15,262,gender
突発性発しん,2020,8,2020-W08,50,51,101,262,gender
ヘルパンギーナ,2020,8,2020-W08,3,3,6,262,gender
流行性耳下腺炎,2020,8,2020-W08,8,5,13,262,gender
川崎病,2020,8,2020-W08,1,1,2,262,gender
インフルエンザ,2025,4,2025-W04,1362,1397,2759,418,gender
新型コロナウイルス感染症（COVID-19）,2025,4,2025-W04,703,761,1464,418,gender
RSウイルス感染症,2025,4,2025-W04,76,85,161,263,gender
咽頭結膜熱,2025,4,2025-W04,28,19,47,263,gender
Ａ群溶血性レンサ球菌咽頭炎,2025,4,2025-W04,331,279,610,263,gender
感染性胃腸炎,2025,4,2025-W04,1073,1024,2097,263,gender
水痘,2025,4,2025-W04,52,40,92,263,gender
手足口病,2025,4,2025-W04,10,11,21,263,gender
突発性発しん,2025,4,2025-W04,33,27,60,263,gender
ヘルパンギーナ,2025,4,2025-W04,1,1,2,263,gender
流行性耳下腺炎,2025,4,2025-W04,8,3,11,263,gender
川崎病,2025,4,2025-W04,6,2,8,263,gender
インフルエンザ,2008,26,2008-W26,11,9,20,284,gender
RSウイルス感染症,2008,26,2008-W26,0,0,0,147,gender
咽頭結膜熱,2008,26,2008-W26,53,45,98,147,gender
Ａ群溶血性レンサ球菌咽頭炎,2008,26,2008-W26,196,174,370,147,gender
感染性胃腸炎,2008,26,2008-W26,448,344,792,147,gender
水痘,2008,26,2008-W26,110,116,226,147,gender
手足口病,2008,26,2008-W26,73,60,133,147,gender
突発性発しん,2008,26,2008-W26,58,62,120,147,gender
ヘルパンギーナ,2008,26,2008-W26,197,196,393,147,gender
流行性耳下腺炎,2008,26,2008-W26,67,48,115,147,gender
川崎病,2008,26,2008-W26,0,1,1,147,gender
インフルエンザ,2015,31,2015-W31,5,6,11,410,gender
RSウイルス感染症,2015,31,2015-W31,14,13,27,261,gender
咽頭結膜熱,2015,31,2015-W31,87,61,148,261,gender
Ａ群溶血性レンサ球菌咽頭炎,2015,31,2015-W31,259,209,468,261,gender
感染性胃腸炎,2015,31,2015-W31,575,490,1065,261,gender
水痘,2015,31,2015-W31,44,47,91,261,gender
手足口病,2015,31,2015-W31,2009,1669,3678,261,gender
突発性発しん,2015,31,2015-W31,83,96,179,261,gender
ヘルパンギーナ,2015,31,2015-W31,410,397,807,261,gender
流行性耳下腺炎,2015,31,2015-W31,63,33,96,261,gender
川崎病,2015,31,2015-W31,1,2,3,261,gender
インフルエンザ,2004,18,2004-W18,1,0,1,178,gender
RSウイルス感染症,2004,18,2004-W18,3,3,6,142,gender
咽頭結膜熱,2004,18,2004-W18,15,8,23,142,gender
Ａ群溶血性レンサ球菌咽頭炎,2004,18,2004-W18,97,78,175,142,gender
感染性胃腸炎,2004,18,2004-W18,344,307,651,142,gender
水痘,2004,18,2004-W18,92,59,151,142,gender
手足口病,2004,18,2004-W18,7,6,13,142,gender
突発性発しん,2004,18,2004-W18,47,44,91,142,gender
ヘルパンギーナ,2004,18,2004-W18,8,11,19,142,gender
流行性耳下腺炎,2004,18,2004-W18,27,18,45,142,gender
川崎病,2004,18,2004-W18,1,0,1,142,gender
インフルエンザ,2009,48,2009-W48,3072,2993,6065,288,gender
RSウイルス感染症,2009,48,2009-W48,10,10,20,149,gender
咽頭結膜熱,2009,48,2009-W48,4,8,12,149,gender
Ａ群溶血性レンサ球菌咽頭炎,2009,48,2009-W48,63,42,105,149,gender
感染性胃腸炎,2009,48,2009-W48,251,263,514,149,gender
水痘,2009,48,2009-W48,83,60,143,149,gender
手足口病,2009,48,2009-W48,20,17,37,149,gender
突発性発しん,2009,48,2009-W48,35,20,55,149,gender
ヘルパンギーナ,2009,48,2009-W48,10,9,19,149,gender
流行性耳下腺炎,2009,48,2009-W48,56,40,96,149,gender
川崎病,2009,48,2009-W48,0,1,1,149,gender
インフルエンザ,2006,7,2006-W07,1302,1308,2610,178,gender
RSウイルス感染症,2006,7,2006-W07,5,2,7,142,gender
咽頭結膜熱,2006,7,2006-W07,16,18,34,142,gender
Ａ群溶血性レンサ球菌咽頭炎,2006,7,2006-W07,140,160,300,142,gender
感染性胃腸炎,2006,7,2006-W07,584,536,1120,142,gender
水痘,2006,7,2006-W07,102,91,193,142,gender
手足口病,2006,7,2006-W07,2,3,5,142,gender
突発性発しん,2006,7,2006-W07,41,36,77,142,gender
ヘルパンギーナ,2006,7,2006-W07,4,3,7,142,gender
流行性耳下腺炎,2006,7,2006-W07,50,46,96,142,gender
川崎病,2006,7,2006-W07,1,2,3,142,gender
インフルエンザ,2017,42,2017-W42,51,48,99,415,gender
RSウイルス感染症,2017,42,2017-W42,72,60,132,263,gender
咽頭結膜熱,2017,42,2017-W42,48,41,89,263,gender
Ａ群溶血性レンサ球菌咽頭炎,2017,42,2017-W42,288,236,524,263,gender
感染性胃腸炎,2017,42,2017-W42,548,467,1015,263,gender
水痘,2017,42,2017-W42,53,47,100,263,gender
手足口病,2017,42,2017-W42,337,286,623,263,gender
突発性発しん,2017,42,2017-W42,56,63,119,263,gender
ヘルパンギーナ,2017,42,2017-W42,70,76,146,263,gender
流行性耳下腺炎,2017,42,2017-W42,33,19,52,263,gender
川崎病,2017,42,2017-W42,2,2,4,263,gender
インフルエンザ,2019,31,2019-W31,25,30,55,409,gender
RSウイルス感染症,2019,31,2019-W31,309,251,560,259,gender
咽頭結膜熱,2019,31,2019-W31,47,35,82,259,gender
Ａ群溶血性レンサ球菌咽頭炎,2019,31,2019-W31,182,156,338,259,gender
感染性胃腸炎,2019,31,2019-W31,479,421,900,259,gender
水痘,2019,31,2019-W31,47,39,86,259,gender
手足口病,2019,31,2019-W31,1719,1490,3209,259,gender
突発性発しん,2019,31,2019-W31,61,52,113,259,gender
ヘルパンギーナ,2019,31,2019-W31,493,434,927,259,gender
流行性耳下腺炎,2019,31,2019-W31,9,9,18,259,gender
川崎病,2019,31,2019-W31,1,1,2,259,gender
インフルエンザ,2005,48,2005-W48,27,21,48,178,gender
RSウイルス感染症,2005,48,2005-W48,36,29,65,142,gender
咽頭結膜熱,2005,48,2005-W48,29,40,69,142,gender
Ａ群溶血性レンサ球菌咽頭炎,2005,48,2005-W48,169,132,301,142,gender
感染性胃腸炎,2005,48,2005-W48,919,846,1765,142,gender
水痘,2005,48,2005-W48,118,94,212,142,gender
手足口病,2005,48,2005-W48,13,11,24,142,gender
突発性発しん,2005,48,2005-W48,50,33,83,142,gender
ヘルパンギーナ,2005,48,2005-W48,7,3,10,142,gender
流行性耳下腺炎,2005,48,2005-W48,79,81,160,142,gender
川崎病,2005,48,2005-W48,0,0,0,142,gender
インフルエンザ,2024,34,2024-W34,57,51,108,410,gender
新型コロナウイルス感染症（COVID-19）,2024,34,2024-W34,872,1090,1962,410,gender
RSウイルス感染症,2024,34,2024-W34,30,20,50,257,gender
咽頭結膜熱,2024,34,2024-W34,18,21,39,257,gender
Ａ群溶血性レンサ球菌咽頭炎,2024,34,2024-W34,158,130,288,257,gender
感染性胃腸炎,2024,34,2024-W34,346,294,640,257,gender
水痘,2024,34,2024-W34,14,10,24,257,gender
手足口病,2024,34,2024-W34,626,540,1166,257,gender
突発性発しん,2024,34,2024-W34,37,42,79,257,gender
ヘルパンギーナ,2024,34,2024-W34,98,81,179,257,gender
流行性耳下腺炎,2024,34,2024-W34,3,2,5,257,gender
川崎病,2024,34,2024-W34,1,1,2,257,gender
インフルエンザ,2008,18,2008-W18,48,45,93,281,gender
RSウイルス感染症,2008,18,2008-W18,2,4,6,146,gender
咽頭結膜熱,2008,18,2008-W18,32,27,59,146,gender
Ａ群溶血性レンサ球菌咽頭炎,2008,18,2008-W18,161,151,312,146,gender
感染性胃腸炎,2008,18,2008-W18,425,369,794,146,gender
水痘,2008,18,2008-W18,112,91,203,146,gender
手足口病,2008,18,2008-W18,10,6,16,146,gender
突発性発しん,2008,18,2008-W18,35,39,74,146,gender
ヘルパンギーナ,2008,18,2008-W18,1,6,7,146,gender
流行性耳下腺炎,2008,18,2008-W18,36,26,62,146,gender
川崎病,2008,18,2008-W18,0,0,0,146,gender
インフルエンザ,2016,12,2016-W12,1942,1918,3860,415,gender
RSウイルス感染症,2016,12,2016-W12,11,14,25,261,gender
咽頭結膜熱,2016,12,2016-W12,12,19,31,261,gender
Ａ群溶血性レンサ球菌咽頭炎,2016,12,2016-W12,325,264,589,261,gender
感染性胃腸炎,2016,12,2016-W12,724,579,1303,261,gender
水痘,2016,12,2016-W12,50,36,86,261,gender
手足口病,2016,12,2016-W12,10,8,18,261,gender
突発性発しん,2016,12,2016-W12,58,33,91,261,gender
ヘルパンギーナ,2016,12,2016-W12,3,1,4,261,gender
流行性耳下腺炎,2016,12,2016-W12,61,50,111,261,gender
川崎病,2016,12,2016-W12,0,1,1,261,gender
インフルエンザ,2004,26,2004-W26,0,0,0,178,gender
RSウイルス感染症,2004,26,2004-W26,2,1,3,142,gender
咽頭結膜熱,2004,26,2004-W26,71,58,129,142,gender
Ａ群溶血性レンサ球菌咽頭炎,2004,26,2004-W26,76,77,153,142,gender
感染性胃腸炎,2004,26,2004-W26,262,209,471,142,gender
水痘,2004,26,2004-W26,81,79,160,142,gender
手足口病,2004,26,2004-W26,56,52,108,142,gender
突発性発しん,2004,26,2004-W26,38,47,85,142,gender
ヘルパンギーナ,2004,26,2004-W26,193,172,365,142,gender
流行性耳下腺炎,2004,26,2004-W26,29,25,54,142,gender
川崎病,2004,26,2004-W26,0,0,0,142,gender
インフルエンザ,2002,21,2002-W21,4,1,5,178,gender
RSウイルス感染症,2002,21,2002-W21,0,0,0,142,gender
咽頭結膜熱,2002,21,2002-W21,5,6,11,142,gender
Ａ群溶血性レンサ球菌咽頭炎,2002,21,2002-W21,77,61,138,142,gender
感染性胃腸炎,2002,21,2002-W21,344,258,602,142,gender
水痘,2002,21,2002-W21,118,90,208,142,gender
手足口病,2002,21,2002-W21,39,33,72,142,gender
突発性発しん,2002,21,2002-W21,41,36,77,142,gender
ヘルパンギーナ,2002,21,2002-W21,49,59,108,142,gender
流行性耳下腺炎,2002,21,2002-W21,48,28,76,142,gender
川崎病,2002,21,2002-W21,0,0,0,142,gender
インフルエンザ,2000,52,2000-W52,25,17,42,178,gender
RSウイルス感染症,2000,52,2000-W52,0,0,0,142,gender
咽頭結膜熱,2000,52,2000-W52,3,6,9,142,gender
Ａ群溶血性レンサ球菌咽頭炎,2000,52,2000-W52,34,34,68,142,gender
感染性胃腸炎,2000,52,2000-W52,799,771,1570,142,gender
水痘,2000,52,2000-W52,88,100,188,142,gender
手足口病,2000,52,2000-W52,16,13,29,142,gender
突発性発しん,2000,52,2000-W52,28,26,54,142,gender
ヘルパンギーナ,2000,52,2000-W52,4,3,7,142,gender
流行性耳下腺炎,2000,52,2000-W52,89,91,180,142,gender
川崎病,2000,52,2000-W52,0,0,0,142,gender
インフルエンザ,2022,33,2022-W33,5,3,8,399,gender
RSウイルス感染症,2022,33,2022-W33,168,145,313,248,gender
咽頭結膜熱,2022,33,2022-W33,4,4,8,248,gender
Ａ群溶血性レンサ球菌咽頭炎,2022,33,2022-W33,9,11,20,248,gender
感染性胃腸炎,2022,33,2022-W33,196,181,377,248,gender
水痘,2022,33,2022-W33,10,1,11,248,gender
手足口病,2022,33,2022-W33,512,453,965,248,gender
突発性発しん,2022,33,2022-W33,19,20,39,248,gender
ヘルパンギーナ,2022,33,2022-W33,104,97,201,248,gender
流行性耳下腺炎,2022,33,2022-W33,3,2,5,248,gender
川崎病,2022,33,2022-W33,1,1,2,248,gender
インフルエンザ,2010,15,2010-W15,7,6,13,289,gender
RSウイルス感染症,2010,15,2010-W15,7,6,13,149,gender
咽頭結膜熱,2010,15,2010-W15,15,13,28,149,gender
Ａ群溶血性レンサ球菌咽頭炎,2010,15,2010-W15,136,74,210,149,gender
感染性胃腸炎,2010,15,2010-W15,687,558,1245,149,gender
水痘,2010,15,2010-W15,109,99,208,149,gender
手足口病,2010,15,2010-W15,25,13,38,149,gender
突発性発しん,2010,15,2010-W15,45,44,89,149,gender
ヘルパンギーナ,2010,15,2010-W15,11,5,16,149,gender
流行性耳下腺炎,2010,15,2010-W15,59,39,98,149,gender
川崎病,2010,15,2010-W15,0,2,2,149,gender
インフルエンザ,2020,40,2020-W40,0,0,0,411,gender
RSウイルス感染症,2020,40,2020-W40,0,0,0,258,gender
咽頭結膜熱,2020,40,2020-W40,12,15,27,258,gender
Ａ群溶血性レンサ球菌咽頭炎,2020,40,2020-W40,67,42,109,258,gender
感染性胃腸炎,2020,40,2020-W40,272,235,507,258,gender
水痘,2020,40,2020-W40,19,22,41,258,gender
手足口病,2020,40,2020-W40,8,12,20,258,gender
突発性発しん,2020,40,2020-W40,66,70,136,258,gender
ヘルパンギーナ,2020,40,2020-W40,9,15,24,258,gender
流行性耳下腺炎,2020,40,2020-W40,7,4,11,258,gender
川崎病,2020,40,2020-W40,2,1,3,258,gender
インフルエンザ,2015,40,2015-W40,14,14,28,412,gender
RSウイルス感染症,2015,40,2015-W40,167,136,303,260,gender
咽頭結膜熱,2015,40,2015-W40,48,34,82,260,gender
Ａ群溶血性レンサ球菌咽頭炎,2015,40,2015-W40,253,182,435,260,gender
感染性胃腸炎,2015,40,2015-W40,466,443,909,260,gender
水痘,2015,40,2015-W40,50,38,88,260,gender
手足口病,2015,40,2015-W40,335,283,618,260,gender
突発性発しん,2015,40,2015-W40,83,70,153,260,gender
ヘルパンギーナ,2015,40,2015-W40,55,47,102,260,gender
流行性耳下腺炎,2015,40,2015-W40,82,63,145,260,gender
川崎病,2015,40,2015-W40,4,2,6,260,gender
インフルエンザ,2018,10,2018-W10,1563,1709,3272,414,gender
RSウイルス感染症,2018,10,2018-W10,28,29,57,261,gender
咽頭結膜熱,2018,10,2018-W10,30,9,39,261,gender
Ａ群溶血性レンサ球菌咽頭炎,2018,10,2018-W10,358,270,628,261,gender
感染性胃腸炎,2018,10,2018-W10,636,599,1235,261,gender
水痘,2018,10,2018-W10,44,40,84,261,gender
手足口病,2018,10,2018-W10,7,5,12,261,gender
突発性発しん,2018,10,2018-W10,67,35,102,261,gender
ヘルパンギーナ,2018,10,2018-W10,0,0,0,261,gender
流行性耳下腺炎,2018,10,2018-W10,7,13,20,261,gender
川崎病,2018,10,2018-W10,4,2,6,261,gender
インフルエンザ,2023,9,2023-W09,1842,1607,3449,413,gender
RSウイルス感染症,2023,9,2023-W09,6,9,15,259,gender
咽頭結膜熱,2023,9,2023-W09,19,11,30,259,gender
Ａ群溶血性レンサ球菌咽頭炎,2023,9,2023-W09,50,43,93,259,gender
感染性胃腸炎,2023,9,2023-W09,755,636,1391,259,gender
水痘,2023,9,2023-W09,5,7,12,259,gender
手足口病,2023,9,2023-W09,3,0,3,259,gender
突発性発しん,2023,9,2023-W09,30,18,48,259,gender
ヘルパンギーナ,2023,9,2023-W09,0,1,1,259,gender
流行性耳下腺炎,2023,9,2023-W09,1,10,11,259,gender
川崎病,2023,9,2023-W09,2,0,2,259,gender
インフルエンザ,2009,39,2009-W39,987,921,1908,284,gender
RSウイルス感染症,2009,39,2009-W39,3,4,7,147,gender
咽頭結膜熱,2009,39,2009-W39,4,2,6,147,gender
Ａ群溶血性レンサ球菌咽頭炎,2009,39,2009-W39,31,20,51,147,gender
感染性胃腸炎,2009,39,2009-W39,125,107,232,147,gender
水痘,2009,39,2009-W39,24,21,45,147,gender
手足口病,2009,39,2009-W39,40,35,75,147,gender
突発性発しん,2009,39,2009-W39,33,29,62,147,gender
ヘルパンギーナ,2009,39,2009-W39,25,36,61,147,gender
流行性耳下腺炎,2009,39,2009-W39,51,42,93,147,gender
川崎病,2009,39,2009-W39,2,0,2,147,gender
インフルエンザ,2025,15,2025-W15,281,238,519,418,gender
新型コロナウイルス感染症（COVID-19）,2025,15,2025-W15,240,262,502,418,gender
RSウイルス感染症,2025,15,2025-W15,68,68,136,264,gender
咽頭結膜熱,2025,15,2025-W15,26,18,44,264,gender
Ａ群溶血性レンサ球菌咽頭炎,2025,15,2025-W15,365,307,672,264,gender
感染性胃腸炎,2025,15,2025-W15,1044,1013,2057,264,gender
水痘,2025,15,2025-W15,68,46,114,264,gender
手足口病,2025,15,2025-W15,9,10,19,264,gender
突発性発しん,2025,15,2025-W15,48,40,88,264,gender
ヘルパンギーナ,2025,15,2025-W15,2,3,5,264,gender
流行性耳下腺炎,2025,15,2025-W15,15,10,25,264,gender
川崎病,2025,15,2025-W15,4,2,6,264,gender
インフルエンザ,2017,33,2017-W33,13,16,29,379,gender
RSウイルス感染症,2017,33,2017-W33,248,212,460,227,gender
咽頭結膜熱,2017,33,2017-W33,76,54,130,227,gender
Ａ群溶血性レンサ球菌咽頭炎,2017,33,2017-W33,114,89,203,227,gender
感染性胃腸炎,2017,33,2017-W33,359,285,644,227,gender
水痘,2017,33,2017-W33,27,23,50,227,gender
手足口病,2017,33,2017-W33,981,848,1829,227,gender
突発性発しん,2017,33,2017-W33,54,39,93,227,gender
ヘルパンギーナ,2017,33,2017-W33,139,157,296,227,gender
流行性耳下腺炎,2017,33,2017-W33,14,18,32,227,gender
川崎病,2017,33,2017-W33,1,1,2,227,gender
インフルエンザ,2005,6,2005-W06,3428,3377,6805,178,gender
RSウイルス感染症,2005,6,2005-W06,1,0,1,142,gender
咽頭結膜熱,2005,6,2005-W06,7,2,9,142,gender
Ａ群溶血性レンサ球菌咽頭炎,2005,6,2005-W06,51,60,111,142,gender
感染性胃腸炎,2005,6,2005-W06,452,435,887,142,gender
水痘,2005,6,2005-W06,112,98,210,142,gender
手足口病,2005,6,2005-W06,8,7,15,142,gender
突発性発しん,2005,6,2005-W06,30,37,67,142,gender
ヘルパンギーナ,2005,6,2005-W06,0,2,2,142,gender
流行性耳下腺炎,2005,6,2005-W06,52,33,85,142,gender
川崎病,2005,6,2005-W06,0,0,0,142,gender
インフルエンザ,2012,29,2012-W29,5,4,9,416,gender
RSウイルス感染症,2012,29,2012-W29,24,25,49,262,gender
咽頭結膜熱,2012,29,2012-W29,90,70,160,262,gender
Ａ群溶血性レンサ球菌咽頭炎,2012,29,2012-W29,184,185,369,262,gender
感染性胃腸炎,2012,29,2012-W29,569,462,1031,262,gender
水痘,2012,29,2012-W29,80,67,147,262,gender
手足口病,2012,29,2012-W29,178,169,347,262,gender
突発性発しん,2012,29,2012-W29,100,92,192,262,gender
ヘルパンギーナ,2012,29,2012-W29,1156,1019,2175,262,gender
流行性耳下腺炎,2012,29,2012-W29,44,38,82,262,gender
川崎病,2012,29,2012-W29,1,1,2,262,gender
インフルエンザ,2023,12,2023-W12,1088,1056,2144,413,gender
RSウイルス感染症,2023,12,2023-W12,20,17,37,259,gender
咽頭結膜熱,2023,12,2023-W12,15,14,29,259,gender
Ａ群溶血性レンサ球菌咽頭炎,2023,12,2023-W12,62,31,93,259,gender
感染性胃腸炎,2023,12,2023-W12,556,493,1049,259,gender
水痘,2023,12,2023-W12,10,10,20,259,gender
手足口病,2023,12,2023-W12,3,3,6,259,gender
突発性発しん,2023,12,2023-W12,29,30,59,259,gender
ヘルパンギーナ,2023,12,2023-W12,2,0,2,259,gender
流行性耳下腺炎,2023,12,2023-W12,7,0,7,259,gender
川崎病,2023,12,2023-W12,1,0,1,259,gender
インフルエンザ,2013,47,2013-W47,61,63,124,410,gender
RSウイルス感染症,2013,47,2013-W47,118,95,213,260,gender
咽頭結膜熱,2013,47,2013-W47,78,52,130,260,gender
Ａ群溶血性レンサ球菌咽頭炎,2013,47,2013-W47,258,176,434,260,gender
感染性胃腸炎,2013,47,2013-W47,1196,1101,2297,260,gender
水痘,2013,47,2013-W47,131,121,252,260,gender
手足口病,2013,47,2013-W47,38,26,64,260,gender
突発性発しん,2013,47,2013-W47,73,71,144,260,gender
ヘルパンギーナ,2013,47,2013-W47,6,3,9,260,gender
流行性耳下腺炎,2013,47,2013-W47,25,15,40,260,gender
川崎病,2013,47,2013-W47,0,4,4,260,gender
インフルエンザ,2011,34,2011-W34,1,1,2,408,gender
RSウイルス感染症,2011,34,2011-W34,23,28,51,259,gender
咽頭結膜熱,2011,34,2011-W34,35,24,59,259,gender
Ａ群溶血性レンサ球菌咽頭炎,2011,34,2011-W34,75,71,146,259,gender
感染性胃腸炎,2011,34,2011-W34,379,300,679,259,gender
水痘,2011,34,2011-W34,49,47,96,259,gender
手足口病,2011,34,2011-W34,612,488,1100,259,gender
突発性発しん,2011,34,2011-W34,80,86,166,259,gender
ヘルパンギーナ,2011,34,2011-W34,342,280,622,259,gender
流行性耳下腺炎,2011,34,2011-W34,40,33,73,259,gender
川崎病,2011,34,2011-W34,0,2,2,259,gender
インフルエンザ,2022,42,2022-W42,1,1,2,413,gender
RSウイルス感染症,2022,42,2022-W42,121,117,238,259,gender
咽頭結膜熱,2022,42,2022-W42,12,9,21,259,gender
Ａ群溶血性レンサ球菌咽頭炎,2022,42,2022-W42,25,12,37,259,gender
感染性胃腸炎,2022,42,2022-W42,440,366,806,259,gender
水痘,2022,42,2022-W42,7,15,22,259,gender
手足口病,2022,42,2022-W42,200,156,356,259,gender
突発性発しん,2022,42,2022-W42,42,44,86,259,gender
ヘルパンギーナ,2022,42,2022-W42,57,41,98,259,gender
流行性耳下腺炎,2022,42,2022-W42,6,4,10,259,gender
川崎病,2022,42,2022-W42,2,1,3,259,gender
インフルエンザ,2012,17,2012-W17,414,395,809,406,gender
RSウイルス感染症,2012,17,2012-W17,18,17,35,259,gender
咽頭結膜熱,2012,17,2012-W17,44,34,78,259,gender
Ａ群溶血性レンサ球菌咽頭炎,2012,17,2012-W17,338,275,613,259,gender
感染性胃腸炎,2012,17,2012-W17,1718,1561,3279,259,gender
水痘,2012,17,2012-W17,130,105,235,259,gender
手足口病,2012,17,2012-W17,11,11,22,259,gender
突発性発しん,2012,17,2012-W17,98,71,169,259,gender
ヘルパンギーナ,2012,17,2012-W17,2,2,4,259,gender
流行性耳下腺炎,2012,17,2012-W17,26,24,50,259,gender
川崎病,2012,17,2012-W17,0,3,3,259,gender
インフルエンザ,2020,31,2020-W31,0,0,0,412,gender
RSウイルス感染症,2020,31,2020-W31,0,1,1,258,gender
咽頭結膜熱,2020,31,2020-W31,3,8,11,258,gender
Ａ群溶血性レンサ球菌咽頭炎,2020,31,2020-W31,67,44,111,258,gender
感染性胃腸炎,2020,31,2020-W31,362,308,670,258,gender
水痘,2020,31,2020-W31,12,15,27,258,gender
手足口病,2020,31,2020-W31,19,16,35,258,gender
突発性発しん,2020,31,2020-W31,85,54,139,258,gender
ヘルパンギーナ,2020,31,2020-W31,9,11,20,258,gender
流行性耳下腺炎,2020,31,2020-W31,2,5,7,258,gender
川崎病,2020,31,2020-W31,2,2,4,258,gender
インフルエンザ,2002,50,2002-W50,59,60,119,178,gender
RSウイルス感染症,2002,50,2002-W50,0,0,0,142,gender
咽頭結膜熱,2002,50,2002-W50,5,1,6,142,gender
Ａ群溶血性レンサ球菌咽頭炎,2002,50,2002-W50,43,28,71,142,gender
感染性胃腸炎,2002,50,2002-W50,697,721,1418,142,gender
水痘,2002,50,2002-W50,101,98,199,142,gender
手足口病,2002,50,2002-W50,5,7,12,142,gender
突発性発しん,2002,50,2002-W50,27,20,47,142,gender
ヘルパンギーナ,2002,50,2002-W50,6,3,9,142,gender
流行性耳下腺炎,2002,50,2002-W50,23,19,42,142,gender
川崎病,2002,50,2002-W50,2,0,2,142,gender
インフルエンザ,2012,1,2012-W01,185,202,387,410,gender
RSウイルス感染症,2012,1,2012-W01,44,41,85,257,gender
咽頭結膜熱,2012,1,2012-W01,37,42,79,257,gender
Ａ群溶血性レンサ球菌咽頭炎,2012,1,2012-W01,107,120,227,257,gender
感染性胃腸炎,2012,1,2012-W01,998,923,1921,257,gender
水痘,2012,1,2012-W01,310,280,590,257,gender
手足口病,2012,1,2012-W01,16,9,25,257,gender
突発性発しん,2012,1,2012-W01,34,44,78,257,gender
ヘルパンギーナ,2012,1,2012-W01,1,3,4,257,gender
流行性耳下腺炎,2012,1,2012-W01,46,30,76,257,gender
川崎病,2012,1,2012-W01,1,0,1,257,gender
インフルエンザ,2000,23,2000-W23,5,3,8,178,gender
RSウイルス感染症,2000,23,2000-W23,0,0,0,142,gender
咽頭結膜熱,2000,23,2000-W23,3,9,12,142,gender
Ａ群溶血性レンサ球菌咽頭炎,2000,23,2000-W23,49,49,98,142,gender
感染性胃腸炎,2000,23,2000-W23,219,177,396,142,gender
水痘,2000,23,2000-W23,102,87,189,142,gender
手足口病,2000,23,2000-W23,52,34,86,142,gender
突発性発しん,2000,23,2000-W23,40,42,82,142,gender
ヘルパンギーナ,2000,23,2000-W23,69,84,153,142,gender
流行性耳下腺炎,2000,23,2000-W23,43,36,79,142,gender
川崎病,2000,23,2000-W23,0,1,1,142,gender
インフルエンザ,2006,24,2006-W24,2,3,5,178,gender
RSウイルス感染症,2006,24,2006-W24,0,0,0,142,gender
咽頭結膜熱,2006,24,2006-W24,94,74,168,142,gender
Ａ群溶血性レンサ球菌咽頭炎,2006,24,2006-W24,160,132,292,142,gender
感染性胃腸炎,2006,24,2006-W24,285,249,534,142,gender
水痘,2006,24,2006-W24,116,107,223,142,gender
手足口病,2006,24,2006-W24,31,22,53,142,gender
突発性発しん,2006,24,2006-W24,42,40,82,142,gender
ヘルパンギーナ,2006,24,2006-W24,354,329,683,142,gender
流行性耳下腺炎,2006,24,2006-W24,49,49,98,142,gender
川崎病,2006,24,2006-W24,1,0,1,142,gender
インフルエンザ,2014,10,2014-W10,4742,4677,9419,414,gender
RSウイルス感染症,2014,10,2014-W10,20,14,34,260,gender
咽頭結膜熱,2014,10,2014-W10,26,18,44,260,gender
Ａ群溶血性レンサ球菌咽頭炎,2014,10,2014-W10,313,271,584,260,gender
感染性胃腸炎,2014,10,2014-W10,653,619,1272,260,gender
水痘,2014,10,2014-W10,119,96,215,260,gender
手足口病,2014,10,2014-W10,6,5,11,260,gender
突発性発しん,2014,10,2014-W10,60,63,123,260,gender
ヘルパンギーナ,2014,10,2014-W10,2,0,2,260,gender
流行性耳下腺炎,2014,10,2014-W10,18,11,29,260,gender
川崎病,2014,10,2014-W10,3,1,4,260,gender
インフルエンザ,2019,40,2019-W40,224,211,435,413,gender
RSウイルス感染症,2019,40,2019-W40,151,140,291,261,gender
咽頭結膜熱,2019,40,2019-W40,34,38,72,261,gender
Ａ群溶血性レンサ球菌咽頭炎,2019,40,2019-W40,249,216,465,261,gender
感染性胃腸炎,2019,40,2019-W40,508,400,908,261,gender
水痘,2019,40,2019-W40,51,41,92,261,gender
手足口病,2019,40,2019-W40,373,322,695,261,gender
突発性発しん,2019,40,2019-W40,50,60,110,261,gender
ヘルパンギーナ,2019,40,2019-W40,113,113,226,261,gender
流行性耳下腺炎,2019,40,2019-W40,14,12,26,261,gender
川崎病,2019,40,2019-W40,1,1,2,261,gender
インフルエンザ,2005,39,2005-W39,0,0,0,178,gender
RSウイルス感染症,2005,39,2005-W39,4,3,7,142,gender
咽頭結膜熱,2005,39,2005-W39,17,11,28,142,gender
Ａ群溶血性レンサ球菌咽頭炎,2005,39,2005-W39,34,42,76,142,gender
感染性胃腸炎,2005,39,2005-W39,207,163,370,142,gender
水痘,2005,39,2005-W39,30,18,48,142,gender
手足口病,2005,39,2005-W39,19,9,28,142,gender
突発性発しん,2005,39,2005-W39,49,45,94,142,gender
ヘルパンギーナ,2005,39,2005-W39,39,21,60,142,gender
流行性耳下腺炎,2005,39,2005-W39,117,74,191,142,gender
川崎病,2005,39,2005-W39,1,2,3,142,gender
インフルエンザ,2024,45,2024-W45,238,230,468,418,gender
新型コロナウイルス感染症（COVID-19）,2024,45,2024-W45,195,237,432,418,gender
RSウイルス感染症,2024,45,2024-W45,25,27,52,264,gender
咽頭結膜熱,2024,45,2024-W45,20,11,31,264,gender
Ａ群溶血性レンサ球菌咽頭炎,2024,45,2024-W45,208,163,371,264,gender
感染性胃腸炎,2024,45,2024-W45,354,296,650,264,gender
水痘,2024,45,2024-W45,26,28,54,264,gender
手足口病,2024,45,2024-W45,909,717,1626,264,gender
突発性発しん,2024,45,2024-W45,31,31,62,264,gender
ヘルパンギーナ,2024,45,2024-W45,12,12,24,264,gender
流行性耳下腺炎,2024,45,2024-W45,5,3,8,264,gender
川崎病,2024,45,2024-W45,1,1,2,264,gender
インフルエンザ,2025,19,2025-W19,106,79,185,419,gender
新型コロナウイルス感染症（COVID-19）,2025,19,2025-W19,96,104,200,419,gender
RSウイルス感染症,2025,19,2025-W19,14,13,27,264,gender
咽頭結膜熱,2025,19,2025-W19,44,26,70,264,gender
Ａ群溶血性レンサ球菌咽頭炎,2025,19,2025-W19,422,322,744,264,gender
感染性胃腸炎,2025,19,2025-W19,823,692,1515,264,gender
水痘,2025,19,2025-W19,111,88,199,264,gender
手足口病,2025,19,2025-W19,11,18,29,264,gender
突発性発しん,2025,19,2025-W19,44,32,76,264,gender
ヘルパンギーナ,2025,19,2025-W19,2,5,7,264,gender
流行性耳下腺炎,2025,19,2025-W19,9,7,16,264,gender
川崎病,2025,19,2025-W19,5,3,8,264,gender
インフルエンザ,2009,35,2009-W35,465,391,856,284,gender
RSウイルス感染症,2009,35,2009-W35,10,9,19,147,gender
咽頭結膜熱,2009,35,2009-W35,10,6,16,147,gender
Ａ群溶血性レンサ球菌咽頭炎,2009,35,2009-W35,31,27,58,147,gender
感染性胃腸炎,2009,35,2009-W35,199,163,362,147,gender
水痘,2009,35,2009-W35,26,21,47,147,gender
手足口病,2009,35,2009-W35,103,76,179,147,gender
突発性発しん,2009,35,2009-W35,63,44,107,147,gender
ヘルパンギーナ,2009,35,2009-W35,98,80,178,147,gender
流行性耳下腺炎,2009,35,2009-W35,52,57,109,147,gender
川崎病,2009,35,2009-W35,0,2,2,147,gender
インフルエンザ,2023,5,2023-W05,2093,1940,4033,413,gender
RSウイルス感染症,2023,5,2023-W05,27,19,46,260,gender
咽頭結膜熱,2023,5,2023-W05,14,8,22,260,gender
Ａ群溶血性レンサ球菌咽頭炎,2023,5,2023-W05,36,26,62,260,gender
感染性胃腸炎,2023,5,2023-W05,1181,1088,2269,260,gender
水痘,2023,5,2023-W05,12,10,22,260,gender
手足口病,2023,5,2023-W05,5,7,12,260,gender
突発性発しん,2023,5,2023-W05,29,33,62,260,gender
ヘルパンギーナ,2023,5,2023-W05,1,2,3,260,gender
流行性耳下腺炎,2023,5,2023-W05,6,5,11,260,gender
川崎病,2023,5,2023-W05,2,1,3,260,gender
インフルエンザ,2006,16,2006-W16,58,37,95,178,gender
RSウイルス感染症,2006,16,2006-W16,2,2,4,142,gender
咽頭結膜熱,2006,16,2006-W16,40,40,80,142,gender
Ａ群溶血性レンサ球菌咽頭炎,2006,16,2006-W16,151,157,308,142,gender
感染性胃腸炎,2006,16,2006-W16,509,420,929,142,gender
水痘,2006,16,2006-W16,97,81,178,142,gender
手足口病,2006,16,2006-W16,2,2,4,142,gender
突発性発しん,2006,16,2006-W16,51,36,87,142,gender
ヘルパンギーナ,2006,16,2006-W16,13,5,18,142,gender
流行性耳下腺炎,2006,16,2006-W16,41,48,89,142,gender
川崎病,2006,16,2006-W16,0,0,0,142,gender
インフルエンザ,2014,22,2014-W22,14,23,37,414,gender
RSウイルス感染症,2014,22,2014-W22,13,8,21,263,gender
咽頭結膜熱,2014,22,2014-W22,100,88,188,263,gender
Ａ群溶血性レンサ球菌咽頭炎,2014,22,2014-W22,536,425,961,263,gender
感染性胃腸炎,2014,22,2014-W22,989,812,1801,263,gender
水痘,2014,22,2014-W22,142,165,307,263,gender
手足口病,2014,22,2014-W22,33,26,59,263,gender
突発性発しん,2014,22,2014-W22,109,112,221,263,gender
ヘルパンギーナ,2014,22,2014-W22,30,24,54,263,gender
流行性耳下腺炎,2014,22,2014-W22,28,33,61,263,gender
川崎病,2014,22,2014-W22,4,4,8,263,gender
インフルエンザ,2016,51,2016-W51,2164,2197,4361,413,gender
RSウイルス感染症,2016,51,2016-W51,33,24,57,260,gender
咽頭結膜熱,2016,51,2016-W51,65,46,111,260,gender
Ａ群溶血性レンサ球菌咽頭炎,2016,51,2016-W51,280,307,587,260,gender
感染性胃腸炎,2016,51,2016-W51,2804,2564,5368,260,gender
水痘,2016,51,2016-W51,77,67,144,260,gender
手足口病,2016,51,2016-W51,40,33,73,260,gender
突発性発しん,2016,51,2016-W51,58,50,108,260,gender
ヘルパンギーナ,2016,51,2016-W51,5,7,12,260,gender
流行性耳下腺炎,2016,51,2016-W51,63,53,116,260,gender
川崎病,2016,51,2016-W51,1,1,2,260,gender
インフルエンザ,2012,25,2012-W25,3,2,5,416,gender
RSウイルス感染症,2012,25,2012-W25,8,9,17,261,gender
咽頭結膜熱,2012,25,2012-W25,90,76,166,261,gender
Ａ群溶血性レンサ球菌咽頭炎,2012,25,2012-W25,422,321,743,261,gender
感染性胃腸炎,2012,25,2012-W25,1105,997,2102,261,gender
水痘,2012,25,2012-W25,182,155,337,261,gender
手足口病,2012,25,2012-W25,143,106,249,261,gender
突発性発しん,2012,25,2012-W25,96,110,206,261,gender
ヘルパンギーナ,2012,25,2012-W25,200,179,379,261,gender
流行性耳下腺炎,2012,25,2012-W25,44,36,80,261,gender
川崎病,2012,25,2012-W25,6,2,8,261,gender
インフルエンザ,2011,38,2011-W38,7,1,8,415,gender
RSウイルス感染症,2011,38,2011-W38,44,60,104,261,gender
咽頭結膜熱,2011,38,2011-W38,12,13,25,261,gender
Ａ群溶血性レンサ球菌咽頭炎,2011,38,2011-W38,72,73,145,261,gender
感染性胃腸炎,2011,38,2011-W38,358,257,615,261,gender
水痘,2011,38,2011-W38,58,37,95,261,gender
手足口病,2011,38,2011-W38,504,380,884,261,gender
突発性発しん,2011,38,2011-W38,82,60,142,261,gender
ヘルパンギーナ,2011,38,2011-W38,158,150,308,261,gender
流行性耳下腺炎,2011,38,2011-W38,35,37,72,261,gender
川崎病,2011,38,2011-W38,2,0,2,261,gender
インフルエンザ,2003,32,2003-W32,0,0,0,178,gender
RSウイルス感染症,2003,32,2003-W32,0,0,0,142,gender
咽頭結膜熱,2003,32,2003-W32,45,23,68,142,gender
Ａ群溶血性レンサ球菌咽頭炎,2003,32,2003-W32,15,12,27,142,gender
感染性胃腸炎,2003,32,2003-W32,101,104,205,142,gender
水痘,2003,32,2003-W32,46,23,69,142,gender
手足口病,2003,32,2003-W32,225,198,423,142,gender
突発性発しん,2003,32,2003-W32,39,23,62,142,gender
ヘルパンギーナ,2003,32,2003-W32,196,180,376,142,gender
流行性耳下腺炎,2003,32,2003-W32,8,6,14,142,gender
川崎病,2003,32,2003-W32,3,0,3,142,gender
インフルエンザ,2001,41,2001-W41,0,0,0,178,gender
RSウイルス感染症,2001,41,2001-W41,0,0,0,142,gender
咽頭結膜熱,2001,41,2001-W41,1,2,3,142,gender
Ａ群溶血性レンサ球菌咽頭炎,2001,41,2001-W41,13,13,26,142,gender
感染性胃腸炎,2001,41,2001-W41,150,135,285,142,gender
水痘,2001,41,2001-W41,25,28,53,142,gender
手足口病,2001,41,2001-W41,19,13,32,142,gender
突発性発しん,2001,41,2001-W41,38,33,71,142,gender
ヘルパンギーナ,2001,41,2001-W41,5,4,9,142,gender
流行性耳下腺炎,2001,41,2001-W41,47,41,88,142,gender
川崎病,2001,41,2001-W41,0,0,0,142,gender
インフルエンザ,2023,20,2023-W20,438,400,838,416,gender
新型コロナウイルス感染症（COVID-19）,2023,20,2023-W20,679,793,1472,416,gender
RSウイルス感染症,2023,20,2023-W20,94,77,171,262,gender
咽頭結膜熱,2023,20,2023-W20,77,48,125,262,gender
Ａ群溶血性レンサ球菌咽頭炎,2023,20,2023-W20,242,178,420,262,gender
感染性胃腸炎,2023,20,2023-W20,1042,895,1937,262,gender
水痘,2023,20,2023-W20,15,18,33,262,gender
手足口病,2023,20,2023-W20,39,41,80,262,gender
突発性発しん,2023,20,2023-W20,51,45,96,262,gender
ヘルパンギーナ,2023,20,2023-W20,67,92,159,262,gender
流行性耳下腺炎,2023,20,2023-W20,5,4,9,262,gender
川崎病,2023,20,2023-W20,0,2,2,262,gender
インフルエンザ,2017,1,2017-W01,1825,1945,3770,409,gender
RSウイルス感染症,2017,1,2017-W01,11,8,19,258,gender
咽頭結膜熱,2017,1,2017-W01,29,28,57,258,gender
Ａ群溶血性レンサ球菌咽頭炎,2017,1,2017-W01,119,112,231,258,gender
感染性胃腸炎,2017,1,2017-W01,551,532,1083,258,gender
水痘,2017,1,2017-W01,63,54,117,258,gender
手足口病,2017,1,2017-W01,9,14,23,258,gender
突発性発しん,2017,1,2017-W01,30,15,45,258,gender
ヘルパンギーナ,2017,1,2017-W01,0,2,2,258,gender
流行性耳下腺炎,2017,1,2017-W01,41,32,73,258,gender
川崎病,2017,1,2017-W01,0,3,3,258,gender
インフルエンザ,2018,22,2018-W22,34,29,63,416,gender
RSウイルス感染症,2018,22,2018-W22,19,27,46,262,gender
咽頭結膜熱,2018,22,2018-W22,94,99,193,262,gender
Ａ群溶血性レンサ球菌咽頭炎,2018,22,2018-W22,485,444,929,262,gender
感染性胃腸炎,2018,22,2018-W22,1000,925,1925,262,gender
水痘,2018,22,2018-W22,39,27,66,262,gender
手足口病,2018,22,2018-W22,31,34,65,262,gender
突発性発しん,2018,22,2018-W22,99,98,197,262,gender
ヘルパンギーナ,2018,22,2018-W22,12,20,32,262,gender
流行性耳下腺炎,2018,22,2018-W22,16,14,30,262,gender
川崎病,2018,22,2018-W22,0,2,2,262,gender
インフルエンザ,2006,28,2006-W28,0,0,0,178,gender
RSウイルス感染症,2006,28,2006-W28,0,0,0,142,gender
咽頭結膜熱,2006,28,2006-W28,101,87,188,142,gender
Ａ群溶血性レンサ球菌咽頭炎,2006,28,2006-W28,81,73,154,142,gender
感染性胃腸炎,2006,28,2006-W28,232,182,414,142,gender
水痘,2006,28,2006-W28,78,50,128,142,gender
手足口病,2006,28,2006-W28,58,46,104,142,gender
突発性発しん,2006,28,2006-W28,68,51,119,142,gender
ヘルパンギーナ,2006,28,2006-W28,228,230,458,142,gender
流行性耳下腺炎,2006,28,2006-W28,74,49,123,142,gender
川崎病,2006,28,2006-W28,0,1,1,142,gender
インフルエンザ,2024,49,2024-W49,1742,1683,3425,418,gender
新型コロナウイルス感染症（COVID-19）,2024,49,2024-W49,351,368,719,418,gender
RSウイルス感染症,2024,49,2024-W49,40,26,66,264,gender
咽頭結膜熱,2024,49,2024-W49,44,32,76,264,gender
Ａ群溶血性レンサ球菌咽頭炎,2024,49,2024-W49,409,350,759,264,gender
感染性胃腸炎,2024,49,2024-W49,751,621,1372,264,gender
水痘,2024,49,2024-W49,52,42,94,264,gender
手足口病,2024,49,2024-W49,243,211,454,264,gender
突発性発しん,2024,49,2024-W49,31,36,67,264,gender
ヘルパンギーナ,2024,49,2024-W49,4,1,5,264,gender
流行性耳下腺炎,2024,49,2024-W49,8,4,12,264,gender
川崎病,2024,49,2024-W49,4,0,4,264,gender
インフルエンザ,2005,35,2005-W35,0,0,0,178,gender
RSウイルス感染症,2005,35,2005-W35,2,1,3,142,gender
咽頭結膜熱,2005,35,2005-W35,32,28,60,142,gender
Ａ群溶血性レンサ球菌咽頭炎,2005,35,2005-W35,30,27,57,142,gender
感染性胃腸炎,2005,35,2005-W35,181,156,337,142,gender
水痘,2005,35,2005-W35,21,24,45,142,gender
手足口病,2005,35,2005-W35,38,31,69,142,gender
突発性発しん,2005,35,2005-W35,52,57,109,142,gender
ヘルパンギーナ,2005,35,2005-W35,62,48,110,142,gender
流行性耳下腺炎,2005,35,2005-W35,67,46,113,142,gender
川崎病,2005,35,2005-W35,2,1,3,142,gender
インフルエンザ,2019,3,2019-W03,10875,10975,21850,415,gender
RSウイルス感染症,2019,3,2019-W03,21,23,44,262,gender
咽頭結膜熱,2019,3,2019-W03,18,21,39,262,gender
Ａ群溶血性レンサ球菌咽頭炎,2019,3,2019-W03,270,222,492,262,gender
感染性胃腸炎,2019,3,2019-W03,999,959,1958,262,gender
水痘,2019,3,2019-W03,40,38,78,262,gender
手足口病,2019,3,2019-W03,13,17,30,262,gender
突発性発しん,2019,3,2019-W03,43,52,95,262,gender
ヘルパンギーナ,2019,3,2019-W03,2,1,3,262,gender
流行性耳下腺炎,2019,3,2019-W03,8,1,9,262,gender
川崎病,2019,3,2019-W03,0,1,1,262,gender
インフルエンザ,2007,46,2007-W46,138,155,293,287,gender
RSウイルス感染症,2007,46,2007-W46,33,20,53,150,gender
咽頭結膜熱,2007,46,2007-W46,13,11,24,150,gender
Ａ群溶血性レンサ球菌咽頭炎,2007,46,2007-W46,120,107,227,150,gender
感染性胃腸炎,2007,46,2007-W46,505,497,1002,150,gender
水痘,2007,46,2007-W46,79,71,150,150,gender
手足口病,2007,46,2007-W46,41,39,80,150,gender
突発性発しん,2007,46,2007-W46,56,50,106,150,gender
ヘルパンギーナ,2007,46,2007-W46,7,12,19,150,gender
流行性耳下腺炎,2007,46,2007-W46,21,17,38,150,gender
川崎病,2007,46,2007-W46,0,0,0,150,gender
インフルエンザ,2002,13,2002-W13,93,103,196,178,gender
RSウイルス感染症,2002,13,2002-W13,0,0,0,142,gender
咽頭結膜熱,2002,13,2002-W13,2,0,2,142,gender
Ａ群溶血性レンサ球菌咽頭炎,2002,13,2002-W13,21,29,50,142,gender
感染性胃腸炎,2002,13,2002-W13,306,315,621,142,gender
水痘,2002,13,2002-W13,77,72,149,142,gender
手足口病,2002,13,2002-W13,3,1,4,142,gender
突発性発しん,2002,13,2002-W13,32,27,59,142,gender
ヘルパンギーナ,2002,13,2002-W13,4,6,10,142,gender
流行性耳下腺炎,2002,13,2002-W13,52,35,87,142,gender
川崎病,2002,13,2002-W13,0,0,0,142,gender
インフルエンザ,2011,49,2011-W49,55,47,102,416,gender
RSウイルス感染症,2011,49,2011-W49,92,80,172,262,gender
咽頭結膜熱,2011,49,2011-W49,43,51,94,262,gender
Ａ群溶血性レンサ球菌咽頭炎,2011,49,2011-W49,346,297,643,262,gender
感染性胃腸炎,2011,49,2011-W49,2015,1796,3811,262,gender
水痘,2011,49,2011-W49,343,275,618,262,gender
手足口病,2011,49,2011-W49,45,45,90,262,gender
突発性発しん,2011,49,2011-W49,87,66,153,262,gender
ヘルパンギーナ,2011,49,2011-W49,4,8,12,262,gender
流行性耳下腺炎,2011,49,2011-W49,43,37,80,262,gender
川崎病,2011,49,2011-W49,4,0,4,262,gender
インフルエンザ,2008,9,2008-W09,534,493,1027,289,gender
RSウイルス感染症,2008,9,2008-W09,2,9,11,150,gender
咽頭結膜熱,2008,9,2008-W09,17,10,27,150,gender
Ａ群溶血性レンサ球菌咽頭炎,2008,9,2008-W09,193,216,409,150,gender
感染性胃腸炎,2008,9,2008-W09,1043,985,2028,150,gender
水痘,2008,9,2008-W09,109,81,190,150,gender
手足口病,2008,9,2008-W09,3,1,4,150,gender
突発性発しん,2008,9,2008-W09,51,41,92,150,gender
ヘルパンギーナ,2008,9,2008-W09,1,1,2,150,gender
流行性耳下腺炎,2008,9,2008-W09,28,9,37,150,gender
川崎病,2008,9,2008-W09,2,0,2,150,gender
インフルエンザ,2010,27,2010-W27,7,11,18,285,gender
RSウイルス感染症,2010,27,2010-W27,4,6,10,148,gender
咽頭結膜熱,2010,27,2010-W27,29,24,53,148,gender
Ａ群溶血性レンサ球菌咽頭炎,2010,27,2010-W27,87,89,176,148,gender
感染性胃腸炎,2010,27,2010-W27,319,268,587,148,gender
水痘,2010,27,2010-W27,93,80,173,148,gender
手足口病,2010,27,2010-W27,316,268,584,148,gender
突発性発しん,2010,27,2010-W27,48,48,96,148,gender
ヘルパンギーナ,2010,27,2010-W27,702,623,1325,148,gender
流行性耳下腺炎,2010,27,2010-W27,98,75,173,148,gender
川崎病,2010,27,2010-W27,3,1,4,148,gender
インフルエンザ,2020,4,2020-W04,2817,2769,5586,417,gender
RSウイルス感染症,2020,4,2020-W04,19,25,44,262,gender
咽頭結膜熱,2020,4,2020-W04,34,24,58,262,gender
Ａ群溶血性レンサ球菌咽頭炎,2020,4,2020-W04,467,403,870,262,gender
感染性胃腸炎,2020,4,2020-W04,1290,1112,2402,262,gender
水痘,2020,4,2020-W04,80,58,138,262,gender
手足口病,2020,4,2020-W04,11,9,20,262,gender
突発性発しん,2020,4,2020-W04,50,41,91,262,gender
ヘルパンギーナ,2020,4,2020-W04,9,10,19,262,gender
流行性耳下腺炎,2020,4,2020-W04,8,6,14,262,gender
川崎病,2020,4,2020-W04,2,2,4,262,gender
インフルエンザ,2025,8,2025-W08,335,323,658,419,gender
新型コロナウイルス感染症（COVID-19）,2025,8,2025-W08,591,723,1314,419,gender
RSウイルス感染症,2025,8,2025-W08,94,87,181,264,gender
咽頭結膜熱,2025,8,2025-W08,16,19,35,264,gender
Ａ群溶血性レンサ球菌咽頭炎,2025,8,2025-W08,357,289,646,264,gender
感染性胃腸炎,2025,8,2025-W08,1830,1700,3530,264,gender
水痘,2025,8,2025-W08,56,37,93,264,gender
手足口病,2025,8,2025-W08,4,5,9,264,gender
突発性発しん,2025,8,2025-W08,21,24,45,264,gender
ヘルパンギーナ,2025,8,2025-W08,1,0,1,264,gender
流行性耳下腺炎,2025,8,2025-W08,2,6,8,264,gender
川崎病,2025,8,2025-W08,5,1,6,264,gender
インフルエンザ,2016,20,2016-W20,58,42,100,414,gender
RSウイルス感染症,2016,20,2016-W20,8,7,15,260,gender
咽頭結膜熱,2016,20,2016-W20,69,65,134,260,gender
Ａ群溶血性レンサ球菌咽頭炎,2016,20,2016-W20,432,355,787,260,gender
感染性胃腸炎,2016,20,2016-W20,874,804,1678,260,gender
水痘,2016,20,2016-W20,41,49,90,260,gender
手足口病,2016,20,2016-W20,11,10,21,260,gender
突発性発しん,2016,20,2016-W20,95,111,206,260,gender
ヘルパンギーナ,2016,20,2016-W20,9,8,17,260,gender
流行性耳下腺炎,2016,20,2016-W20,93,65,158,260,gender
川崎病,2016,20,2016-W20,3,0,3,260,gender
インフルエンザ,2009,44,2009-W44,4154,3919,8073,288,gender
RSウイルス感染症,2009,44,2009-W44,7,7,14,148,gender
咽頭結膜熱,2009,44,2009-W44,3,2,5,148,gender
Ａ群溶血性レンサ球菌咽頭炎,2009,44,2009-W44,79,53,132,148,gender
感染性胃腸炎,2009,44,2009-W44,182,142,324,148,gender
水痘,2009,44,2009-W44,33,41,74,148,gender
手足口病,2009,44,2009-W44,26,24,50,148,gender
突発性発しん,2009,44,2009-W44,37,34,71,148,gender
ヘルパンギーナ,2009,44,2009-W44,12,9,21,148,gender
流行性耳下腺炎,2009,44,2009-W44,44,36,80,148,gender
川崎病,2009,44,2009-W44,1,0,1,148,gender
インフルエンザ,2004,14,2004-W14,15,12,27,178,gender
RSウイルス感染症,2004,14,2004-W14,3,1,4,142,gender
咽頭結膜熱,2004,14,2004-W14,11,8,19,142,gender
Ａ群溶血性レンサ球菌咽頭炎,2004,14,2004-W14,78,81,159,142,gender
感染性胃腸炎,2004,14,2004-W14,436,384,820,142,gender
水痘,2004,14,2004-W14,91,81,172,142,gender
手足口病,2004,14,2004-W14,0,0,0,142,gender
突発性発しん,2004,14,2004-W14,28,31,59,142,gender
ヘルパンギーナ,2004,14,2004-W14,3,1,4,142,gender
流行性耳下腺炎,2004,14,2004-W14,18,15,33,142,gender
川崎病,2004,14,2004-W14,0,0,0,142,gender
インフルエンザ,2003,7,2003-W07,1456,1415,2871,178,gender
RSウイルス感染症,2003,7,2003-W07,0,0,0,142,gender
咽頭結膜熱,2003,7,2003-W07,7,4,11,142,gender
Ａ群溶血性レンサ球菌咽頭炎,2003,7,2003-W07,39,39,78,142,gender
感染性胃腸炎,2003,7,2003-W07,420,420,840,142,gender
水痘,2003,7,2003-W07,61,49,110,142,gender
手足口病,2003,7,2003-W07,2,0,2,142,gender
突発性発しん,2003,7,2003-W07,22,27,49,142,gender
ヘルパンギーナ,2003,7,2003-W07,0,3,3,142,gender
流行性耳下腺炎,2003,7,2003-W07,11,9,20,142,gender
川崎病,2003,7,2003-W07,0,0,0,142,gender
インフルエンザ,2008,14,2008-W14,51,70,121,287,gender
RSウイルス感染症,2008,14,2008-W14,4,2,6,150,gender
咽頭結膜熱,2008,14,2008-W14,12,14,26,150,gender
Ａ群溶血性レンサ球菌咽頭炎,2008,14,2008-W14,98,93,191,150,gender
感染性胃腸炎,2008,14,2008-W14,597,555,1152,150,gender
水痘,2008,14,2008-W14,83,95,178,150,gender
手足口病,2008,14,2008-W14,3,1,4,150,gender
突発性発しん,2008,14,2008-W14,41,51,92,150,gender
ヘルパンギーナ,2008,14,2008-W14,0,1,1,150,gender
流行性耳下腺炎,2008,14,2008-W14,21,21,42,150,gender
川崎病,2008,14,2008-W14,1,1,2,150,gender
インフルエンザ,2024,38,2024-W38,133,113,246,419,gender
新型コロナウイルス感染症（COVID-19）,2024,38,2024-W38,749,900,1649,419,gender
RSウイルス感染症,2024,38,2024-W38,31,23,54,264,gender
咽頭結膜熱,2024,38,2024-W38,20,23,43,264,gender
Ａ群溶血性レンサ球菌咽頭炎,2024,38,2024-W38,209,176,385,264,gender
感染性胃腸炎,2024,38,2024-W38,408,321,729,264,gender
水痘,2024,38,2024-W38,27,19,46,264,gender
手足口病,2024,38,2024-W38,1290,1022,2312,264,gender
突発性発しん,2024,38,2024-W38,46,35,81,264,gender
ヘルパンギーナ,2024,38,2024-W38,80,76,156,264,gender
流行性耳下腺炎,2024,38,2024-W38,14,3,17,264,gender
川崎病,2024,38,2024-W38,2,5,7,264,gender
インフルエンザ,2005,44,2005-W44,1,1,2,178,gender
RSウイルス感染症,2005,44,2005-W44,19,13,32,142,gender
咽頭結膜熱,2005,44,2005-W44,25,20,45,142,gender
Ａ群溶血性レンサ球菌咽頭炎,2005,44,2005-W44,82,66,148,142,gender
感染性胃腸炎,2005,44,2005-W44,252,264,516,142,gender
水痘,2005,44,2005-W44,49,49,98,142,gender
手足口病,2005,44,2005-W44,29,22,51,142,gender
突発性発しん,2005,44,2005-W44,46,47,93,142,gender
ヘルパンギーナ,2005,44,2005-W44,12,19,31,142,gender
流行性耳下腺炎,2005,44,2005-W44,94,72,166,142,gender
川崎病,2005,44,2005-W44,2,0,2,142,gender
インフルエンザ,2007,37,2007-W37,1,0,1,286,gender
RSウイルス感染症,2007,37,2007-W37,3,5,8,149,gender
咽頭結膜熱,2007,37,2007-W37,14,22,36,149,gender
Ａ群溶血性レンサ球菌咽頭炎,2007,37,2007-W37,76,64,140,149,gender
感染性胃腸炎,2007,37,2007-W37,328,268,596,149,gender
水痘,2007,37,2007-W37,28,20,48,149,gender
手足口病,2007,37,2007-W37,112,67,179,149,gender
突発性発しん,2007,37,2007-W37,63,56,119,149,gender
ヘルパンギーナ,2007,37,2007-W37,61,59,120,149,gender
流行性耳下腺炎,2007,37,2007-W37,13,13,26,149,gender
川崎病,2007,37,2007-W37,1,0,1,149,gender
インフルエンザ,2023,51,2023-W51,3855,3631,7486,414,gender
新型コロナウイルス感染症（COVID-19）,2023,51,2023-W51,629,667,1296,414,gender
RSウイルス感染症,2023,51,2023-W51,2,4,6,261,gender
咽頭結膜熱,2023,51,2023-W51,363,348,711,261,gender
Ａ群溶血性レンサ球菌咽頭炎,2023,51,2023-W51,801,709,1510,261,gender
感染性胃腸炎,2023,51,2023-W51,1474,1350,2824,261,gender
水痘,2023,51,2023-W51,29,23,52,261,gender
手足口病,2023,51,2023-W51,51,36,87,261,gender
突発性発しん,2023,51,2023-W51,26,26,52,261,gender
ヘルパンギーナ,2023,51,2023-W51,4,3,7,261,gender
流行性耳下腺炎,2023,51,2023-W51,5,1,6,261,gender
川崎病,2023,51,2023-W51,1,0,1,261,gender
インフルエンザ,2021,22,2021-W22,0,0,0,405,gender
RSウイルス感染症,2021,22,2021-W22,236,236,472,257,gender
咽頭結膜熱,2021,22,2021-W22,30,22,52,257,gender
Ａ群溶血性レンサ球菌咽頭炎,2021,22,2021-W22,53,53,106,257,gender
感染性胃腸炎,2021,22,2021-W22,574,527,1101,257,gender
水痘,2021,22,2021-W22,20,19,39,257,gender
手足口病,2021,22,2021-W22,6,12,18,257,gender
突発性発しん,2021,22,2021-W22,84,56,140,257,gender
ヘルパンギーナ,2021,22,2021-W22,7,5,12,257,gender
流行性耳下腺炎,2021,22,2021-W22,9,6,15,257,gender
川崎病,2021,22,2021-W22,2,1,3,257,gender
インフルエンザ,2003,43,2003-W43,1,0,1,178,gender
RSウイルス感染症,2003,43,2003-W43,0,0,0,142,gender
咽頭結膜熱,2003,43,2003-W43,9,8,17,142,gender
Ａ群溶血性レンサ球菌咽頭炎,2003,43,2003-W43,38,39,77,142,gender
感染性胃腸炎,2003,43,2003-W43,267,241,508,142,gender
水痘,2003,43,2003-W43,50,48,98,142,gender
手足口病,2003,43,2003-W43,17,12,29,142,gender
突発性発しん,2003,43,2003-W43,37,35,72,142,gender
ヘルパンギーナ,2003,43,2003-W43,11,10,21,142,gender
流行性耳下腺炎,2003,43,2003-W43,19,15,34,142,gender
川崎病,2003,43,2003-W43,1,0,1,142,gender
インフルエンザ,2010,19,2010-W19,9,6,15,284,gender
RSウイルス感染症,2010,19,2010-W19,7,1,8,148,gender
咽頭結膜熱,2010,19,2010-W19,20,21,41,148,gender
Ａ群溶血性レンサ球菌咽頭炎,2010,19,2010-W19,140,107,247,148,gender
感染性胃腸炎,2010,19,2010-W19,560,495,1055,148,gender
水痘,2010,19,2010-W19,145,157,302,148,gender
手足口病,2010,19,2010-W19,31,22,53,148,gender
突発性発しん,2010,19,2010-W19,49,48,97,148,gender
ヘルパンギーナ,2010,19,2010-W19,29,18,47,148,gender
流行性耳下腺炎,2010,19,2010-W19,74,89,163,148,gender
川崎病,2010,19,2010-W19,1,2,3,148,gender
インフルエンザ,2001,30,2001-W30,1,0,1,178,gender
RSウイルス感染症,2001,30,2001-W30,0,0,0,142,gender
咽頭結膜熱,2001,30,2001-W30,25,21,46,142,gender
Ａ群溶血性レンサ球菌咽頭炎,2001,30,2001-W30,11,8,19,142,gender
感染性胃腸炎,2001,30,2001-W30,105,97,202,142,gender
水痘,2001,30,2001-W30,40,53,93,142,gender
手足口病,2001,30,2001-W30,82,42,124,142,gender
突発性発しん,2001,30,2001-W30,23,26,49,142,gender
ヘルパンギーナ,2001,30,2001-W30,310,284,594,142,gender
流行性耳下腺炎,2001,30,2001-W30,66,72,138,142,gender
川崎病,2001,30,2001-W30,0,0,0,142,gender
インフルエンザ,2000,51,2000-W51,20,19,39,178,gender
RSウイルス感染症,2000,51,2000-W51,0,0,0,142,gender
咽頭結膜熱,2000,51,2000-W51,5,3,8,142,gender
Ａ群溶血性レンサ球菌咽頭炎,2000,51,2000-W51,19,23,42,142,gender
感染性胃腸炎,2000,51,2000-W51,901,943,1844,142,gender
水痘,2000,51,2000-W51,102,92,194,142,gender
手足口病,2000,51,2000-W51,17,16,33,142,gender
突発性発しん,2000,51,2000-W51,35,34,69,142,gender
ヘルパンギーナ,2000,51,2000-W51,4,9,13,142,gender
流行性耳下腺炎,2000,51,2000-W51,80,68,148,142,gender
川崎病,2000,51,2000-W51,0,0,0,142,gender
インフルエンザ,2002,22,2002-W22,0,0,0,178,gender
RSウイルス感染症,2002,22,2002-W22,0,0,0,142,gender
咽頭結膜熱,2002,22,2002-W22,1,4,5,142,gender
Ａ群溶血性レンサ球菌咽頭炎,2002,22,2002-W22,66,56,122,142,gender
感染性胃腸炎,2002,22,2002-W22,276,237,513,142,gender
水痘,2002,22,2002-W22,147,135,282,142,gender
手足口病,2002,22,2002-W22,63,54,117,142,gender
突発性発しん,2002,22,2002-W22,55,35,90,142,gender
ヘルパンギーナ,2002,22,2002-W22,78,80,158,142,gender
流行性耳下腺炎,2002,22,2002-W22,51,55,106,142,gender
川崎病,2002,22,2002-W22,0,0,0,142,gender
インフルエンザ,2020,43,2020-W43,1,1,2,406,gender
RSウイルス感染症,2020,43,2020-W43,1,1,2,256,gender
咽頭結膜熱,2020,43,2020-W43,15,8,23,256,gender
Ａ群溶血性レンサ球菌咽頭炎,2020,43,2020-W43,77,61,138,256,gender
感染性胃腸炎,2020,43,2020-W43,304,247,551,256,gender
水痘,2020,43,2020-W43,14,21,35,256,gender
手足口病,2020,43,2020-W43,1,2,3,256,gender
突発性発しん,2020,43,2020-W43,67,55,122,256,gender
ヘルパンギーナ,2020,43,2020-W43,10,6,16,256,gender
流行性耳下腺炎,2020,43,2020-W43,9,8,17,256,gender
川崎病,2020,43,2020-W43,1,2,3,256,gender
インフルエンザ,2011,3,2011-W03,5264,4969,10233,417,gender
RSウイルス感染症,2011,3,2011-W03,70,46,116,263,gender
咽頭結膜熱,2011,3,2011-W03,56,35,91,263,gender
Ａ群溶血性レンサ球菌咽頭炎,2011,3,2011-W03,340,282,622,263,gender
感染性胃腸炎,2011,3,2011-W03,1440,1373,2813,263,gender
水痘,2011,3,2011-W03,176,191,367,263,gender
手足口病,2011,3,2011-W03,9,4,13,263,gender
突発性発しん,2011,3,2011-W03,98,74,172,263,gender
ヘルパンギーナ,2011,3,2011-W03,2,2,4,263,gender
流行性耳下腺炎,2011,3,2011-W03,56,36,92,263,gender
川崎病,2011,3,2011-W03,2,2,4,263,gender
インフルエンザ,2010,16,2010-W16,16,11,27,288,gender
RSウイルス感染症,2010,16,2010-W16,3,4,7,149,gender
咽頭結膜熱,2010,16,2010-W16,21,15,36,149,gender
Ａ群溶血性レンサ球菌咽頭炎,2010,16,2010-W16,123,109,232,149,gender
感染性胃腸炎,2010,16,2010-W16,784,684,1468,149,gender
水痘,2010,16,2010-W16,128,115,243,149,gender
手足口病,2010,16,2010-W16,19,22,41,149,gender
突発性発しん,2010,16,2010-W16,48,41,89,149,gender
ヘルパンギーナ,2010,16,2010-W16,15,12,27,149,gender
流行性耳下腺炎,2010,16,2010-W16,51,48,99,149,gender
川崎病,2010,16,2010-W16,1,1,2,149,gender
インフルエンザ,2022,30,2022-W30,9,6,15,406,gender
RSウイルス感染症,2022,30,2022-W30,219,221,440,258,gender
咽頭結膜熱,2022,30,2022-W30,18,12,30,258,gender
Ａ群溶血性レンサ球菌咽頭炎,2022,30,2022-W30,22,11,33,258,gender
感染性胃腸炎,2022,30,2022-W30,392,314,706,258,gender
水痘,2022,30,2022-W30,6,7,13,258,gender
手足口病,2022,30,2022-W30,678,553,1231,258,gender
突発性発しん,2022,30,2022-W30,45,38,83,258,gender
ヘルパンギーナ,2022,30,2022-W30,196,188,384,258,gender
流行性耳下腺炎,2022,30,2022-W30,7,4,11,258,gender
川崎病,2022,30,2022-W30,1,0,1,258,gender
インフルエンザ,2016,11,2016-W11,3081,3057,6138,413,gender
RSウイルス感染症,2016,11,2016-W11,13,12,25,259,gender
咽頭結膜熱,2016,11,2016-W11,29,18,47,259,gender
Ａ群溶血性レンサ球菌咽頭炎,2016,11,2016-W11,404,363,767,259,gender
感染性胃腸炎,2016,11,2016-W11,804,787,1591,259,gender
水痘,2016,11,2016-W11,38,32,70,259,gender
手足口病,2016,11,2016-W11,4,1,5,259,gender
突発性発しん,2016,11,2016-W11,63,61,124,259,gender
ヘルパンギーナ,2016,11,2016-W11,1,4,5,259,gender
流行性耳下腺炎,2016,11,2016-W11,68,53,121,259,gender
川崎病,2016,11,2016-W11,0,4,4,259,gender
インフルエンザ,2007,38,2007-W38,9,5,14,284,gender
RSウイルス感染症,2007,38,2007-W38,2,2,4,148,gender
咽頭結膜熱,2007,38,2007-W38,20,15,35,148,gender
Ａ群溶血性レンサ球菌咽頭炎,2007,38,2007-W38,49,55,104,148,gender
感染性胃腸炎,2007,38,2007-W38,260,234,494,148,gender
水痘,2007,38,2007-W38,31,25,56,148,gender
手足口病,2007,38,2007-W38,73,63,136,148,gender
突発性発しん,2007,38,2007-W38,57,64,121,148,gender
ヘルパンギーナ,2007,38,2007-W38,47,50,97,148,gender
流行性耳下腺炎,2007,38,2007-W38,15,14,29,148,gender
川崎病,2007,38,2007-W38,2,1,3,148,gender
インフルエンザ,2024,37,2024-W37,105,97,202,419,gender
新型コロナウイルス感染症（COVID-19）,2024,37,2024-W37,882,961,1843,419,gender
RSウイルス感染症,2024,37,2024-W37,36,27,63,264,gender
咽頭結膜熱,2024,37,2024-W37,23,33,56,264,gender
Ａ群溶血性レンサ球菌咽頭炎,2024,37,2024-W37,251,213,464,264,gender
感染性胃腸炎,2024,37,2024-W37,484,355,839,264,gender
水痘,2024,37,2024-W37,21,20,41,264,gender
手足口病,2024,37,2024-W37,1324,1087,2411,264,gender
突発性発しん,2024,37,2024-W37,43,36,79,264,gender
ヘルパンギーナ,2024,37,2024-W37,110,88,198,264,gender
流行性耳下腺炎,2024,37,2024-W37,7,10,17,264,gender
川崎病,2024,37,2024-W37,0,4,4,264,gender
インフルエンザ,2019,32,2019-W32,24,26,50,379,gender
RSウイルス感染症,2019,32,2019-W32,322,228,550,242,gender
咽頭結膜熱,2019,32,2019-W32,35,37,72,242,gender
Ａ群溶血性レンサ球菌咽頭炎,2019,32,2019-W32,141,133,274,242,gender
感染性胃腸炎,2019,32,2019-W32,437,356,793,242,gender
水痘,2019,32,2019-W32,41,28,69,242,gender
手足口病,2019,32,2019-W32,1015,907,1922,242,gender
突発性発しん,2019,32,2019-W32,51,41,92,242,gender
ヘルパンギーナ,2019,32,2019-W32,358,350,708,242,gender
流行性耳下腺炎,2019,32,2019-W32,14,7,21,242,gender
川崎病,2019,32,2019-W32,2,0,2,242,gender
インフルエンザ,2004,25,2004-W25,0,0,0,178,gender
RSウイルス感染症,2004,25,2004-W25,2,4,6,142,gender
咽頭結膜熱,2004,25,2004-W25,54,55,109,142,gender
Ａ群溶血性レンサ球菌咽頭炎,2004,25,2004-W25,80,67,147,142,gender
感染性胃腸炎,2004,25,2004-W25,298,250,548,142,gender
水痘,2004,25,2004-W25,63,68,131,142,gender
手足口病,2004,25,2004-W25,62,45,107,142,gender
突発性発しん,2004,25,2004-W25,41,36,77,142,gender
ヘルパンギーナ,2004,25,2004-W25,155,139,294,142,gender
流行性耳下腺炎,2004,25,2004-W25,31,19,50,142,gender
川崎病,2004,25,2004-W25,0,0,0,142,gender
インフルエンザ,2025,7,2025-W07,325,360,685,419,gender
新型コロナウイルス感染症（COVID-19）,2025,7,2025-W07,641,730,1371,419,gender
RSウイルス感染症,2025,7,2025-W07,113,89,202,264,gender
咽頭結膜熱,2025,7,2025-W07,19,25,44,264,gender
Ａ群溶血性レンサ球菌咽頭炎,2025,7,2025-W07,285,237,522,264,gender
感染性胃腸炎,2025,7,2025-W07,1361,1333,2694,264,gender
水痘,2025,7,2025-W07,36,29,65,264,gender
手足口病,2025,7,2025-W07,10,2,12,264,gender
突発性発しん,2025,7,2025-W07,19,19,38,264,gender
ヘルパンギーナ,2025,7,2025-W07,0,0,0,264,gender
流行性耳下腺炎,2025,7,2025-W07,11,4,15,264,gender
川崎病,2025,7,2025-W07,2,2,4,264,gender
インフルエンザ,2008,25,2008-W25,6,5,11,289,gender
RSウイルス感染症,2008,25,2008-W25,1,0,1,150,gender
咽頭結膜熱,2008,25,2008-W25,77,65,142,150,gender
Ａ群溶血性レンサ球菌咽頭炎,2008,25,2008-W25,219,189,408,150,gender
感染性胃腸炎,2008,25,2008-W25,496,436,932,150,gender
水痘,2008,25,2008-W25,165,130,295,150,gender
手足口病,2008,25,2008-W25,85,54,139,150,gender
突発性発しん,2008,25,2008-W25,58,55,113,150,gender
ヘルパンギーナ,2008,25,2008-W25,122,103,225,150,gender
流行性耳下腺炎,2008,25,2008-W25,63,62,125,150,gender
川崎病,2008,25,2008-W25,2,4,6,150,gender
インフルエンザ,2006,4,2006-W04,2195,2159,4354,178,gender
RSウイルス感染症,2006,4,2006-W04,9,5,14,142,gender
咽頭結膜熱,2006,4,2006-W04,15,17,32,142,gender
Ａ群溶血性レンサ球菌咽頭炎,2006,4,2006-W04,131,122,253,142,gender
感染性胃腸炎,2006,4,2006-W04,538,503,1041,142,gender
水痘,2006,4,2006-W04,79,81,160,142,gender
手足口病,2006,4,2006-W04,5,1,6,142,gender
突発性発しん,2006,4,2006-W04,45,36,81,142,gender
ヘルパンギーナ,2006,4,2006-W04,2,0,2,142,gender
流行性耳下腺炎,2006,4,2006-W04,47,33,80,142,gender
川崎病,2006,4,2006-W04,2,1,3,142,gender
インフルエンザ,2017,41,2017-W41,32,36,68,417,gender
RSウイルス感染症,2017,41,2017-W41,112,85,197,262,gender
咽頭結膜熱,2017,41,2017-W41,63,37,100,262,gender
Ａ群溶血性レンサ球菌咽頭炎,2017,41,2017-W41,218,175,393,262,gender
感染性胃腸炎,2017,41,2017-W41,401,354,755,262,gender
水痘,2017,41,2017-W41,36,33,69,262,gender
手足口病,2017,41,2017-W41,356,300,656,262,gender
突発性発しん,2017,41,2017-W41,63,64,127,262,gender
ヘルパンギーナ,2017,41,2017-W41,58,47,105,262,gender
流行性耳下腺炎,2017,41,2017-W41,17,20,37,262,gender
川崎病,2017,41,2017-W41,5,3,8,262,gender
インフルエンザ,2003,8,2003-W08,878,918,1796,178,gender
RSウイルス感染症,2003,8,2003-W08,0,0,0,142,gender
咽頭結膜熱,2003,8,2003-W08,5,5,10,142,gender
Ａ群溶血性レンサ球菌咽頭炎,2003,8,2003-W08,32,33,65,142,gender
感染性胃腸炎,2003,8,2003-W08,541,493,1034,142,gender
水痘,2003,8,2003-W08,63,51,114,142,gender
手足口病,2003,8,2003-W08,2,6,8,142,gender
突発性発しん,2003,8,2003-W08,24,28,52,142,gender
ヘルパンギーナ,2003,8,2003-W08,1,1,2,142,gender
流行性耳下腺炎,2003,8,2003-W08,13,10,23,142,gender
川崎病,2003,8,2003-W08,1,2,3,142,gender
インフルエンザ,2015,32,2015-W32,1,2,3,408,gender
RSウイルス感染症,2015,32,2015-W32,34,24,58,258,gender
咽頭結膜熱,2015,32,2015-W32,66,65,131,258,gender
Ａ群溶血性レンサ球菌咽頭炎,2015,32,2015-W32,177,190,367,258,gender
感染性胃腸炎,2015,32,2015-W32,513,411,924,258,gender
水痘,2015,32,2015-W32,43,49,92,258,gender
手足口病,2015,32,2015-W32,1619,1341,2960,258,gender
突発性発しん,2015,32,2015-W32,90,76,166,258,gender
ヘルパンギーナ,2015,32,2015-W32,320,327,647,258,gender
流行性耳下腺炎,2015,32,2015-W32,52,40,92,258,gender
川崎病,2015,32,2015-W32,6,2,8,258,gender
インフルエンザ,2021,13,2021-W13,0,0,0,412,gender
RSウイルス感染症,2021,13,2021-W13,16,9,25,259,gender
咽頭結膜熱,2021,13,2021-W13,6,11,17,259,gender
Ａ群溶血性レンサ球菌咽頭炎,2021,13,2021-W13,44,34,78,259,gender
感染性胃腸炎,2021,13,2021-W13,323,297,620,259,gender
水痘,2021,13,2021-W13,11,14,25,259,gender
手足口病,2021,13,2021-W13,2,3,5,259,gender
突発性発しん,2021,13,2021-W13,63,45,108,259,gender
ヘルパンギーナ,2021,13,2021-W13,1,1,2,259,gender
流行性耳下腺炎,2021,13,2021-W13,4,6,10,259,gender
川崎病,2021,13,2021-W13,4,1,5,259,gender
インフルエンザ,2011,46,2011-W46,20,16,36,414,gender
RSウイルス感染症,2011,46,2011-W46,54,40,94,261,gender
咽頭結膜熱,2011,46,2011-W46,30,30,60,261,gender
Ａ群溶血性レンサ球菌咽頭炎,2011,46,2011-W46,274,247,521,261,gender
感染性胃腸炎,2011,46,2011-W46,891,790,1681,261,gender
水痘,2011,46,2011-W46,184,175,359,261,gender
手足口病,2011,46,2011-W46,80,66,146,261,gender
突発性発しん,2011,46,2011-W46,84,76,160,261,gender
ヘルパンギーナ,2011,46,2011-W46,13,12,25,261,gender
流行性耳下腺炎,2011,46,2011-W46,46,35,81,261,gender
川崎病,2011,46,2011-W46,6,2,8,261,gender
インフルエンザ,2013,35,2013-W35,1,0,1,407,gender
RSウイルス感染症,2013,35,2013-W35,78,68,146,256,gender
咽頭結膜熱,2013,35,2013-W35,69,43,112,256,gender
Ａ群溶血性レンサ球菌咽頭炎,2013,35,2013-W35,96,83,179,256,gender
感染性胃腸炎,2013,35,2013-W35,356,261,617,256,gender
水痘,2013,35,2013-W35,45,33,78,256,gender
手足口病,2013,35,2013-W35,519,424,943,256,gender
突発性発しん,2013,35,2013-W35,96,97,193,256,gender
ヘルパンギーナ,2013,35,2013-W35,173,136,309,256,gender
流行性耳下腺炎,2013,35,2013-W35,25,23,48,256,gender
川崎病,2013,35,2013-W35,2,2,4,256,gender
インフルエンザ,2008,6,2008-W06,1197,1174,2371,288,gender
RSウイルス感染症,2008,6,2008-W06,10,13,23,150,gender
咽頭結膜熱,2008,6,2008-W06,13,26,39,150,gender
Ａ群溶血性レンサ球菌咽頭炎,2008,6,2008-W06,199,162,361,150,gender
感染性胃腸炎,2008,6,2008-W06,806,783,1589,150,gender
水痘,2008,6,2008-W06,89,87,176,150,gender
手足口病,2008,6,2008-W06,7,3,10,150,gender
突発性発しん,2008,6,2008-W06,53,52,105,150,gender
ヘルパンギーナ,2008,6,2008-W06,3,0,3,150,gender
流行性耳下腺炎,2008,6,2008-W06,20,9,29,150,gender
川崎病,2008,6,2008-W06,0,0,0,150,gender
インフルエンザ,2010,28,2010-W28,6,8,14,283,gender
RSウイルス感染症,2010,28,2010-W28,0,0,0,147,gender
咽頭結膜熱,2010,28,2010-W28,24,22,46,147,gender
Ａ群溶血性レンサ球菌咽頭炎,2010,28,2010-W28,84,61,145,147,gender
感染性胃腸炎,2010,28,2010-W28,285,242,527,147,gender
水痘,2010,28,2010-W28,102,68,170,147,gender
手足口病,2010,28,2010-W28,397,293,690,147,gender
突発性発しん,2010,28,2010-W28,54,49,103,147,gender
ヘルパンギーナ,2010,28,2010-W28,706,692,1398,147,gender
流行性耳下腺炎,2010,28,2010-W28,84,77,161,147,gender
川崎病,2010,28,2010-W28,1,1,2,147,gender
インフルエンザ,2006,27,2006-W27,0,0,0,178,gender
RSウイルス感染症,2006,27,2006-W27,1,0,1,142,gender
咽頭結膜熱,2006,27,2006-W27,125,125,250,142,gender
Ａ群溶血性レンサ球菌咽頭炎,2006,27,2006-W27,112,80,192,142,gender
感染性胃腸炎,2006,27,2006-W27,251,214,465,142,gender
水痘,2006,27,2006-W27,92,98,190,142,gender
手足口病,2006,27,2006-W27,48,35,83,142,gender
突発性発しん,2006,27,2006-W27,48,44,92,142,gender
ヘルパンギーナ,2006,27,2006-W27,271,300,571,142,gender
流行性耳下腺炎,2006,27,2006-W27,45,54,99,142,gender
川崎病,2006,27,2006-W27,1,1,2,142,gender
インフルエンザ,2007,49,2007-W49,705,657,1362,288,gender
RSウイルス感染症,2007,49,2007-W49,59,43,102,150,gender
咽頭結膜熱,2007,49,2007-W49,28,29,57,150,gender
Ａ群溶血性レンサ球菌咽頭炎,2007,49,2007-W49,159,121,280,150,gender
感染性胃腸炎,2007,49,2007-W49,1393,1362,2755,150,gender
水痘,2007,49,2007-W49,112,88,200,150,gender
手足口病,2007,49,2007-W49,19,12,31,150,gender
突発性発しん,2007,49,2007-W49,42,41,83,150,gender
ヘルパンギーナ,2007,49,2007-W49,6,10,16,150,gender
流行性耳下腺炎,2007,49,2007-W49,19,11,30,150,gender
川崎病,2007,49,2007-W49,0,0,0,150,gender
インフルエンザ,2024,46,2024-W46,465,408,873,418,gender
新型コロナウイルス感染症（COVID-19）,2024,46,2024-W46,240,297,537,418,gender
RSウイルス感染症,2024,46,2024-W46,29,30,59,264,gender
咽頭結膜熱,2024,46,2024-W46,22,8,30,264,gender
Ａ群溶血性レンサ球菌咽頭炎,2024,46,2024-W46,301,240,541,264,gender
感染性胃腸炎,2024,46,2024-W46,528,443,971,264,gender
水痘,2024,46,2024-W46,35,22,57,264,gender
手足口病,2024,46,2024-W46,597,516,1113,264,gender
突発性発しん,2024,46,2024-W46,28,34,62,264,gender
ヘルパンギーナ,2024,46,2024-W46,7,9,16,264,gender
流行性耳下腺炎,2024,46,2024-W46,7,2,9,264,gender
川崎病,2024,46,2024-W46,0,4,4,264,gender
インフルエンザ,2014,13,2014-W13,1937,1943,3880,412,gender
RSウイルス感染症,2014,13,2014-W13,21,14,35,260,gender
咽頭結膜熱,2014,13,2014-W13,33,23,56,260,gender
Ａ群溶血性レンサ球菌咽頭炎,2014,13,2014-W13,248,204,452,260,gender
感染性胃腸炎,2014,13,2014-W13,570,555,1125,260,gender
水痘,2014,13,2014-W13,93,98,191,260,gender
手足口病,2014,13,2014-W13,5,3,8,260,gender
突発性発しん,2014,13,2014-W13,68,66,134,260,gender
ヘルパンギーナ,2014,13,2014-W13,0,1,1,260,gender
流行性耳下腺炎,2014,13,2014-W13,15,11,26,260,gender
川崎病,2014,13,2014-W13,6,1,7,260,gender
インフルエンザ,2019,43,2019-W43,148,136,284,416,gender
RSウイルス感染症,2019,43,2019-W43,42,45,87,261,gender
咽頭結膜熱,2019,43,2019-W43,38,35,73,261,gender
Ａ群溶血性レンサ球菌咽頭炎,2019,43,2019-W43,266,225,491,261,gender
感染性胃腸炎,2019,43,2019-W43,491,396,887,261,gender
水痘,2019,43,2019-W43,44,39,83,261,gender
手足口病,2019,43,2019-W43,256,197,453,261,gender
突発性発しん,2019,43,2019-W43,41,56,97,261,gender
ヘルパンギーナ,2019,43,2019-W43,42,33,75,261,gender
流行性耳下腺炎,2019,43,2019-W43,14,11,25,261,gender
川崎病,2019,43,2019-W43,1,4,5,261,gender
インフルエンザ,2020,32,2020-W32,0,0,0,393,gender
RSウイルス感染症,2020,32,2020-W32,1,0,1,248,gender
咽頭結膜熱,2020,32,2020-W32,9,9,18,248,gender
Ａ群溶血性レンサ球菌咽頭炎,2020,32,2020-W32,51,33,84,248,gender
感染性胃腸炎,2020,32,2020-W32,274,245,519,248,gender
水痘,2020,32,2020-W32,12,15,27,248,gender
手足口病,2020,32,2020-W32,12,9,21,248,gender
突発性発しん,2020,32,2020-W32,61,63,124,248,gender
ヘルパンギーナ,2020,32,2020-W32,9,7,16,248,gender
流行性耳下腺炎,2020,32,2020-W32,9,7,16,248,gender
川崎病,2020,32,2020-W32,0,0,0,248,gender
インフルエンザ,2012,14,2012-W14,921,960,1881,414,gender
RSウイルス感染症,2012,14,2012-W14,17,17,34,261,gender
咽頭結膜熱,2012,14,2012-W14,18,10,28,261,gender
Ａ群溶血性レンサ球菌咽頭炎,2012,14,2012-W14,160,165,325,261,gender
感染性胃腸炎,2012,14,2012-W14,1221,1090,2311,261,gender
水痘,2012,14,2012-W14,131,115,246,261,gender
手足口病,2012,14,2012-W14,2,0,2,261,gender
突発性発しん,2012,14,2012-W14,75,52,127,261,gender
ヘルパンギーナ,2012,14,2012-W14,2,2,4,261,gender
流行性耳下腺炎,2012,14,2012-W14,19,30,49,261,gender
川崎病,2012,14,2012-W14,0,1,1,261,gender
インフルエンザ,2022,41,2022-W41,2,0,2,411,gender
RSウイルス感染症,2022,41,2022-W41,118,110,228,258,gender
咽頭結膜熱,2022,41,2022-W41,8,4,12,258,gender
Ａ群溶血性レンサ球菌咽頭炎,2022,41,2022-W41,12,17,29,258,gender
感染性胃腸炎,2022,41,2022-W41,371,305,676,258,gender
水痘,2022,41,2022-W41,6,4,10,258,gender
手足口病,2022,41,2022-W41,189,150,339,258,gender
突発性発しん,2022,41,2022-W41,24,26,50,258,gender
ヘルパンギーナ,2022,41,2022-W41,36,40,76,258,gender
流行性耳下腺炎,2022,41,2022-W41,3,3,6,258,gender
川崎病,2022,41,2022-W41,3,0,3,258,gender
インフルエンザ,2000,20,2000-W20,6,8,14,178,gender
RSウイルス感染症,2000,20,2000-W20,0,0,0,142,gender
咽頭結膜熱,2000,20,2000-W20,2,2,4,142,gender
Ａ群溶血性レンサ球菌咽頭炎,2000,20,2000-W20,53,52,105,142,gender
感染性胃腸炎,2000,20,2000-W20,298,238,536,142,gender
水痘,2000,20,2000-W20,130,104,234,142,gender
手足口病,2000,20,2000-W20,8,10,18,142,gender
突発性発しん,2000,20,2000-W20,45,45,90,142,gender
ヘルパンギーナ,2000,20,2000-W20,20,17,37,142,gender
流行性耳下腺炎,2000,20,2000-W20,36,45,81,142,gender
川崎病,2000,20,2000-W20,1,3,4,142,gender
インフルエンザ,2012,2,2012-W02,710,638,1348,418,gender
RSウイルス感染症,2012,2,2012-W02,35,38,73,264,gender
咽頭結膜熱,2012,2,2012-W02,34,28,62,264,gender
Ａ群溶血性レンサ球菌咽頭炎,2012,2,2012-W02,216,196,412,264,gender
感染性胃腸炎,2012,2,2012-W02,1569,1458,3027,264,gender
水痘,2012,2,2012-W02,301,270,571,264,gender
手足口病,2012,2,2012-W02,20,14,34,264,gender
突発性発しん,2012,2,2012-W02,67,70,137,264,gender
ヘルパンギーナ,2012,2,2012-W02,2,5,7,264,gender
流行性耳下腺炎,2012,2,2012-W02,40,29,69,264,gender
川崎病,2012,2,2012-W02,3,1,4,264,gender
インフルエンザ,2011,37,2011-W37,9,1,10,409,gender
RSウイルス感染症,2011,37,2011-W37,73,53,126,256,gender
咽頭結膜熱,2011,37,2011-W37,38,33,71,256,gender
Ａ群溶血性レンサ球菌咽頭炎,2011,37,2011-W37,99,83,182,256,gender
感染性胃腸炎,2011,37,2011-W37,483,394,877,256,gender
水痘,2011,37,2011-W37,59,53,112,256,gender
手足口病,2011,37,2011-W37,593,463,1056,256,gender
突発性発しん,2011,37,2011-W37,108,86,194,256,gender
ヘルパンギーナ,2011,37,2011-W37,269,233,502,256,gender
流行性耳下腺炎,2011,37,2011-W37,38,27,65,256,gender
川崎病,2011,37,2011-W37,0,1,1,256,gender
インフルエンザ,2013,44,2013-W44,17,18,35,401,gender
RSウイルス感染症,2013,44,2013-W44,145,146,291,254,gender
咽頭結膜熱,2013,44,2013-W44,33,38,71,254,gender
Ａ群溶血性レンサ球菌咽頭炎,2013,44,2013-W44,165,155,320,254,gender
感染性胃腸炎,2013,44,2013-W44,568,578,1146,254,gender
水痘,2013,44,2013-W44,84,95,179,254,gender
手足口病,2013,44,2013-W44,120,92,212,254,gender
突発性発しん,2013,44,2013-W44,95,92,187,254,gender
ヘルパンギーナ,2013,44,2013-W44,16,16,32,254,gender
流行性耳下腺炎,2013,44,2013-W44,26,23,49,254,gender
川崎病,2013,44,2013-W44,1,2,3,254,gender
インフルエンザ,2023,11,2023-W11,1677,1481,3158,408,gender
RSウイルス感染症,2023,11,2023-W11,21,18,39,256,gender
咽頭結膜熱,2023,11,2023-W11,12,10,22,256,gender
Ａ群溶血性レンサ球菌咽頭炎,2023,11,2023-W11,67,33,100,256,gender
感染性胃腸炎,2023,11,2023-W11,652,626,1278,256,gender
水痘,2023,11,2023-W11,15,22,37,256,gender
手足口病,2023,11,2023-W11,7,4,11,256,gender
突発性発しん,2023,11,2023-W11,36,25,61,256,gender
ヘルパンギーナ,2023,11,2023-W11,2,1,3,256,gender
流行性耳下腺炎,2023,11,2023-W11,3,6,9,256,gender
川崎病,2023,11,2023-W11,1,0,1,256,gender
インフルエンザ,2017,30,2017-W30,35,25,60,417,gender
RSウイルス感染症,2017,30,2017-W30,235,170,405,263,gender
咽頭結膜熱,2017,30,2017-W30,162,133,295,263,gender
Ａ群溶血性レンサ球菌咽頭炎,2017,30,2017-W30,251,204,455,263,gender
感染性胃腸炎,2017,30,2017-W30,558,531,1089,263,gender
水痘,2017,30,2017-W30,42,33,75,263,gender
手足口病,2017,30,2017-W30,1511,1342,2853,263,gender
突発性発しん,2017,30,2017-W30,85,73,158,263,gender
ヘルパンギーナ,2017,30,2017-W30,335,334,669,263,gender
流行性耳下腺炎,2017,30,2017-W30,32,37,69,263,gender
川崎病,2017,30,2017-W30,2,1,3,263,gender
インフルエンザ,2006,19,2006-W19,4,5,9,178,gender
RSウイルス感染症,2006,19,2006-W19,0,1,1,142,gender
咽頭結膜熱,2006,19,2006-W19,50,38,88,142,gender
Ａ群溶血性レンサ球菌咽頭炎,2006,19,2006-W19,136,133,269,142,gender
感染性胃腸炎,2006,19,2006-W19,395,388,783,142,gender
水痘,2006,19,2006-W19,191,180,371,142,gender
手足口病,2006,19,2006-W19,8,7,15,142,gender
突発性発しん,2006,19,2006-W19,37,48,85,142,gender
ヘルパンギーナ,2006,19,2006-W19,25,30,55,142,gender
流行性耳下腺炎,2006,19,2006-W19,46,43,89,142,gender
川崎病,2006,19,2006-W19,1,1,2,142,gender
インフルエンザ,2025,16,2025-W16,192,202,394,418,gender
新型コロナウイルス感染症（COVID-19）,2025,16,2025-W16,195,235,430,418,gender
RSウイルス感染症,2025,16,2025-W16,56,49,105,264,gender
咽頭結膜熱,2025,16,2025-W16,42,21,63,264,gender
Ａ群溶血性レンサ球菌咽頭炎,2025,16,2025-W16,501,413,914,264,gender
感染性胃腸炎,2025,16,2025-W16,1100,907,2007,264,gender
水痘,2025,16,2025-W16,67,67,134,264,gender
手足口病,2025,16,2025-W16,5,10,15,264,gender
突発性発しん,2025,16,2025-W16,30,35,65,264,gender
ヘルパンギーナ,2025,16,2025-W16,0,0,0,264,gender
流行性耳下腺炎,2025,16,2025-W16,5,4,9,264,gender
川崎病,2025,16,2025-W16,3,5,8,264,gender
インフルエンザ,2015,43,2015-W43,21,28,49,414,gender
RSウイルス感染症,2015,43,2015-W43,208,176,384,261,gender
咽頭結膜熱,2015,43,2015-W43,32,34,66,261,gender
Ａ群溶血性レンサ球菌咽頭炎,2015,43,2015-W43,302,237,539,261,gender
感染性胃腸炎,2015,43,2015-W43,639,550,1189,261,gender
水痘,2015,43,2015-W43,61,46,107,261,gender
手足口病,2015,43,2015-W43,93,87,180,261,gender
突発性発しん,2015,43,2015-W43,70,76,146,261,gender
ヘルパンギーナ,2015,43,2015-W43,29,19,48,261,gender
流行性耳下腺炎,2015,43,2015-W43,84,72,156,261,gender
川崎病,2015,43,2015-W43,1,0,1,261,gender
インフルエンザ,2018,13,2018-W13,375,413,788,415,gender
RSウイルス感染症,2018,13,2018-W13,38,30,68,261,gender
咽頭結膜熱,2018,13,2018-W13,28,23,51,261,gender
Ａ群溶血性レンサ球菌咽頭炎,2018,13,2018-W13,316,237,553,261,gender
感染性胃腸炎,2018,13,2018-W13,612,572,1184,261,gender
水痘,2018,13,2018-W13,37,47,84,261,gender
手足口病,2018,13,2018-W13,3,6,9,261,gender
突発性発しん,2018,13,2018-W13,67,56,123,261,gender
ヘルパンギーナ,2018,13,2018-W13,1,0,1,261,gender
流行性耳下腺炎,2018,13,2018-W13,10,4,14,261,gender
川崎病,2018,13,2018-W13,0,2,2,261,gender
インフルエンザ,2005,5,2005-W05,2355,2241,4596,178,gender
RSウイルス感染症,2005,5,2005-W05,7,4,11,142,gender
咽頭結膜熱,2005,5,2005-W05,10,8,18,142,gender
Ａ群溶血性レンサ球菌咽頭炎,2005,5,2005-W05,73,66,139,142,gender
感染性胃腸炎,2005,5,2005-W05,620,635,1255,142,gender
水痘,2005,5,2005-W05,75,63,138,142,gender
手足口病,2005,5,2005-W05,6,9,15,142,gender
突発性発しん,2005,5,2005-W05,33,37,70,142,gender
ヘルパンギーナ,2005,5,2005-W05,3,0,3,142,gender
流行性耳下腺炎,2005,5,2005-W05,55,33,88,142,gender
川崎病,2005,5,2005-W05,0,0,0,142,gender
インフルエンザ,2022,52,2022-W52,620,519,1139,387,gender
RSウイルス感染症,2022,52,2022-W52,5,4,9,247,gender
咽頭結膜熱,2022,52,2022-W52,13,12,25,247,gender
Ａ群溶血性レンサ球菌咽頭炎,2022,52,2022-W52,25,15,40,247,gender
感染性胃腸炎,2022,52,2022-W52,923,815,1738,247,gender
水痘,2022,52,2022-W52,17,7,24,247,gender
手足口病,2022,52,2022-W52,10,10,20,247,gender
突発性発しん,2022,52,2022-W52,19,13,32,247,gender
ヘルパンギーナ,2022,52,2022-W52,6,4,10,247,gender
流行性耳下腺炎,2022,52,2022-W52,3,2,5,247,gender
川崎病,2022,52,2022-W52,1,1,2,247,gender
インフルエンザ,2020,21,2020-W21,1,0,1,411,gender
RSウイルス感染症,2020,21,2020-W21,0,1,1,260,gender
咽頭結膜熱,2020,21,2020-W21,4,1,5,260,gender
Ａ群溶血性レンサ球菌咽頭炎,2020,21,2020-W21,32,45,77,260,gender
感染性胃腸炎,2020,21,2020-W21,140,122,262,260,gender
水痘,2020,21,2020-W21,10,12,22,260,gender
手足口病,2020,21,2020-W21,6,8,14,260,gender
突発性発しん,2020,21,2020-W21,45,31,76,260,gender
ヘルパンギーナ,2020,21,2020-W21,1,1,2,260,gender
流行性耳下腺炎,2020,21,2020-W21,7,2,9,260,gender
川崎病,2020,21,2020-W21,4,1,5,260,gender
インフルエンザ,2002,40,2002-W40,0,0,0,178,gender
RSウイルス感染症,2002,40,2002-W40,0,0,0,142,gender
咽頭結膜熱,2002,40,2002-W40,7,1,8,142,gender
Ａ群溶血性レンサ球菌咽頭炎,2002,40,2002-W40,18,24,42,142,gender
感染性胃腸炎,2002,40,2002-W40,173,150,323,142,gender
水痘,2002,40,2002-W40,32,32,64,142,gender
手足口病,2002,40,2002-W40,20,15,35,142,gender
突発性発しん,2002,40,2002-W40,44,58,102,142,gender
ヘルパンギーナ,2002,40,2002-W40,11,7,18,142,gender
流行性耳下腺炎,2002,40,2002-W40,23,25,48,142,gender
川崎病,2002,40,2002-W40,0,0,0,142,gender
インフルエンザ,2004,3,2004-W03,777,698,1475,178,gender
RSウイルス感染症,2004,3,2004-W03,9,3,12,142,gender
咽頭結膜熱,2004,3,2004-W03,7,4,11,142,gender
Ａ群溶血性レンサ球菌咽頭炎,2004,3,2004-W03,48,36,84,142,gender
感染性胃腸炎,2004,3,2004-W03,431,447,878,142,gender
水痘,2004,3,2004-W03,77,86,163,142,gender
手足口病,2004,3,2004-W03,2,5,7,142,gender
突発性発しん,2004,3,2004-W03,34,45,79,142,gender
ヘルパンギーナ,2004,3,2004-W03,1,0,1,142,gender
流行性耳下腺炎,2004,3,2004-W03,19,14,33,142,gender
川崎病,2004,3,2004-W03,2,0,2,142,gender
インフルエンザ,2000,33,2000-W33,0,0,0,178,gender
RSウイルス感染症,2000,33,2000-W33,0,0,0,142,gender
咽頭結膜熱,2000,33,2000-W33,2,7,9,142,gender
Ａ群溶血性レンサ球菌咽頭炎,2000,33,2000-W33,4,8,12,142,gender
感染性胃腸炎,2000,33,2000-W33,72,77,149,142,gender
水痘,2000,33,2000-W33,15,10,25,142,gender
手足口病,2000,33,2000-W33,104,79,183,142,gender
突発性発しん,2000,33,2000-W33,19,21,40,142,gender
ヘルパンギーナ,2000,33,2000-W33,56,46,102,142,gender
流行性耳下腺炎,2000,33,2000-W33,28,29,57,142,gender
川崎病,2000,33,2000-W33,0,0,0,142,gender
インフルエンザ,2009,17,2009-W17,296,313,609,286,gender
RSウイルス感染症,2009,17,2009-W17,5,1,6,147,gender
咽頭結膜熱,2009,17,2009-W17,26,15,41,147,gender
Ａ群溶血性レンサ球菌咽頭炎,2009,17,2009-W17,162,134,296,147,gender
感染性胃腸炎,2009,17,2009-W17,527,449,976,147,gender
水痘,2009,17,2009-W17,80,70,150,147,gender
手足口病,2009,17,2009-W17,3,6,9,147,gender
突発性発しん,2009,17,2009-W17,49,55,104,147,gender
ヘルパンギーナ,2009,17,2009-W17,7,2,9,147,gender
流行性耳下腺炎,2009,17,2009-W17,50,46,96,147,gender
川崎病,2009,17,2009-W17,1,0,1,147,gender
インフルエンザ,2004,47,2004-W47,30,28,58,178,gender
RSウイルス感染症,2004,47,2004-W47,14,7,21,142,gender
咽頭結膜熱,2004,47,2004-W47,9,7,16,142,gender
Ａ群溶血性レンサ球菌咽頭炎,2004,47,2004-W47,59,36,95,142,gender
感染性胃腸炎,2004,47,2004-W47,398,389,787,142,gender
水痘,2004,47,2004-W47,85,63,148,142,gender
手足口病,2004,47,2004-W47,73,75,148,142,gender
突発性発しん,2004,47,2004-W47,31,32,63,142,gender
ヘルパンギーナ,2004,47,2004-W47,5,6,11,142,gender
流行性耳下腺炎,2004,47,2004-W47,34,38,72,142,gender
川崎病,2004,47,2004-W47,1,0,1,142,gender
インフルエンザ,2006,34,2006-W34,0,0,0,178,gender
RSウイルス感染症,2006,34,2006-W34,1,0,1,142,gender
咽頭結膜熱,2006,34,2006-W34,39,27,66,142,gender
Ａ群溶血性レンサ球菌咽頭炎,2006,34,2006-W34,43,28,71,142,gender
感染性胃腸炎,2006,34,2006-W34,183,127,310,142,gender
水痘,2006,34,2006-W34,38,40,78,142,gender
手足口病,2006,34,2006-W34,40,59,99,142,gender
突発性発しん,2006,34,2006-W34,53,58,111,142,gender
ヘルパンギーナ,2006,34,2006-W34,29,31,60,142,gender
流行性耳下腺炎,2006,34,2006-W34,41,26,67,142,gender
川崎病,2006,34,2006-W34,1,0,1,142,gender
インフルエンザ,2019,50,2019-W50,3582,3437,7019,416,gender
RSウイルス感染症,2019,50,2019-W50,21,23,44,261,gender
咽頭結膜熱,2019,50,2019-W50,82,77,159,261,gender
Ａ群溶血性レンサ球菌咽頭炎,2019,50,2019-W50,548,462,1010,261,gender
感染性胃腸炎,2019,50,2019-W50,1146,1040,2186,261,gender
水痘,2019,50,2019-W50,135,111,246,261,gender
手足口病,2019,50,2019-W50,163,142,305,261,gender
突発性発しん,2019,50,2019-W50,58,55,113,261,gender
ヘルパンギーナ,2019,50,2019-W50,18,8,26,261,gender
流行性耳下腺炎,2019,50,2019-W50,7,4,11,261,gender
川崎病,2019,50,2019-W50,5,3,8,261,gender
インフルエンザ,2005,29,2005-W29,0,1,1,178,gender
RSウイルス感染症,2005,29,2005-W29,1,1,2,142,gender
咽頭結膜熱,2005,29,2005-W29,43,37,80,142,gender
Ａ群溶血性レンサ球菌咽頭炎,2005,29,2005-W29,84,46,130,142,gender
感染性胃腸炎,2005,29,2005-W29,188,156,344,142,gender
水痘,2005,29,2005-W29,68,69,137,142,gender
手足口病,2005,29,2005-W29,141,118,259,142,gender
突発性発しん,2005,29,2005-W29,28,36,64,142,gender
ヘルパンギーナ,2005,29,2005-W29,350,337,687,142,gender
流行性耳下腺炎,2005,29,2005-W29,92,90,182,142,gender
川崎病,2005,29,2005-W29,0,0,0,142,gender
インフルエンザ,2015,50,2015-W50,100,81,181,414,gender
RSウイルス感染症,2015,50,2015-W50,179,177,356,261,gender
咽頭結膜熱,2015,50,2015-W50,86,51,137,261,gender
Ａ群溶血性レンサ球菌咽頭炎,2015,50,2015-W50,424,435,859,261,gender
感染性胃腸炎,2015,50,2015-W50,1963,1771,3734,261,gender
水痘,2015,50,2015-W50,100,101,201,261,gender
手足口病,2015,50,2015-W50,20,10,30,261,gender
突発性発しん,2015,50,2015-W50,64,49,113,261,gender
ヘルパンギーナ,2015,50,2015-W50,8,3,11,261,gender
流行性耳下腺炎,2015,50,2015-W50,81,72,153,261,gender
川崎病,2015,50,2015-W50,1,1,2,261,gender
インフルエンザ,2009,29,2009-W29,37,35,72,289,gender
RSウイルス感染症,2009,29,2009-W29,2,3,5,149,gender
咽頭結膜熱,2009,29,2009-W29,35,25,60,149,gender
Ａ群溶血性レンサ球菌咽頭炎,2009,29,2009-W29,90,73,163,149,gender
感染性胃腸炎,2009,29,2009-W29,273,235,508,149,gender
水痘,2009,29,2009-W29,83,58,141,149,gender
手足口病,2009,29,2009-W29,85,82,167,149,gender
突発性発しん,2009,29,2009-W29,53,50,103,149,gender
ヘルパンギーナ,2009,29,2009-W29,86,96,182,149,gender
流行性耳下腺炎,2009,29,2009-W29,68,71,139,149,gender
川崎病,2009,29,2009-W29,0,0,0,149,gender
インフルエンザ,2017,23,2017-W23,13,13,26,413,gender
RSウイルス感染症,2017,23,2017-W23,29,30,59,262,gender
咽頭結膜熱,2017,23,2017-W23,168,135,303,262,gender
Ａ群溶血性レンサ球菌咽頭炎,2017,23,2017-W23,480,399,879,262,gender
感染性胃腸炎,2017,23,2017-W23,984,857,1841,262,gender
水痘,2017,23,2017-W23,55,49,104,262,gender
手足口病,2017,23,2017-W23,129,138,267,262,gender
突発性発しん,2017,23,2017-W23,85,83,168,262,gender
ヘルパンギーナ,2017,23,2017-W23,30,40,70,262,gender
流行性耳下腺炎,2017,23,2017-W23,33,26,59,262,gender
川崎病,2017,23,2017-W23,1,0,1,262,gender
インフルエンザ,2008,47,2008-W47,76,74,150,282,gender
RSウイルス感染症,2008,47,2008-W47,70,52,122,146,gender
咽頭結膜熱,2008,47,2008-W47,20,20,40,146,gender
Ａ群溶血性レンサ球菌咽頭炎,2008,47,2008-W47,150,128,278,146,gender
感染性胃腸炎,2008,47,2008-W47,837,800,1637,146,gender
水痘,2008,47,2008-W47,88,70,158,146,gender
手足口病,2008,47,2008-W47,34,42,76,146,gender
突発性発しん,2008,47,2008-W47,41,52,93,146,gender
ヘルパンギーナ,2008,47,2008-W47,8,5,13,146,gender
流行性耳下腺炎,2008,47,2008-W47,40,41,81,146,gender
川崎病,2008,47,2008-W47,2,2,4,146,gender
インフルエンザ,2005,17,2005-W17,57,60,117,178,gender
RSウイルス感染症,2005,17,2005-W17,5,2,7,142,gender
咽頭結膜熱,2005,17,2005-W17,15,15,30,142,gender
Ａ群溶血性レンサ球菌咽頭炎,2005,17,2005-W17,77,66,143,142,gender
感染性胃腸炎,2005,17,2005-W17,359,341,700,142,gender
水痘,2005,17,2005-W17,89,77,166,142,gender
手足口病,2005,17,2005-W17,10,13,23,142,gender
突発性発しん,2005,17,2005-W17,39,38,77,142,gender
ヘルパンギーナ,2005,17,2005-W17,6,10,16,142,gender
流行性耳下腺炎,2005,17,2005-W17,71,60,131,142,gender
川崎病,2005,17,2005-W17,0,0,0,142,gender
インフルエンザ,2013,4,2013-W04,8779,8480,17259,418,gender
RSウイルス感染症,2013,4,2013-W04,53,45,98,264,gender
咽頭結膜熱,2013,4,2013-W04,47,31,78,264,gender
Ａ群溶血性レンサ球菌咽頭炎,2013,4,2013-W04,308,262,570,264,gender
感染性胃腸炎,2013,4,2013-W04,1097,1051,2148,264,gender
水痘,2013,4,2013-W04,134,92,226,264,gender
手足口病,2013,4,2013-W04,16,6,22,264,gender
突発性発しん,2013,4,2013-W04,67,59,126,264,gender
ヘルパンギーナ,2013,4,2013-W04,0,1,1,264,gender
流行性耳下腺炎,2013,4,2013-W04,23,11,34,264,gender
川崎病,2013,4,2013-W04,4,3,7,264,gender
インフルエンザ,2016,8,2016-W08,5355,5333,10688,414,gender
RSウイルス感染症,2016,8,2016-W08,19,13,32,260,gender
咽頭結膜熱,2016,8,2016-W08,34,14,48,260,gender
Ａ群溶血性レンサ球菌咽頭炎,2016,8,2016-W08,419,355,774,260,gender
感染性胃腸炎,2016,8,2016-W08,926,836,1762,260,gender
水痘,2016,8,2016-W08,38,33,71,260,gender
手足口病,2016,8,2016-W08,3,5,8,260,gender
突発性発しん,2016,8,2016-W08,60,44,104,260,gender
ヘルパンギーナ,2016,8,2016-W08,3,1,4,260,gender
流行性耳下腺炎,2016,8,2016-W08,67,45,112,260,gender
川崎病,2016,8,2016-W08,1,1,2,260,gender
インフルエンザ,2003,10,2003-W10,369,391,760,178,gender
RSウイルス感染症,2003,10,2003-W10,0,0,0,142,gender
咽頭結膜熱,2003,10,2003-W10,3,5,8,142,gender
Ａ群溶血性レンサ球菌咽頭炎,2003,10,2003-W10,46,43,89,142,gender
感染性胃腸炎,2003,10,2003-W10,454,419,873,142,gender
水痘,2003,10,2003-W10,61,64,125,142,gender
手足口病,2003,10,2003-W10,1,1,2,142,gender
突発性発しん,2003,10,2003-W10,20,26,46,142,gender
ヘルパンギーナ,2003,10,2003-W10,0,2,2,142,gender
流行性耳下腺炎,2003,10,2003-W10,16,9,25,142,gender
川崎病,2003,10,2003-W10,0,0,0,142,gender
インフルエンザ,2012,39,2012-W39,7,8,15,415,gender
RSウイルス感染症,2012,39,2012-W39,319,250,569,261,gender
咽頭結膜熱,2012,39,2012-W39,76,57,133,261,gender
Ａ群溶血性レンサ球菌咽頭炎,2012,39,2012-W39,170,122,292,261,gender
感染性胃腸炎,2012,39,2012-W39,531,467,998,261,gender
水痘,2012,39,2012-W39,56,50,106,261,gender
手足口病,2012,39,2012-W39,68,66,134,261,gender
突発性発しん,2012,39,2012-W39,106,85,191,261,gender
ヘルパンギーナ,2012,39,2012-W39,74,82,156,261,gender
流行性耳下腺炎,2012,39,2012-W39,34,24,58,261,gender
川崎病,2012,39,2012-W39,3,0,3,261,gender
インフルエンザ,2011,24,2011-W24,7,4,11,414,gender
RSウイルス感染症,2011,24,2011-W24,4,11,15,259,gender
咽頭結膜熱,2011,24,2011-W24,100,100,200,259,gender
Ａ群溶血性レンサ球菌咽頭炎,2011,24,2011-W24,379,320,699,259,gender
感染性胃腸炎,2011,24,2011-W24,921,815,1736,259,gender
水痘,2011,24,2011-W24,231,195,426,259,gender
手足口病,2011,24,2011-W24,100,85,185,259,gender
突発性発しん,2011,24,2011-W24,109,121,230,259,gender
ヘルパンギーナ,2011,24,2011-W24,42,46,88,259,gender
流行性耳下腺炎,2011,24,2011-W24,68,42,110,259,gender
川崎病,2011,24,2011-W24,2,3,5,259,gender
インフルエンザ,2019,21,2019-W21,124,94,218,413,gender
RSウイルス感染症,2019,21,2019-W21,42,31,73,260,gender
咽頭結膜熱,2019,21,2019-W21,79,61,140,260,gender
Ａ群溶血性レンサ球菌咽頭炎,2019,21,2019-W21,438,335,773,260,gender
感染性胃腸炎,2019,21,2019-W21,1028,925,1953,260,gender
水痘,2019,21,2019-W21,67,76,143,260,gender
手足口病,2019,21,2019-W21,56,53,109,260,gender
突発性発しん,2019,21,2019-W21,86,81,167,260,gender
ヘルパンギーナ,2019,21,2019-W21,12,12,24,260,gender
流行性耳下腺炎,2019,21,2019-W21,13,15,28,260,gender
川崎病,2019,21,2019-W21,2,0,2,260,gender
インフルエンザ,2024,24,2024-W24,41,38,79,419,gender
新型コロナウイルス感染症（COVID-19）,2024,24,2024-W24,868,1012,1880,419,gender
RSウイルス感染症,2024,24,2024-W24,106,78,184,264,gender
咽頭結膜熱,2024,24,2024-W24,88,62,150,264,gender
Ａ群溶血性レンサ球菌咽頭炎,2024,24,2024-W24,506,500,1006,264,gender
感染性胃腸炎,2024,24,2024-W24,731,599,1330,264,gender
水痘,2024,24,2024-W24,28,22,50,264,gender
手足口病,2024,24,2024-W24,584,492,1076,264,gender
突発性発しん,2024,24,2024-W24,47,36,83,264,gender
ヘルパンギーナ,2024,24,2024-W24,125,81,206,264,gender
流行性耳下腺炎,2024,24,2024-W24,12,10,22,264,gender
川崎病,2024,24,2024-W24,1,2,3,264,gender
インフルエンザ,2004,36,2004-W36,0,0,0,178,gender
RSウイルス感染症,2004,36,2004-W36,0,0,0,142,gender
咽頭結膜熱,2004,36,2004-W36,20,16,36,142,gender
Ａ群溶血性レンサ球菌咽頭炎,2004,36,2004-W36,26,18,44,142,gender
感染性胃腸炎,2004,36,2004-W36,150,150,300,142,gender
水痘,2004,36,2004-W36,20,13,33,142,gender
手足口病,2004,36,2004-W36,63,36,99,142,gender
突発性発しん,2004,36,2004-W36,48,47,95,142,gender
ヘルパンギーナ,2004,36,2004-W36,30,30,60,142,gender
流行性耳下腺炎,2004,36,2004-W36,15,31,46,142,gender
川崎病,2004,36,2004-W36,1,0,1,142,gender
インフルエンザ,2006,45,2006-W45,1,0,1,178,gender
RSウイルス感染症,2006,45,2006-W45,6,2,8,142,gender
咽頭結膜熱,2006,45,2006-W45,18,6,24,142,gender
Ａ群溶血性レンサ球菌咽頭炎,2006,45,2006-W45,115,100,215,142,gender
感染性胃腸炎,2006,45,2006-W45,721,678,1399,142,gender
水痘,2006,45,2006-W45,59,57,116,142,gender
手足口病,2006,45,2006-W45,39,23,62,142,gender
突発性発しん,2006,45,2006-W45,50,42,92,142,gender
ヘルパンギーナ,2006,45,2006-W45,8,1,9,142,gender
流行性耳下腺炎,2006,45,2006-W45,36,33,69,142,gender
川崎病,2006,45,2006-W45,1,1,2,142,gender
インフルエンザ,2002,31,2002-W31,0,0,0,178,gender
RSウイルス感染症,2002,31,2002-W31,0,0,0,142,gender
咽頭結膜熱,2002,31,2002-W31,18,17,35,142,gender
Ａ群溶血性レンサ球菌咽頭炎,2002,31,2002-W31,12,17,29,142,gender
感染性胃腸炎,2002,31,2002-W31,143,124,267,142,gender
水痘,2002,31,2002-W31,53,56,109,142,gender
手足口病,2002,31,2002-W31,94,84,178,142,gender
突発性発しん,2002,31,2002-W31,43,36,79,142,gender
ヘルパンギーナ,2002,31,2002-W31,167,142,309,142,gender
流行性耳下腺炎,2002,31,2002-W31,39,28,67,142,gender
川崎病,2002,31,2002-W31,0,0,0,142,gender
インフルエンザ,2024,1,2024-W01,1577,1587,3164,405,gender
新型コロナウイルス感染症（COVID-19）,2024,1,2024-W01,627,739,1366,405,gender
RSウイルス感染症,2024,1,2024-W01,2,1,3,255,gender
咽頭結膜熱,2024,1,2024-W01,101,77,178,255,gender
Ａ群溶血性レンサ球菌咽頭炎,2024,1,2024-W01,207,172,379,255,gender
感染性胃腸炎,2024,1,2024-W01,473,438,911,255,gender
水痘,2024,1,2024-W01,17,14,31,255,gender
手足口病,2024,1,2024-W01,12,20,32,255,gender
突発性発しん,2024,1,2024-W01,11,14,25,255,gender
ヘルパンギーナ,2024,1,2024-W01,2,0,2,255,gender
流行性耳下腺炎,2024,1,2024-W01,0,0,0,255,gender
川崎病,2024,1,2024-W01,3,2,5,255,gender
インフルエンザ,2013,18,2013-W18,143,168,311,399,gender
RSウイルス感染症,2013,18,2013-W18,10,9,19,251,gender
咽頭結膜熱,2013,18,2013-W18,39,28,67,251,gender
Ａ群溶血性レンサ球菌咽頭炎,2013,18,2013-W18,221,172,393,251,gender
感染性胃腸炎,2013,18,2013-W18,647,650,1297,251,gender
水痘,2013,18,2013-W18,77,75,152,251,gender
手足口病,2013,18,2013-W18,12,11,23,251,gender
突発性発しん,2013,18,2013-W18,59,53,112,251,gender
ヘルパンギーナ,2013,18,2013-W18,7,5,12,251,gender
流行性耳下腺炎,2013,18,2013-W18,18,12,30,251,gender
川崎病,2013,18,2013-W18,1,2,3,251,gender
インフルエンザ,2000,42,2000-W42,0,3,3,178,gender
RSウイルス感染症,2000,42,2000-W42,0,0,0,142,gender
咽頭結膜熱,2000,42,2000-W42,2,4,6,142,gender
Ａ群溶血性レンサ球菌咽頭炎,2000,42,2000-W42,29,18,47,142,gender
感染性胃腸炎,2000,42,2000-W42,162,131,293,142,gender
水痘,2000,42,2000-W42,36,24,60,142,gender
手足口病,2000,42,2000-W42,60,54,114,142,gender
突発性発しん,2000,42,2000-W42,43,46,89,142,gender
ヘルパンギーナ,2000,42,2000-W42,10,8,18,142,gender
流行性耳下腺炎,2000,42,2000-W42,65,66,131,142,gender
川崎病,2000,42,2000-W42,1,1,2,142,gender
インフルエンザ,2022,23,2022-W23,1,2,3,411,gender
RSウイルス感染症,2022,23,2022-W23,23,22,45,258,gender
咽頭結膜熱,2022,23,2022-W23,57,43,100,258,gender
Ａ群溶血性レンサ球菌咽頭炎,2022,23,2022-W23,28,22,50,258,gender
感染性胃腸炎,2022,23,2022-W23,945,846,1791,258,gender
水痘,2022,23,2022-W23,9,9,18,258,gender
手足口病,2022,23,2022-W23,39,27,66,258,gender
突発性発しん,2022,23,2022-W23,57,49,106,258,gender
ヘルパンギーナ,2022,23,2022-W23,6,12,18,258,gender
流行性耳下腺炎,2022,23,2022-W23,12,0,12,258,gender
川崎病,2022,23,2022-W23,0,1,1,258,gender
インフルエンザ,2020,50,2020-W50,2,2,4,408,gender
RSウイルス感染症,2020,50,2020-W50,0,2,2,257,gender
咽頭結膜熱,2020,50,2020-W50,27,25,52,257,gender
Ａ群溶血性レンサ球菌咽頭炎,2020,50,2020-W50,69,52,121,257,gender
感染性胃腸炎,2020,50,2020-W50,377,352,729,257,gender
水痘,2020,50,2020-W50,21,19,40,257,gender
手足口病,2020,50,2020-W50,3,3,6,257,gender
突発性発しん,2020,50,2020-W50,65,53,118,257,gender
ヘルパンギーナ,2020,50,2020-W50,3,3,6,257,gender
流行性耳下腺炎,2020,50,2020-W50,3,4,7,257,gender
川崎病,2020,50,2020-W50,0,3,3,257,gender
インフルエンザ,2007,2,2007-W02,18,18,36,270,gender
RSウイルス感染症,2007,2,2007-W02,31,37,68,141,gender
咽頭結膜熱,2007,2,2007-W02,16,14,30,141,gender
Ａ群溶血性レンサ球菌咽頭炎,2007,2,2007-W02,77,67,144,141,gender
感染性胃腸炎,2007,2,2007-W02,399,454,853,141,gender
水痘,2007,2,2007-W02,138,136,274,141,gender
手足口病,2007,2,2007-W02,6,7,13,141,gender
突発性発しん,2007,2,2007-W02,41,33,74,141,gender
ヘルパンギーナ,2007,2,2007-W02,1,0,1,141,gender
流行性耳下腺炎,2007,2,2007-W02,29,15,44,141,gender
川崎病,2007,2,2007-W02,1,1,2,141,gender
インフルエンザ,2013,26,2013-W26,22,21,43,414,gender
RSウイルス感染症,2013,26,2013-W26,18,13,31,261,gender
咽頭結膜熱,2013,26,2013-W26,136,127,263,261,gender
Ａ群溶血性レンサ球菌咽頭炎,2013,26,2013-W26,306,250,556,261,gender
感染性胃腸炎,2013,26,2013-W26,630,481,1111,261,gender
水痘,2013,26,2013-W26,158,154,312,261,gender
手足口病,2013,26,2013-W26,567,477,1044,261,gender
突発性発しん,2013,26,2013-W26,117,84,201,261,gender
ヘルパンギーナ,2013,26,2013-W26,158,165,323,261,gender
流行性耳下腺炎,2013,26,2013-W26,38,27,65,261,gender
川崎病,2013,26,2013-W26,2,1,3,261,gender
インフルエンザ,2012,48,2012-W48,72,56,128,418,gender
RSウイルス感染症,2012,48,2012-W48,62,48,110,263,gender
咽頭結膜熱,2012,48,2012-W48,76,68,144,263,gender
Ａ群溶血性レンサ球菌咽頭炎,2012,48,2012-W48,288,278,566,263,gender
感染性胃腸炎,2012,48,2012-W48,3220,2990,6210,263,gender
水痘,2012,48,2012-W48,174,169,343,263,gender
手足口病,2012,48,2012-W48,50,50,100,263,gender
突発性発しん,2012,48,2012-W48,80,87,167,263,gender
ヘルパンギーナ,2012,48,2012-W48,13,7,20,263,gender
流行性耳下腺炎,2012,48,2012-W48,36,20,56,263,gender
川崎病,2012,48,2012-W48,2,1,3,263,gender
インフルエンザ,2001,12,2001-W12,343,312,655,178,gender
RSウイルス感染症,2001,12,2001-W12,0,0,0,142,gender
咽頭結膜熱,2001,12,2001-W12,1,3,4,142,gender
Ａ群溶血性レンサ球菌咽頭炎,2001,12,2001-W12,24,29,53,142,gender
感染性胃腸炎,2001,12,2001-W12,412,374,786,142,gender
水痘,2001,12,2001-W12,88,83,171,142,gender
手足口病,2001,12,2001-W12,4,8,12,142,gender
突発性発しん,2001,12,2001-W12,42,24,66,142,gender
ヘルパンギーナ,2001,12,2001-W12,3,1,4,142,gender
流行性耳下腺炎,2001,12,2001-W12,68,62,130,142,gender
川崎病,2001,12,2001-W12,1,0,1,142,gender
インフルエンザ,2008,36,2008-W36,3,1,4,284,gender
RSウイルス感染症,2008,36,2008-W36,10,11,21,147,gender
咽頭結膜熱,2008,36,2008-W36,29,32,61,147,gender
Ａ群溶血性レンサ球菌咽頭炎,2008,36,2008-W36,72,56,128,147,gender
感染性胃腸炎,2008,36,2008-W36,244,221,465,147,gender
水痘,2008,36,2008-W36,35,29,64,147,gender
手足口病,2008,36,2008-W36,97,87,184,147,gender
突発性発しん,2008,36,2008-W36,68,60,128,147,gender
ヘルパンギーナ,2008,36,2008-W36,95,85,180,147,gender
流行性耳下腺炎,2008,36,2008-W36,27,22,49,147,gender
川崎病,2008,36,2008-W36,2,1,3,147,gender
インフルエンザ,2007,15,2007-W15,555,554,1109,284,gender
RSウイルス感染症,2007,15,2007-W15,6,4,10,147,gender
咽頭結膜熱,2007,15,2007-W15,17,18,35,147,gender
Ａ群溶血性レンサ球菌咽頭炎,2007,15,2007-W15,93,108,201,147,gender
感染性胃腸炎,2007,15,2007-W15,424,367,791,147,gender
水痘,2007,15,2007-W15,122,109,231,147,gender
手足口病,2007,15,2007-W15,6,4,10,147,gender
突発性発しん,2007,15,2007-W15,45,55,100,147,gender
ヘルパンギーナ,2007,15,2007-W15,0,2,2,147,gender
流行性耳下腺炎,2007,15,2007-W15,23,21,44,147,gender
川崎病,2007,15,2007-W15,1,0,1,147,gender
インフルエンザ,2015,21,2015-W21,27,25,52,412,gender
RSウイルス感染症,2015,21,2015-W21,13,5,18,260,gender
咽頭結膜熱,2015,21,2015-W21,107,76,183,260,gender
Ａ群溶血性レンサ球菌咽頭炎,2015,21,2015-W21,617,453,1070,260,gender
感染性胃腸炎,2015,21,2015-W21,993,889,1882,260,gender
水痘,2015,21,2015-W21,61,66,127,260,gender
手足口病,2015,21,2015-W21,92,56,148,260,gender
突発性発しん,2015,21,2015-W21,120,89,209,260,gender
ヘルパンギーナ,2015,21,2015-W21,31,19,50,260,gender
流行性耳下腺炎,2015,21,2015-W21,40,34,74,260,gender
川崎病,2015,21,2015-W21,1,0,1,260,gender
インフルエンザ,2015,9,2015-W09,825,869,1694,416,gender
RSウイルス感染症,2015,9,2015-W09,41,23,64,263,gender
咽頭結膜熱,2015,9,2015-W09,29,27,56,263,gender
Ａ群溶血性レンサ球菌咽頭炎,2015,9,2015-W09,414,398,812,263,gender
感染性胃腸炎,2015,9,2015-W09,1170,1184,2354,263,gender
水痘,2015,9,2015-W09,62,63,125,263,gender
手足口病,2015,9,2015-W09,15,11,26,263,gender
突発性発しん,2015,9,2015-W09,68,60,128,263,gender
ヘルパンギーナ,2015,9,2015-W09,2,0,2,263,gender
流行性耳下腺炎,2015,9,2015-W09,31,34,65,263,gender
川崎病,2015,9,2015-W09,3,3,6,263,gender
インフルエンザ,2017,52,2017-W52,3270,3451,6721,387,gender
RSウイルス感染症,2017,52,2017-W52,49,47,96,240,gender
咽頭結膜熱,2017,52,2017-W52,69,72,141,240,gender
Ａ群溶血性レンサ球菌咽頭炎,2017,52,2017-W52,288,313,601,240,gender
感染性胃腸炎,2017,52,2017-W52,1249,1261,2510,240,gender
水痘,2017,52,2017-W52,48,76,124,240,gender
手足口病,2017,52,2017-W52,27,32,59,240,gender
突発性発しん,2017,52,2017-W52,43,47,90,240,gender
ヘルパンギーナ,2017,52,2017-W52,0,2,2,240,gender
流行性耳下腺炎,2017,52,2017-W52,18,10,28,240,gender
川崎病,2017,52,2017-W52,3,3,6,240,gender
インフルエンザ,2010,5,2010-W05,507,481,988,288,gender
RSウイルス感染症,2010,5,2010-W05,75,66,141,148,gender
咽頭結膜熱,2010,5,2010-W05,5,4,9,148,gender
Ａ群溶血性レンサ球菌咽頭炎,2010,5,2010-W05,150,148,298,148,gender
感染性胃腸炎,2010,5,2010-W05,1021,964,1985,148,gender
水痘,2010,5,2010-W05,106,96,202,148,gender
手足口病,2010,5,2010-W05,12,5,17,148,gender
突発性発しん,2010,5,2010-W05,30,37,67,148,gender
ヘルパンギーナ,2010,5,2010-W05,2,1,3,148,gender
流行性耳下腺炎,2010,5,2010-W05,35,26,61,148,gender
川崎病,2010,5,2010-W05,1,1,2,148,gender
インフルエンザ,2016,33,2016-W33,2,2,4,392,gender
RSウイルス感染症,2016,33,2016-W33,56,44,100,243,gender
咽頭結膜熱,2016,33,2016-W33,33,20,53,243,gender
Ａ群溶血性レンサ球菌咽頭炎,2016,33,2016-W33,116,95,211,243,gender
感染性胃腸炎,2016,33,2016-W33,378,340,718,243,gender
水痘,2016,33,2016-W33,29,35,64,243,gender
手足口病,2016,33,2016-W33,61,68,129,243,gender
突発性発しん,2016,33,2016-W33,53,47,100,243,gender
ヘルパンギーナ,2016,33,2016-W33,171,188,359,243,gender
流行性耳下腺炎,2016,33,2016-W33,118,73,191,243,gender
川崎病,2016,33,2016-W33,0,0,0,243,gender
インフルエンザ,2008,39,2008-W39,5,5,10,285,gender
RSウイルス感染症,2008,39,2008-W39,33,23,56,147,gender
咽頭結膜熱,2008,39,2008-W39,21,12,33,147,gender
Ａ群溶血性レンサ球菌咽頭炎,2008,39,2008-W39,87,90,177,147,gender
感染性胃腸炎,2008,39,2008-W39,277,194,471,147,gender
水痘,2008,39,2008-W39,43,31,74,147,gender
手足口病,2008,39,2008-W39,100,75,175,147,gender
突発性発しん,2008,39,2008-W39,61,49,110,147,gender
ヘルパンギーナ,2008,39,2008-W39,60,41,101,147,gender
流行性耳下腺炎,2008,39,2008-W39,39,36,75,147,gender
川崎病,2008,39,2008-W39,3,1,4,147,gender
インフルエンザ,2024,15,2024-W15,407,412,819,418,gender
新型コロナウイルス感染症（COVID-19）,2024,15,2024-W15,468,542,1010,418,gender
RSウイルス感染症,2024,15,2024-W15,239,186,425,263,gender
咽頭結膜熱,2024,15,2024-W15,42,27,69,263,gender
Ａ群溶血性レンサ球菌咽頭炎,2024,15,2024-W15,390,361,751,263,gender
感染性胃腸炎,2024,15,2024-W15,530,501,1031,263,gender
水痘,2024,15,2024-W15,31,18,49,263,gender
手足口病,2024,15,2024-W15,7,4,11,263,gender
突発性発しん,2024,15,2024-W15,44,35,79,263,gender
ヘルパンギーナ,2024,15,2024-W15,3,1,4,263,gender
流行性耳下腺炎,2024,15,2024-W15,5,6,11,263,gender
川崎病,2024,15,2024-W15,4,3,7,263,gender
インフルエンザ,2014,40,2014-W40,14,17,31,411,gender
RSウイルス感染症,2014,40,2014-W40,127,84,211,262,gender
咽頭結膜熱,2014,40,2014-W40,28,25,53,262,gender
Ａ群溶血性レンサ球菌咽頭炎,2014,40,2014-W40,200,187,387,262,gender
感染性胃腸炎,2014,40,2014-W40,558,412,970,262,gender
水痘,2014,40,2014-W40,57,57,114,262,gender
手足口病,2014,40,2014-W40,109,85,194,262,gender
突発性発しん,2014,40,2014-W40,79,70,149,262,gender
ヘルパンギーナ,2014,40,2014-W40,83,64,147,262,gender
流行性耳下腺炎,2014,40,2014-W40,47,27,74,262,gender
川崎病,2014,40,2014-W40,0,3,3,262,gender
インフルエンザ,2019,10,2019-W10,455,465,920,415,gender
RSウイルス感染症,2019,10,2019-W10,32,22,54,261,gender
咽頭結膜熱,2019,10,2019-W10,22,15,37,261,gender
Ａ群溶血性レンサ球菌咽頭炎,2019,10,2019-W10,366,301,667,261,gender
感染性胃腸炎,2019,10,2019-W10,971,865,1836,261,gender
水痘,2019,10,2019-W10,49,34,83,261,gender
手足口病,2019,10,2019-W10,8,4,12,261,gender
突発性発しん,2019,10,2019-W10,46,56,102,261,gender
ヘルパンギーナ,2019,10,2019-W10,0,0,0,261,gender
流行性耳下腺炎,2019,10,2019-W10,16,10,26,261,gender
川崎病,2019,10,2019-W10,2,1,3,261,gender
インフルエンザ,2015,6,2015-W06,2385,2358,4743,415,gender
RSウイルス感染症,2015,6,2015-W06,51,49,100,261,gender
咽頭結膜熱,2015,6,2015-W06,33,23,56,261,gender
Ａ群溶血性レンサ球菌咽頭炎,2015,6,2015-W06,375,312,687,261,gender
感染性胃腸炎,2015,6,2015-W06,1015,953,1968,261,gender
水痘,2015,6,2015-W06,72,58,130,261,gender
手足口病,2015,6,2015-W06,11,11,22,261,gender
突発性発しん,2015,6,2015-W06,46,54,100,261,gender
ヘルパンギーナ,2015,6,2015-W06,0,1,1,261,gender
流行性耳下腺炎,2015,6,2015-W06,28,20,48,261,gender
川崎病,2015,6,2015-W06,5,2,7,261,gender
インフルエンザ,2013,29,2013-W29,5,6,11,413,gender
RSウイルス感染症,2013,29,2013-W29,35,18,53,262,gender
咽頭結膜熱,2013,29,2013-W29,108,80,188,262,gender
Ａ群溶血性レンサ球菌咽頭炎,2013,29,2013-W29,172,167,339,262,gender
感染性胃腸炎,2013,29,2013-W29,434,403,837,262,gender
水痘,2013,29,2013-W29,82,82,164,262,gender
手足口病,2013,29,2013-W29,1992,1601,3593,262,gender
突発性発しん,2013,29,2013-W29,107,96,203,262,gender
ヘルパンギーナ,2013,29,2013-W29,525,552,1077,262,gender
流行性耳下腺炎,2013,29,2013-W29,27,36,63,262,gender
川崎病,2013,29,2013-W29,2,1,3,262,gender
インフルエンザ,2010,34,2010-W34,4,3,7,279,gender
RSウイルス感染症,2010,34,2010-W34,3,4,7,146,gender
咽頭結膜熱,2010,34,2010-W34,18,21,39,146,gender
Ａ群溶血性レンサ球菌咽頭炎,2010,34,2010-W34,38,32,70,146,gender
感染性胃腸炎,2010,34,2010-W34,256,209,465,146,gender
水痘,2010,34,2010-W34,42,24,66,146,gender
手足口病,2010,34,2010-W34,93,83,176,146,gender
突発性発しん,2010,34,2010-W34,42,53,95,146,gender
ヘルパンギーナ,2010,34,2010-W34,57,66,123,146,gender
流行性耳下腺炎,2010,34,2010-W34,51,44,95,146,gender
川崎病,2010,34,2010-W34,1,0,1,146,gender
インフルエンザ,2012,47,2012-W47,43,57,100,417,gender
RSウイルス感染症,2012,47,2012-W47,77,73,150,263,gender
咽頭結膜熱,2012,47,2012-W47,51,48,99,263,gender
Ａ群溶血性レンサ球菌咽頭炎,2012,47,2012-W47,281,240,521,263,gender
感染性胃腸炎,2012,47,2012-W47,2089,2089,4178,263,gender
水痘,2012,47,2012-W47,187,149,336,263,gender
手足口病,2012,47,2012-W47,66,58,124,263,gender
突発性発しん,2012,47,2012-W47,81,71,152,263,gender
ヘルパンギーナ,2012,47,2012-W47,11,10,21,263,gender
流行性耳下腺炎,2012,47,2012-W47,34,22,56,263,gender
川崎病,2012,47,2012-W47,3,3,6,263,gender
インフルエンザ,2022,12,2022-W12,0,0,0,410,gender
RSウイルス感染症,2022,12,2022-W12,0,1,1,256,gender
咽頭結膜熱,2022,12,2022-W12,6,5,11,256,gender
Ａ群溶血性レンサ球菌咽頭炎,2022,12,2022-W12,9,17,26,256,gender
感染性胃腸炎,2022,12,2022-W12,443,377,820,256,gender
水痘,2022,12,2022-W12,6,3,9,256,gender
手足口病,2022,12,2022-W12,3,1,4,256,gender
突発性発しん,2022,12,2022-W12,33,38,71,256,gender
ヘルパンギーナ,2022,12,2022-W12,3,1,4,256,gender
流行性耳下腺炎,2022,12,2022-W12,2,3,5,256,gender
川崎病,2022,12,2022-W12,1,0,1,256,gender
インフルエンザ,2021,31,2021-W31,0,0,0,399,gender
RSウイルス感染症,2021,31,2021-W31,538,471,1009,252,gender
咽頭結膜熱,2021,31,2021-W31,18,14,32,252,gender
Ａ群溶血性レンサ球菌咽頭炎,2021,31,2021-W31,40,25,65,252,gender
感染性胃腸炎,2021,31,2021-W31,313,233,546,252,gender
水痘,2021,31,2021-W31,8,7,15,252,gender
手足口病,2021,31,2021-W31,5,7,12,252,gender
突発性発しん,2021,31,2021-W31,47,42,89,252,gender
ヘルパンギーナ,2021,31,2021-W31,25,23,48,252,gender
流行性耳下腺炎,2021,31,2021-W31,12,8,20,252,gender
川崎病,2021,31,2021-W31,4,5,9,252,gender
インフルエンザ,2013,17,2013-W17,224,204,428,409,gender
RSウイルス感染症,2013,17,2013-W17,16,16,32,260,gender
咽頭結膜熱,2013,17,2013-W17,61,55,116,260,gender
Ａ群溶血性レンサ球菌咽頭炎,2013,17,2013-W17,432,385,817,260,gender
感染性胃腸炎,2013,17,2013-W17,1205,1131,2336,260,gender
水痘,2013,17,2013-W17,122,98,220,260,gender
手足口病,2013,17,2013-W17,18,19,37,260,gender
突発性発しん,2013,17,2013-W17,120,98,218,260,gender
ヘルパンギーナ,2013,17,2013-W17,9,5,14,260,gender
流行性耳下腺炎,2013,17,2013-W17,24,16,40,260,gender
川崎病,2013,17,2013-W17,1,2,3,260,gender
インフルエンザ,2021,2,2021-W02,2,2,4,410,gender
RSウイルス感染症,2021,2,2021-W02,8,1,9,259,gender
咽頭結膜熱,2021,2,2021-W02,16,17,33,259,gender
Ａ群溶血性レンサ球菌咽頭炎,2021,2,2021-W02,48,36,84,259,gender
感染性胃腸炎,2021,2,2021-W02,414,314,728,259,gender
水痘,2021,2,2021-W02,16,12,28,259,gender
手足口病,2021,2,2021-W02,3,3,6,259,gender
突発性発しん,2021,2,2021-W02,58,47,105,259,gender
ヘルパンギーナ,2021,2,2021-W02,1,3,4,259,gender
流行性耳下腺炎,2021,2,2021-W02,6,7,13,259,gender
川崎病,2021,2,2021-W02,3,2,5,259,gender
インフルエンザ,2023,42,2023-W42,4754,4304,9058,416,gender
新型コロナウイルス感染症（COVID-19）,2023,42,2023-W42,387,432,819,416,gender
RSウイルス感染症,2023,42,2023-W42,8,7,15,261,gender
咽頭結膜熱,2023,42,2023-W42,348,282,630,261,gender
Ａ群溶血性レンサ球菌咽頭炎,2023,42,2023-W42,497,419,916,261,gender
感染性胃腸炎,2023,42,2023-W42,496,453,949,261,gender
水痘,2023,42,2023-W42,23,13,36,261,gender
手足口病,2023,42,2023-W42,173,144,317,261,gender
突発性発しん,2023,42,2023-W42,27,38,65,261,gender
ヘルパンギーナ,2023,42,2023-W42,30,21,51,261,gender
流行性耳下腺炎,2023,42,2023-W42,8,4,12,261,gender
川崎病,2023,42,2023-W42,3,2,5,261,gender
インフルエンザ,2001,23,2001-W23,0,0,0,178,gender
RSウイルス感染症,2001,23,2001-W23,0,0,0,142,gender
咽頭結膜熱,2001,23,2001-W23,10,7,17,142,gender
Ａ群溶血性レンサ球菌咽頭炎,2001,23,2001-W23,41,23,64,142,gender
感染性胃腸炎,2001,23,2001-W23,210,166,376,142,gender
水痘,2001,23,2001-W23,96,100,196,142,gender
手足口病,2001,23,2001-W23,30,22,52,142,gender
突発性発しん,2001,23,2001-W23,37,27,64,142,gender
ヘルパンギーナ,2001,23,2001-W23,38,30,68,142,gender
流行性耳下腺炎,2001,23,2001-W23,77,69,146,142,gender
川崎病,2001,23,2001-W23,1,0,1,142,gender
インフルエンザ,2002,1,2002-W01,3,5,8,178,gender
RSウイルス感染症,2002,1,2002-W01,0,0,0,142,gender
咽頭結膜熱,2002,1,2002-W01,1,1,2,142,gender
Ａ群溶血性レンサ球菌咽頭炎,2002,1,2002-W01,4,5,9,142,gender
感染性胃腸炎,2002,1,2002-W01,128,125,253,142,gender
水痘,2002,1,2002-W01,45,48,93,142,gender
手足口病,2002,1,2002-W01,1,0,1,142,gender
突発性発しん,2002,1,2002-W01,9,4,13,142,gender
ヘルパンギーナ,2002,1,2002-W01,1,1,2,142,gender
流行性耳下腺炎,2002,1,2002-W01,29,21,50,142,gender
川崎病,2002,1,2002-W01,0,0,0,142,gender
インフルエンザ,2003,50,2003-W50,28,28,56,178,gender
RSウイルス感染症,2003,50,2003-W50,4,10,14,142,gender
咽頭結膜熱,2003,50,2003-W50,20,12,32,142,gender
Ａ群溶血性レンサ球菌咽頭炎,2003,50,2003-W50,68,63,131,142,gender
感染性胃腸炎,2003,50,2003-W50,1023,1012,2035,142,gender
水痘,2003,50,2003-W50,105,130,235,142,gender
手足口病,2003,50,2003-W50,7,3,10,142,gender
突発性発しん,2003,50,2003-W50,35,38,73,142,gender
ヘルパンギーナ,2003,50,2003-W50,3,2,5,142,gender
流行性耳下腺炎,2003,50,2003-W50,15,12,27,142,gender
川崎病,2003,50,2003-W50,0,0,0,142,gender
インフルエンザ,2007,24,2007-W24,2,2,4,286,gender
RSウイルス感染症,2007,24,2007-W24,2,3,5,149,gender
咽頭結膜熱,2007,24,2007-W24,84,64,148,149,gender
Ａ群溶血性レンサ球菌咽頭炎,2007,24,2007-W24,204,172,376,149,gender
感染性胃腸炎,2007,24,2007-W24,518,464,982,149,gender
水痘,2007,24,2007-W24,183,132,315,149,gender
手足口病,2007,24,2007-W24,28,24,52,149,gender
突発性発しん,2007,24,2007-W24,61,50,111,149,gender
ヘルパンギーナ,2007,24,2007-W24,35,35,70,149,gender
流行性耳下腺炎,2007,24,2007-W24,34,25,59,149,gender
川崎病,2007,24,2007-W24,0,2,2,149,gender
インフルエンザ,2004,39,2004-W39,0,0,0,178,gender
RSウイルス感染症,2004,39,2004-W39,2,3,5,142,gender
咽頭結膜熱,2004,39,2004-W39,8,11,19,142,gender
Ａ群溶血性レンサ球菌咽頭炎,2004,39,2004-W39,15,10,25,142,gender
感染性胃腸炎,2004,39,2004-W39,147,125,272,142,gender
水痘,2004,39,2004-W39,19,23,42,142,gender
手足口病,2004,39,2004-W39,43,45,88,142,gender
突発性発しん,2004,39,2004-W39,56,58,114,142,gender
ヘルパンギーナ,2004,39,2004-W39,14,16,30,142,gender
流行性耳下腺炎,2004,39,2004-W39,31,28,59,142,gender
川崎病,2004,39,2004-W39,1,0,1,142,gender
インフルエンザ,2015,10,2015-W10,579,596,1175,414,gender
RSウイルス感染症,2015,10,2015-W10,30,23,53,262,gender
咽頭結膜熱,2015,10,2015-W10,28,19,47,262,gender
Ａ群溶血性レンサ球菌咽頭炎,2015,10,2015-W10,457,406,863,262,gender
感染性胃腸炎,2015,10,2015-W10,1165,1094,2259,262,gender
水痘,2015,10,2015-W10,90,66,156,262,gender
手足口病,2015,10,2015-W10,8,17,25,262,gender
突発性発しん,2015,10,2015-W10,74,69,143,262,gender
ヘルパンギーナ,2015,10,2015-W10,0,1,1,262,gender
流行性耳下腺炎,2015,10,2015-W10,26,23,49,262,gender
川崎病,2015,10,2015-W10,3,3,6,262,gender
インフルエンザ,2018,40,2018-W40,44,56,100,412,gender
RSウイルス感染症,2018,40,2018-W40,176,164,340,260,gender
咽頭結膜熱,2018,40,2018-W40,29,26,55,260,gender
Ａ群溶血性レンサ球菌咽頭炎,2018,40,2018-W40,232,173,405,260,gender
感染性胃腸炎,2018,40,2018-W40,584,489,1073,260,gender
水痘,2018,40,2018-W40,20,36,56,260,gender
手足口病,2018,40,2018-W40,273,210,483,260,gender
突発性発しん,2018,40,2018-W40,63,73,136,260,gender
ヘルパンギーナ,2018,40,2018-W40,96,72,168,260,gender
流行性耳下腺炎,2018,40,2018-W40,14,16,30,260,gender
川崎病,2018,40,2018-W40,1,1,2,260,gender
インフルエンザ,2020,10,2020-W10,504,464,968,415,gender
RSウイルス感染症,2020,10,2020-W10,22,25,47,261,gender
咽頭結膜熱,2020,10,2020-W10,32,30,62,261,gender
Ａ群溶血性レンサ球菌咽頭炎,2020,10,2020-W10,409,348,757,261,gender
感染性胃腸炎,2020,10,2020-W10,521,549,1070,261,gender
水痘,2020,10,2020-W10,50,46,96,261,gender
手足口病,2020,10,2020-W10,9,5,14,261,gender
突発性発しん,2020,10,2020-W10,45,27,72,261,gender
ヘルパンギーナ,2020,10,2020-W10,3,6,9,261,gender
流行性耳下腺炎,2020,10,2020-W10,9,7,16,261,gender
川崎病,2020,10,2020-W10,0,0,0,261,gender
インフルエンザ,2010,45,2010-W45,57,50,107,287,gender
RSウイルス感染症,2010,45,2010-W45,38,22,60,149,gender
咽頭結膜熱,2010,45,2010-W45,28,23,51,149,gender
Ａ群溶血性レンサ球菌咽頭炎,2010,45,2010-W45,142,108,250,149,gender
感染性胃腸炎,2010,45,2010-W45,695,647,1342,149,gender
水痘,2010,45,2010-W45,84,72,156,149,gender
手足口病,2010,45,2010-W45,41,31,72,149,gender
突発性発しん,2010,45,2010-W45,34,30,64,149,gender
ヘルパンギーナ,2010,45,2010-W45,9,8,17,149,gender
流行性耳下腺炎,2010,45,2010-W45,53,29,82,149,gender
川崎病,2010,45,2010-W45,2,1,3,149,gender
インフルエンザ,2012,36,2012-W36,21,22,43,411,gender
RSウイルス感染症,2012,36,2012-W36,169,148,317,261,gender
咽頭結膜熱,2012,36,2012-W36,62,53,115,261,gender
Ａ群溶血性レンサ球菌咽頭炎,2012,36,2012-W36,143,99,242,261,gender
感染性胃腸炎,2012,36,2012-W36,505,435,940,261,gender
水痘,2012,36,2012-W36,60,54,114,261,gender
手足口病,2012,36,2012-W36,85,69,154,261,gender
突発性発しん,2012,36,2012-W36,133,100,233,261,gender
ヘルパンギーナ,2012,36,2012-W36,134,128,262,261,gender
流行性耳下腺炎,2012,36,2012-W36,36,21,57,261,gender
川崎病,2012,36,2012-W36,1,0,1,261,gender
インフルエンザ,2018,5,2018-W05,11378,10726,22104,416,gender
RSウイルス感染症,2018,5,2018-W05,46,37,83,263,gender
咽頭結膜熱,2018,5,2018-W05,23,22,45,263,gender
Ａ群溶血性レンサ球菌咽頭炎,2018,5,2018-W05,315,310,625,263,gender
感染性胃腸炎,2018,5,2018-W05,772,746,1518,263,gender
水痘,2018,5,2018-W05,39,32,71,263,gender
手足口病,2018,5,2018-W05,11,9,20,263,gender
突発性発しん,2018,5,2018-W05,34,42,76,263,gender
ヘルパンギーナ,2018,5,2018-W05,2,1,3,263,gender
流行性耳下腺炎,2018,5,2018-W05,12,7,19,263,gender
川崎病,2018,5,2018-W05,0,1,1,263,gender
インフルエンザ,2009,26,2009-W26,15,9,24,287,gender
RSウイルス感染症,2009,26,2009-W26,6,1,7,150,gender
咽頭結膜熱,2009,26,2009-W26,24,23,47,150,gender
Ａ群溶血性レンサ球菌咽頭炎,2009,26,2009-W26,121,88,209,150,gender
感染性胃腸炎,2009,26,2009-W26,342,311,653,150,gender
水痘,2009,26,2009-W26,82,80,162,150,gender
手足口病,2009,26,2009-W26,37,23,60,150,gender
突発性発しん,2009,26,2009-W26,64,81,145,150,gender
ヘルパンギーナ,2009,26,2009-W26,13,9,22,150,gender
流行性耳下腺炎,2009,26,2009-W26,77,63,140,150,gender
川崎病,2009,26,2009-W26,2,1,3,150,gender
インフルエンザ,2016,7,2016-W07,6262,6151,12413,415,gender
RSウイルス感染症,2016,7,2016-W07,16,16,32,261,gender
咽頭結膜熱,2016,7,2016-W07,25,27,52,261,gender
Ａ群溶血性レンサ球菌咽頭炎,2016,7,2016-W07,365,373,738,261,gender
感染性胃腸炎,2016,7,2016-W07,954,935,1889,261,gender
水痘,2016,7,2016-W07,53,45,98,261,gender
手足口病,2016,7,2016-W07,4,4,8,261,gender
突発性発しん,2016,7,2016-W07,61,50,111,261,gender
ヘルパンギーナ,2016,7,2016-W07,1,0,1,261,gender
流行性耳下腺炎,2016,7,2016-W07,85,80,165,261,gender
川崎病,2016,7,2016-W07,3,2,5,261,gender
インフルエンザ,2016,42,2016-W42,59,67,126,412,gender
RSウイルス感染症,2016,42,2016-W42,229,207,436,261,gender
咽頭結膜熱,2016,42,2016-W42,39,23,62,261,gender
Ａ群溶血性レンサ球菌咽頭炎,2016,42,2016-W42,275,216,491,261,gender
感染性胃腸炎,2016,42,2016-W42,717,621,1338,261,gender
水痘,2016,42,2016-W42,41,50,91,261,gender
手足口病,2016,42,2016-W42,197,174,371,261,gender
突発性発しん,2016,42,2016-W42,69,61,130,261,gender
ヘルパンギーナ,2016,42,2016-W42,73,71,144,261,gender
流行性耳下腺炎,2016,42,2016-W42,124,123,247,261,gender
川崎病,2016,42,2016-W42,1,2,3,261,gender
インフルエンザ,2005,18,2005-W18,24,17,41,178,gender
RSウイルス感染症,2005,18,2005-W18,3,4,7,142,gender
咽頭結膜熱,2005,18,2005-W18,22,13,35,142,gender
Ａ群溶血性レンサ球菌咽頭炎,2005,18,2005-W18,60,49,109,142,gender
感染性胃腸炎,2005,18,2005-W18,256,215,471,142,gender
水痘,2005,18,2005-W18,95,69,164,142,gender
手足口病,2005,18,2005-W18,14,3,17,142,gender
突発性発しん,2005,18,2005-W18,34,17,51,142,gender
ヘルパンギーナ,2005,18,2005-W18,8,3,11,142,gender
流行性耳下腺炎,2005,18,2005-W18,53,47,100,142,gender
川崎病,2005,18,2005-W18,1,0,1,142,gender
インフルエンザ,2008,48,2008-W48,83,101,184,284,gender
RSウイルス感染症,2008,48,2008-W48,40,50,90,147,gender
咽頭結膜熱,2008,48,2008-W48,25,20,45,147,gender
Ａ群溶血性レンサ球菌咽頭炎,2008,48,2008-W48,130,98,228,147,gender
感染性胃腸炎,2008,48,2008-W48,811,781,1592,147,gender
水痘,2008,48,2008-W48,98,85,183,147,gender
手足口病,2008,48,2008-W48,24,28,52,147,gender
突発性発しん,2008,48,2008-W48,39,33,72,147,gender
ヘルパンギーナ,2008,48,2008-W48,6,6,12,147,gender
流行性耳下腺炎,2008,48,2008-W48,42,43,85,147,gender
川崎病,2008,48,2008-W48,1,0,1,147,gender
インフルエンザ,2014,31,2014-W31,2,2,4,415,gender
RSウイルス感染症,2014,31,2014-W31,18,9,27,262,gender
咽頭結膜熱,2014,31,2014-W31,67,68,135,262,gender
Ａ群溶血性レンサ球菌咽頭炎,2014,31,2014-W31,156,132,288,262,gender
感染性胃腸炎,2014,31,2014-W31,527,437,964,262,gender
水痘,2014,31,2014-W31,82,56,138,262,gender
手足口病,2014,31,2014-W31,179,170,349,262,gender
突発性発しん,2014,31,2014-W31,81,94,175,262,gender
ヘルパンギーナ,2014,31,2014-W31,945,924,1869,262,gender
流行性耳下腺炎,2014,31,2014-W31,42,43,85,262,gender
川崎病,2014,31,2014-W31,1,0,1,262,gender
インフルエンザ,2017,12,2017-W12,1461,1547,3008,414,gender
RSウイルス感染症,2017,12,2017-W12,15,11,26,261,gender
咽頭結膜熱,2017,12,2017-W12,26,26,52,261,gender
Ａ群溶血性レンサ球菌咽頭炎,2017,12,2017-W12,209,206,415,261,gender
感染性胃腸炎,2017,12,2017-W12,934,824,1758,261,gender
水痘,2017,12,2017-W12,46,29,75,261,gender
手足口病,2017,12,2017-W12,3,6,9,261,gender
突発性発しん,2017,12,2017-W12,54,45,99,261,gender
ヘルパンギーナ,2017,12,2017-W12,1,0,1,261,gender
流行性耳下腺炎,2017,12,2017-W12,38,21,59,261,gender
川崎病,2017,12,2017-W12,3,0,3,261,gender
インフルエンザ,2004,48,2004-W48,28,30,58,178,gender
RSウイルス感染症,2004,48,2004-W48,11,11,22,142,gender
咽頭結膜熱,2004,48,2004-W48,9,5,14,142,gender
Ａ群溶血性レンサ球菌咽頭炎,2004,48,2004-W48,41,41,82,142,gender
感染性胃腸炎,2004,48,2004-W48,463,411,874,142,gender
水痘,2004,48,2004-W48,75,76,151,142,gender
手足口病,2004,48,2004-W48,69,67,136,142,gender
突発性発しん,2004,48,2004-W48,42,30,72,142,gender
ヘルパンギーナ,2004,48,2004-W48,4,1,5,142,gender
流行性耳下腺炎,2004,48,2004-W48,53,40,93,142,gender
川崎病,2004,48,2004-W48,1,1,2,142,gender
インフルエンザ,2009,18,2009-W18,230,244,474,283,gender
RSウイルス感染症,2009,18,2009-W18,0,0,0,147,gender
咽頭結膜熱,2009,18,2009-W18,16,16,32,147,gender
Ａ群溶血性レンサ球菌咽頭炎,2009,18,2009-W18,136,141,277,147,gender
感染性胃腸炎,2009,18,2009-W18,515,501,1016,147,gender
水痘,2009,18,2009-W18,67,66,133,147,gender
手足口病,2009,18,2009-W18,6,6,12,147,gender
突発性発しん,2009,18,2009-W18,55,44,99,147,gender
ヘルパンギーナ,2009,18,2009-W18,4,2,6,147,gender
流行性耳下腺炎,2009,18,2009-W18,54,52,106,147,gender
川崎病,2009,18,2009-W18,1,0,1,147,gender
インフルエンザ,2018,31,2018-W31,2,8,10,411,gender
RSウイルス感染症,2018,31,2018-W31,216,156,372,258,gender
咽頭結膜熱,2018,31,2018-W31,59,39,98,258,gender
Ａ群溶血性レンサ球菌咽頭炎,2018,31,2018-W31,212,192,404,258,gender
感染性胃腸炎,2018,31,2018-W31,538,475,1013,258,gender
水痘,2018,31,2018-W31,23,30,53,258,gender
手足口病,2018,31,2018-W31,152,146,298,258,gender
突発性発しん,2018,31,2018-W31,67,72,139,258,gender
ヘルパンギーナ,2018,31,2018-W31,462,446,908,258,gender
流行性耳下腺炎,2018,31,2018-W31,7,14,21,258,gender
川崎病,2018,31,2018-W31,2,3,5,258,gender
インフルエンザ,2005,26,2005-W26,0,0,0,178,gender
RSウイルス感染症,2005,26,2005-W26,6,7,13,142,gender
咽頭結膜熱,2005,26,2005-W26,65,50,115,142,gender
Ａ群溶血性レンサ球菌咽頭炎,2005,26,2005-W26,100,74,174,142,gender
感染性胃腸炎,2005,26,2005-W26,249,221,470,142,gender
水痘,2005,26,2005-W26,111,85,196,142,gender
手足口病,2005,26,2005-W26,151,100,251,142,gender
突発性発しん,2005,26,2005-W26,46,46,92,142,gender
ヘルパンギーナ,2005,26,2005-W26,422,412,834,142,gender
流行性耳下腺炎,2005,26,2005-W26,73,64,137,142,gender
川崎病,2005,26,2005-W26,0,0,0,142,gender
インフルエンザ,2001,52,2001-W52,10,16,26,178,gender
RSウイルス感染症,2001,52,2001-W52,0,0,0,142,gender
咽頭結膜熱,2001,52,2001-W52,1,2,3,142,gender
Ａ群溶血性レンサ球菌咽頭炎,2001,52,2001-W52,37,41,78,142,gender
感染性胃腸炎,2001,52,2001-W52,654,652,1306,142,gender
水痘,2001,52,2001-W52,117,95,212,142,gender
手足口病,2001,52,2001-W52,6,10,16,142,gender
突発性発しん,2001,52,2001-W52,38,19,57,142,gender
ヘルパンギーナ,2001,52,2001-W52,5,3,8,142,gender
流行性耳下腺炎,2001,52,2001-W52,53,43,96,142,gender
川崎病,2001,52,2001-W52,0,2,2,142,gender
インフルエンザ,2022,3,2022-W03,3,0,3,403,gender
RSウイルス感染症,2022,3,2022-W03,7,5,12,253,gender
咽頭結膜熱,2022,3,2022-W03,8,12,20,253,gender
Ａ群溶血性レンサ球菌咽頭炎,2022,3,2022-W03,34,28,62,253,gender
感染性胃腸炎,2022,3,2022-W03,1323,1207,2530,253,gender
水痘,2022,3,2022-W03,13,7,20,253,gender
手足口病,2022,3,2022-W03,21,28,49,253,gender
突発性発しん,2022,3,2022-W03,32,29,61,253,gender
ヘルパンギーナ,2022,3,2022-W03,1,6,7,253,gender
流行性耳下腺炎,2022,3,2022-W03,5,3,8,253,gender
川崎病,2022,3,2022-W03,0,2,2,253,gender
インフルエンザ,2003,21,2003-W21,0,0,0,178,gender
RSウイルス感染症,2003,21,2003-W21,0,0,0,142,gender
咽頭結膜熱,2003,21,2003-W21,16,15,31,142,gender
Ａ群溶血性レンサ球菌咽頭炎,2003,21,2003-W21,80,69,149,142,gender
感染性胃腸炎,2003,21,2003-W21,319,267,586,142,gender
水痘,2003,21,2003-W21,66,65,131,142,gender
手足口病,2003,21,2003-W21,49,51,100,142,gender
突発性発しん,2003,21,2003-W21,37,46,83,142,gender
ヘルパンギーナ,2003,21,2003-W21,11,7,18,142,gender
流行性耳下腺炎,2003,21,2003-W21,12,14,26,142,gender
川崎病,2003,21,2003-W21,1,4,5,142,gender
インフルエンザ,2021,40,2021-W40,0,0,0,413,gender
RSウイルス感染症,2021,40,2021-W40,9,17,26,260,gender
咽頭結膜熱,2021,40,2021-W40,16,7,23,260,gender
Ａ群溶血性レンサ球菌咽頭炎,2021,40,2021-W40,35,23,58,260,gender
感染性胃腸炎,2021,40,2021-W40,351,267,618,260,gender
水痘,2021,40,2021-W40,17,9,26,260,gender
手足口病,2021,40,2021-W40,37,25,62,260,gender
突発性発しん,2021,40,2021-W40,52,51,103,260,gender
ヘルパンギーナ,2021,40,2021-W40,90,80,170,260,gender
流行性耳下腺炎,2021,40,2021-W40,11,4,15,260,gender
川崎病,2021,40,2021-W40,3,3,6,260,gender
インフルエンザ,2011,15,2011-W15,1090,1008,2098,417,gender
RSウイルス感染症,2011,15,2011-W15,13,11,24,262,gender
咽頭結膜熱,2011,15,2011-W15,19,21,40,262,gender
Ａ群溶血性レンサ球菌咽頭炎,2011,15,2011-W15,358,253,611,262,gender
感染性胃腸炎,2011,15,2011-W15,1192,1010,2202,262,gender
水痘,2011,15,2011-W15,125,103,228,262,gender
手足口病,2011,15,2011-W15,8,9,17,262,gender
突発性発しん,2011,15,2011-W15,93,100,193,262,gender
ヘルパンギーナ,2011,15,2011-W15,0,4,4,262,gender
流行性耳下腺炎,2011,15,2011-W15,45,32,77,262,gender
川崎病,2011,15,2011-W15,2,1,3,262,gender
インフルエンザ,2023,33,2023-W33,191,184,375,401,gender
新型コロナウイルス感染症（COVID-19）,2023,33,2023-W33,1954,2449,4403,401,gender
RSウイルス感染症,2023,33,2023-W33,37,53,90,250,gender
咽頭結膜熱,2023,33,2023-W33,75,79,154,250,gender
Ａ群溶血性レンサ球菌咽頭炎,2023,33,2023-W33,110,95,205,250,gender
感染性胃腸炎,2023,33,2023-W33,331,283,614,250,gender
水痘,2023,33,2023-W33,10,13,23,250,gender
手足口病,2023,33,2023-W33,65,48,113,250,gender
突発性発しん,2023,33,2023-W33,22,27,49,250,gender
ヘルパンギーナ,2023,33,2023-W33,65,71,136,250,gender
流行性耳下腺炎,2023,33,2023-W33,4,3,7,250,gender
川崎病,2023,33,2023-W33,3,1,4,250,gender
インフルエンザ,2008,2,2008-W02,790,741,1531,288,gender
RSウイルス感染症,2008,2,2008-W02,28,16,44,148,gender
咽頭結膜熱,2008,2,2008-W02,19,18,37,148,gender
Ａ群溶血性レンサ球菌咽頭炎,2008,2,2008-W02,85,82,167,148,gender
感染性胃腸炎,2008,2,2008-W02,860,829,1689,148,gender
水痘,2008,2,2008-W02,180,147,327,148,gender
手足口病,2008,2,2008-W02,4,10,14,148,gender
突発性発しん,2008,2,2008-W02,44,35,79,148,gender
ヘルパンギーナ,2008,2,2008-W02,2,2,4,148,gender
流行性耳下腺炎,2008,2,2008-W02,23,29,52,148,gender
川崎病,2008,2,2008-W02,4,2,6,148,gender
インフルエンザ,2002,18,2002-W18,6,6,12,178,gender
RSウイルス感染症,2002,18,2002-W18,0,0,0,142,gender
咽頭結膜熱,2002,18,2002-W18,3,2,5,142,gender
Ａ群溶血性レンサ球菌咽頭炎,2002,18,2002-W18,32,35,67,142,gender
感染性胃腸炎,2002,18,2002-W18,179,170,349,142,gender
水痘,2002,18,2002-W18,50,47,97,142,gender
手足口病,2002,18,2002-W18,9,9,18,142,gender
突発性発しん,2002,18,2002-W18,20,20,40,142,gender
ヘルパンギーナ,2002,18,2002-W18,6,10,16,142,gender
流行性耳下腺炎,2002,18,2002-W18,25,34,59,142,gender
川崎病,2002,18,2002-W18,0,0,0,142,gender
インフルエンザ,2013,31,2013-W31,1,8,9,410,gender
RSウイルス感染症,2013,31,2013-W31,51,42,93,259,gender
咽頭結膜熱,2013,31,2013-W31,82,60,142,259,gender
Ａ群溶血性レンサ球菌咽頭炎,2013,31,2013-W31,147,113,260,259,gender
感染性胃腸炎,2013,31,2013-W31,475,394,869,259,gender
水痘,2013,31,2013-W31,76,70,146,259,gender
手足口病,2013,31,2013-W31,2012,1636,3648,259,gender
突発性発しん,2013,31,2013-W31,89,82,171,259,gender
ヘルパンギーナ,2013,31,2013-W31,514,523,1037,259,gender
流行性耳下腺炎,2013,31,2013-W31,31,28,59,259,gender
川崎病,2013,31,2013-W31,1,1,2,259,gender
インフルエンザ,2011,42,2011-W42,10,5,15,415,gender
RSウイルス感染症,2011,42,2011-W42,80,48,128,260,gender
咽頭結膜熱,2011,42,2011-W42,15,14,29,260,gender
Ａ群溶血性レンサ球菌咽頭炎,2011,42,2011-W42,188,161,349,260,gender
感染性胃腸炎,2011,42,2011-W42,472,435,907,260,gender
水痘,2011,42,2011-W42,97,95,192,260,gender
手足口病,2011,42,2011-W42,140,116,256,260,gender
突発性発しん,2011,42,2011-W42,99,78,177,260,gender
ヘルパンギーナ,2011,42,2011-W42,41,30,71,260,gender
流行性耳下腺炎,2011,42,2011-W42,50,43,93,260,gender
川崎病,2011,42,2011-W42,1,2,3,260,gender
インフルエンザ,2021,17,2021-W17,0,0,0,404,gender
RSウイルス感染症,2021,17,2021-W17,42,39,81,257,gender
咽頭結膜熱,2021,17,2021-W17,15,12,27,257,gender
Ａ群溶血性レンサ球菌咽頭炎,2021,17,2021-W17,51,40,91,257,gender
感染性胃腸炎,2021,17,2021-W17,514,485,999,257,gender
水痘,2021,17,2021-W17,18,19,37,257,gender
手足口病,2021,17,2021-W17,1,5,6,257,gender
突発性発しん,2021,17,2021-W17,86,59,145,257,gender
ヘルパンギーナ,2021,17,2021-W17,1,2,3,257,gender
流行性耳下腺炎,2021,17,2021-W17,5,8,13,257,gender
川崎病,2021,17,2021-W17,0,1,1,257,gender
インフルエンザ,2015,36,2015-W36,8,12,20,414,gender
RSウイルス感染症,2015,36,2015-W36,95,77,172,261,gender
咽頭結膜熱,2015,36,2015-W36,52,43,95,261,gender
Ａ群溶血性レンサ球菌咽頭炎,2015,36,2015-W36,209,159,368,261,gender
感染性胃腸炎,2015,36,2015-W36,516,466,982,261,gender
水痘,2015,36,2015-W36,21,25,46,261,gender
手足口病,2015,36,2015-W36,647,551,1198,261,gender
突発性発しん,2015,36,2015-W36,99,82,181,261,gender
ヘルパンギーナ,2015,36,2015-W36,134,155,289,261,gender
流行性耳下腺炎,2015,36,2015-W36,53,27,80,261,gender
川崎病,2015,36,2015-W36,1,1,2,261,gender
インフルエンザ,2017,45,2017-W45,101,125,226,418,gender
RSウイルス感染症,2017,45,2017-W45,54,31,85,263,gender
咽頭結膜熱,2017,45,2017-W45,89,76,165,263,gender
Ａ群溶血性レンサ球菌咽頭炎,2017,45,2017-W45,367,329,696,263,gender
感染性胃腸炎,2017,45,2017-W45,742,642,1384,263,gender
水痘,2017,45,2017-W45,86,71,157,263,gender
手足口病,2017,45,2017-W45,196,173,369,263,gender
突発性発しん,2017,45,2017-W45,67,71,138,263,gender
ヘルパンギーナ,2017,45,2017-W45,35,37,72,263,gender
流行性耳下腺炎,2017,45,2017-W45,32,16,48,263,gender
川崎病,2017,45,2017-W45,2,3,5,263,gender
インフルエンザ,2008,21,2008-W21,13,23,36,288,gender
RSウイルス感染症,2008,21,2008-W21,2,2,4,149,gender
咽頭結膜熱,2008,21,2008-W21,39,32,71,149,gender
Ａ群溶血性レンサ球菌咽頭炎,2008,21,2008-W21,253,180,433,149,gender
感染性胃腸炎,2008,21,2008-W21,596,479,1075,149,gender
水痘,2008,21,2008-W21,99,99,198,149,gender
手足口病,2008,21,2008-W21,14,10,24,149,gender
突発性発しん,2008,21,2008-W21,51,57,108,149,gender
ヘルパンギーナ,2008,21,2008-W21,21,12,33,149,gender
流行性耳下腺炎,2008,21,2008-W21,35,28,63,149,gender
川崎病,2008,21,2008-W21,3,2,5,149,gender
インフルエンザ,2025,3,2025-W03,2131,2166,4297,418,gender
新型コロナウイルス感染症（COVID-19）,2025,3,2025-W03,564,646,1210,418,gender
RSウイルス感染症,2025,3,2025-W03,48,45,93,263,gender
咽頭結膜熱,2025,3,2025-W03,16,11,27,263,gender
Ａ群溶血性レンサ球菌咽頭炎,2025,3,2025-W03,253,211,464,263,gender
感染性胃腸炎,2025,3,2025-W03,849,723,1572,263,gender
水痘,2025,3,2025-W03,32,25,57,263,gender
手足口病,2025,3,2025-W03,8,11,19,263,gender
突発性発しん,2025,3,2025-W03,33,20,53,263,gender
ヘルパンギーナ,2025,3,2025-W03,2,1,3,263,gender
流行性耳下腺炎,2025,3,2025-W03,4,3,7,263,gender
川崎病,2025,3,2025-W03,0,2,2,263,gender
インフルエンザ,2004,21,2004-W21,0,0,0,178,gender
RSウイルス感染症,2004,21,2004-W21,2,1,3,142,gender
咽頭結膜熱,2004,21,2004-W21,20,19,39,142,gender
Ａ群溶血性レンサ球菌咽頭炎,2004,21,2004-W21,85,80,165,142,gender
感染性胃腸炎,2004,21,2004-W21,327,295,622,142,gender
水痘,2004,21,2004-W21,113,79,192,142,gender
手足口病,2004,21,2004-W21,5,6,11,142,gender
突発性発しん,2004,21,2004-W21,48,59,107,142,gender
ヘルパンギーナ,2004,21,2004-W21,15,18,33,142,gender
流行性耳下腺炎,2004,21,2004-W21,36,33,69,142,gender
川崎病,2004,21,2004-W21,0,0,0,142,gender
インフルエンザ,2006,52,2006-W52,2,9,11,178,gender
RSウイルス感染症,2006,52,2006-W52,81,76,157,142,gender
咽頭結膜熱,2006,52,2006-W52,21,20,41,142,gender
Ａ群溶血性レンサ球菌咽頭炎,2006,52,2006-W52,65,79,144,142,gender
感染性胃腸炎,2006,52,2006-W52,792,822,1614,142,gender
水痘,2006,52,2006-W52,128,117,245,142,gender
手足口病,2006,52,2006-W52,13,13,26,142,gender
突発性発しん,2006,52,2006-W52,38,15,53,142,gender
ヘルパンギーナ,2006,52,2006-W52,3,2,5,142,gender
流行性耳下腺炎,2006,52,2006-W52,24,22,46,142,gender
川崎病,2006,52,2006-W52,0,1,1,142,gender
インフルエンザ,2019,36,2019-W36,100,102,202,414,gender
RSウイルス感染症,2019,36,2019-W36,368,316,684,260,gender
咽頭結膜熱,2019,36,2019-W36,54,37,91,260,gender
Ａ群溶血性レンサ球菌咽頭炎,2019,36,2019-W36,196,173,369,260,gender
感染性胃腸炎,2019,36,2019-W36,559,448,1007,260,gender
水痘,2019,36,2019-W36,18,21,39,260,gender
手足口病,2019,36,2019-W36,362,320,682,260,gender
突発性発しん,2019,36,2019-W36,69,64,133,260,gender
ヘルパンギーナ,2019,36,2019-W36,269,236,505,260,gender
流行性耳下腺炎,2019,36,2019-W36,10,8,18,260,gender
川崎病,2019,36,2019-W36,1,1,2,260,gender
インフルエンザ,2024,33,2024-W33,28,34,62,370,gender
新型コロナウイルス感染症（COVID-19）,2024,33,2024-W33,625,717,1342,370,gender
RSウイルス感染症,2024,33,2024-W33,20,30,50,229,gender
咽頭結膜熱,2024,33,2024-W33,12,15,27,229,gender
Ａ群溶血性レンサ球菌咽頭炎,2024,33,2024-W33,116,103,219,229,gender
感染性胃腸炎,2024,33,2024-W33,219,179,398,229,gender
水痘,2024,33,2024-W33,14,9,23,229,gender
手足口病,2024,33,2024-W33,558,429,987,229,gender
突発性発しん,2024,33,2024-W33,22,22,44,229,gender
ヘルパンギーナ,2024,33,2024-W33,62,48,110,229,gender
流行性耳下腺炎,2024,33,2024-W33,5,3,8,229,gender
川崎病,2024,33,2024-W33,1,2,3,229,gender
インフルエンザ,2016,15,2016-W15,732,737,1469,411,gender
RSウイルス感染症,2016,15,2016-W15,18,16,34,257,gender
咽頭結膜熱,2016,15,2016-W15,23,17,40,257,gender
Ａ群溶血性レンサ球菌咽頭炎,2016,15,2016-W15,411,311,722,257,gender
感染性胃腸炎,2016,15,2016-W15,807,720,1527,257,gender
水痘,2016,15,2016-W15,37,31,68,257,gender
手足口病,2016,15,2016-W15,6,2,8,257,gender
突発性発しん,2016,15,2016-W15,62,69,131,257,gender
ヘルパンギーナ,2016,15,2016-W15,1,3,4,257,gender
流行性耳下腺炎,2016,15,2016-W15,58,50,108,257,gender
川崎病,2016,15,2016-W15,1,2,3,257,gender
インフルエンザ,2003,48,2003-W48,5,2,7,178,gender
RSウイルス感染症,2003,48,2003-W48,2,2,4,142,gender
咽頭結膜熱,2003,48,2003-W48,11,11,22,142,gender
Ａ群溶血性レンサ球菌咽頭炎,2003,48,2003-W48,76,52,128,142,gender
感染性胃腸炎,2003,48,2003-W48,734,646,1380,142,gender
水痘,2003,48,2003-W48,109,94,203,142,gender
手足口病,2003,48,2003-W48,15,9,24,142,gender
突発性発しん,2003,48,2003-W48,37,36,73,142,gender
ヘルパンギーナ,2003,48,2003-W48,4,6,10,142,gender
流行性耳下腺炎,2003,48,2003-W48,12,5,17,142,gender
川崎病,2003,48,2003-W48,2,1,3,142,gender
インフルエンザ,2022,34,2022-W34,3,2,5,409,gender
RSウイルス感染症,2022,34,2022-W34,204,163,367,256,gender
咽頭結膜熱,2022,34,2022-W34,6,4,10,256,gender
Ａ群溶血性レンサ球菌咽頭炎,2022,34,2022-W34,16,12,28,256,gender
感染性胃腸炎,2022,34,2022-W34,274,230,504,256,gender
水痘,2022,34,2022-W34,9,3,12,256,gender
手足口病,2022,34,2022-W34,706,618,1324,256,gender
突発性発しん,2022,34,2022-W34,39,34,73,256,gender
ヘルパンギーナ,2022,34,2022-W34,180,190,370,256,gender
流行性耳下腺炎,2022,34,2022-W34,7,5,12,256,gender
川崎病,2022,34,2022-W34,1,2,3,256,gender
インフルエンザ,2010,12,2010-W12,14,13,27,287,gender
RSウイルス感染症,2010,12,2010-W12,10,14,24,148,gender
咽頭結膜熱,2010,12,2010-W12,6,5,11,148,gender
Ａ群溶血性レンサ球菌咽頭炎,2010,12,2010-W12,115,96,211,148,gender
感染性胃腸炎,2010,12,2010-W12,574,578,1152,148,gender
水痘,2010,12,2010-W12,117,113,230,148,gender
手足口病,2010,12,2010-W12,17,13,30,148,gender
突発性発しん,2010,12,2010-W12,41,33,74,148,gender
ヘルパンギーナ,2010,12,2010-W12,2,8,10,148,gender
流行性耳下腺炎,2010,12,2010-W12,65,34,99,148,gender
川崎病,2010,12,2010-W12,0,1,1,148,gender
インフルエンザ,2011,7,2011-W07,3452,3420,6872,418,gender
RSウイルス感染症,2011,7,2011-W07,33,24,57,263,gender
咽頭結膜熱,2011,7,2011-W07,46,39,85,263,gender
Ａ群溶血性レンサ球菌咽頭炎,2011,7,2011-W07,350,305,655,263,gender
感染性胃腸炎,2011,7,2011-W07,1477,1306,2783,263,gender
水痘,2011,7,2011-W07,161,141,302,263,gender
手足口病,2011,7,2011-W07,10,5,15,263,gender
突発性発しん,2011,7,2011-W07,72,82,154,263,gender
ヘルパンギーナ,2011,7,2011-W07,0,1,1,263,gender
流行性耳下腺炎,2011,7,2011-W07,40,38,78,263,gender
川崎病,2011,7,2011-W07,1,1,2,263,gender
インフルエンザ,2020,47,2020-W47,2,3,5,407,gender
RSウイルス感染症,2020,47,2020-W47,0,1,1,258,gender
咽頭結膜熱,2020,47,2020-W47,32,11,43,258,gender
Ａ群溶血性レンサ球菌咽頭炎,2020,47,2020-W47,72,62,134,258,gender
感染性胃腸炎,2020,47,2020-W47,383,346,729,258,gender
水痘,2020,47,2020-W47,40,15,55,258,gender
手足口病,2020,47,2020-W47,3,8,11,258,gender
突発性発しん,2020,47,2020-W47,80,64,144,258,gender
ヘルパンギーナ,2020,47,2020-W47,5,3,8,258,gender
流行性耳下腺炎,2020,47,2020-W47,11,6,17,258,gender
川崎病,2020,47,2020-W47,0,0,0,258,gender
インフルエンザ,2002,26,2002-W26,0,0,0,178,gender
RSウイルス感染症,2002,26,2002-W26,0,0,0,142,gender
咽頭結膜熱,2002,26,2002-W26,9,12,21,142,gender
Ａ群溶血性レンサ球菌咽頭炎,2002,26,2002-W26,55,53,108,142,gender
感染性胃腸炎,2002,26,2002-W26,232,197,429,142,gender
水痘,2002,26,2002-W26,94,86,180,142,gender
手足口病,2002,26,2002-W26,117,85,202,142,gender
突発性発しん,2002,26,2002-W26,33,37,70,142,gender
ヘルパンギーナ,2002,26,2002-W26,235,202,437,142,gender
流行性耳下腺炎,2002,26,2002-W26,47,46,93,142,gender
川崎病,2002,26,2002-W26,1,2,3,142,gender
インフルエンザ,2021,29,2021-W29,0,0,0,412,gender
RSウイルス感染症,2021,29,2021-W29,877,833,1710,259,gender
咽頭結膜熱,2021,29,2021-W29,15,11,26,259,gender
Ａ群溶血性レンサ球菌咽頭炎,2021,29,2021-W29,33,18,51,259,gender
感染性胃腸炎,2021,29,2021-W29,305,254,559,259,gender
水痘,2021,29,2021-W29,10,6,16,259,gender
手足口病,2021,29,2021-W29,6,8,14,259,gender
突発性発しん,2021,29,2021-W29,38,33,71,259,gender
ヘルパンギーナ,2021,29,2021-W29,26,22,48,259,gender
流行性耳下腺炎,2021,29,2021-W29,12,9,21,259,gender
川崎病,2021,29,2021-W29,1,0,1,259,gender
インフルエンザ,2014,29,2014-W29,1,2,3,410,gender
RSウイルス感染症,2014,29,2014-W29,14,13,27,262,gender
咽頭結膜熱,2014,29,2014-W29,100,78,178,262,gender
Ａ群溶血性レンサ球菌咽頭炎,2014,29,2014-W29,264,209,473,262,gender
感染性胃腸炎,2014,29,2014-W29,657,561,1218,262,gender
水痘,2014,29,2014-W29,88,83,171,262,gender
手足口病,2014,29,2014-W29,219,186,405,262,gender
突発性発しん,2014,29,2014-W29,97,79,176,262,gender
ヘルパンギーナ,2014,29,2014-W29,1374,1225,2599,262,gender
流行性耳下腺炎,2014,29,2014-W29,41,58,99,262,gender
川崎病,2014,29,2014-W29,3,2,5,262,gender
インフルエンザ,2008,50,2008-W50,335,339,674,284,gender
RSウイルス感染症,2008,50,2008-W50,35,42,77,147,gender
咽頭結膜熱,2008,50,2008-W50,32,33,65,147,gender
Ａ群溶血性レンサ球菌咽頭炎,2008,50,2008-W50,200,215,415,147,gender
感染性胃腸炎,2008,50,2008-W50,1359,1441,2800,147,gender
水痘,2008,50,2008-W50,138,126,264,147,gender
手足口病,2008,50,2008-W50,41,20,61,147,gender
突発性発しん,2008,50,2008-W50,40,44,84,147,gender
ヘルパンギーナ,2008,50,2008-W50,5,4,9,147,gender
流行性耳下腺炎,2008,50,2008-W50,45,45,90,147,gender
川崎病,2008,50,2008-W50,1,1,2,147,gender
インフルエンザ,2005,1,2005-W01,53,35,88,178,gender
RSウイルス感染症,2005,1,2005-W01,8,7,15,142,gender
咽頭結膜熱,2005,1,2005-W01,13,5,18,142,gender
Ａ群溶血性レンサ球菌咽頭炎,2005,1,2005-W01,26,24,50,142,gender
感染性胃腸炎,2005,1,2005-W01,486,501,987,142,gender
水痘,2005,1,2005-W01,140,117,257,142,gender
手足口病,2005,1,2005-W01,13,8,21,142,gender
突発性発しん,2005,1,2005-W01,18,21,39,142,gender
ヘルパンギーナ,2005,1,2005-W01,4,5,9,142,gender
流行性耳下腺炎,2005,1,2005-W01,63,60,123,142,gender
川崎病,2005,1,2005-W01,0,1,1,142,gender
インフルエンザ,2015,47,2015-W47,48,51,99,410,gender
RSウイルス感染症,2015,47,2015-W47,177,158,335,259,gender
咽頭結膜熱,2015,47,2015-W47,68,41,109,259,gender
Ａ群溶血性レンサ球菌咽頭炎,2015,47,2015-W47,382,340,722,259,gender
感染性胃腸炎,2015,47,2015-W47,1092,971,2063,259,gender
水痘,2015,47,2015-W47,62,78,140,259,gender
手足口病,2015,47,2015-W47,45,52,97,259,gender
突発性発しん,2015,47,2015-W47,83,77,160,259,gender
ヘルパンギーナ,2015,47,2015-W47,6,5,11,259,gender
流行性耳下腺炎,2015,47,2015-W47,80,67,147,259,gender
川崎病,2015,47,2015-W47,0,5,5,259,gender
インフルエンザ,2018,17,2018-W17,150,149,299,412,gender
RSウイルス感染症,2018,17,2018-W17,37,37,74,260,gender
咽頭結膜熱,2018,17,2018-W17,52,48,100,260,gender
Ａ群溶血性レンサ球菌咽頭炎,2018,17,2018-W17,505,404,909,260,gender
感染性胃腸炎,2018,17,2018-W17,919,858,1777,260,gender
水痘,2018,17,2018-W17,33,38,71,260,gender
手足口病,2018,17,2018-W17,12,17,29,260,gender
突発性発しん,2018,17,2018-W17,92,103,195,260,gender
ヘルパンギーナ,2018,17,2018-W17,3,2,5,260,gender
流行性耳下腺炎,2018,17,2018-W17,17,7,24,260,gender
川崎病,2018,17,2018-W17,3,3,6,260,gender
インフルエンザ,2025,12,2025-W12,404,406,810,418,gender
新型コロナウイルス感染症（COVID-19）,2025,12,2025-W12,432,534,966,418,gender
RSウイルス感染症,2025,12,2025-W12,77,35,112,263,gender
咽頭結膜熱,2025,12,2025-W12,16,9,25,263,gender
Ａ群溶血性レンサ球菌咽頭炎,2025,12,2025-W12,346,234,580,263,gender
感染性胃腸炎,2025,12,2025-W12,1507,1316,2823,263,gender
水痘,2025,12,2025-W12,71,59,130,263,gender
手足口病,2025,12,2025-W12,5,5,10,263,gender
突発性発しん,2025,12,2025-W12,19,11,30,263,gender
ヘルパンギーナ,2025,12,2025-W12,1,2,3,263,gender
流行性耳下腺炎,2025,12,2025-W12,2,3,5,263,gender
川崎病,2025,12,2025-W12,4,4,8,263,gender
インフルエンザ,2017,34,2017-W34,14,26,40,402,gender
RSウイルス感染症,2017,34,2017-W34,331,295,626,249,gender
咽頭結膜熱,2017,34,2017-W34,80,57,137,249,gender
Ａ群溶血性レンサ球菌咽頭炎,2017,34,2017-W34,122,118,240,249,gender
感染性胃腸炎,2017,34,2017-W34,429,367,796,249,gender
水痘,2017,34,2017-W34,30,24,54,249,gender
手足口病,2017,34,2017-W34,1270,1077,2347,249,gender
突発性発しん,2017,34,2017-W34,59,56,115,249,gender
ヘルパンギーナ,2017,34,2017-W34,238,229,467,249,gender
流行性耳下腺炎,2017,34,2017-W34,22,16,38,249,gender
川崎病,2017,34,2017-W34,4,2,6,249,gender
インフルエンザ,2023,15,2023-W15,407,386,793,413,gender
RSウイルス感染症,2023,15,2023-W15,48,36,84,260,gender
咽頭結膜熱,2023,15,2023-W15,37,17,54,260,gender
Ａ群溶血性レンサ球菌咽頭炎,2023,15,2023-W15,79,60,139,260,gender
感染性胃腸炎,2023,15,2023-W15,605,525,1130,260,gender
水痘,2023,15,2023-W15,12,15,27,260,gender
手足口病,2023,15,2023-W15,13,22,35,260,gender
突発性発しん,2023,15,2023-W15,35,38,73,260,gender
ヘルパンギーナ,2023,15,2023-W15,7,9,16,260,gender
流行性耳下腺炎,2023,15,2023-W15,5,3,8,260,gender
川崎病,2023,15,2023-W15,0,1,1,260,gender
インフルエンザ,2013,40,2013-W40,1,3,4,411,gender
RSウイルス感染症,2013,40,2013-W40,141,122,263,260,gender
咽頭結膜熱,2013,40,2013-W40,37,37,74,260,gender
Ａ群溶血性レンサ球菌咽頭炎,2013,40,2013-W40,152,138,290,260,gender
感染性胃腸炎,2013,40,2013-W40,486,412,898,260,gender
水痘,2013,40,2013-W40,90,72,162,260,gender
手足口病,2013,40,2013-W40,192,158,350,260,gender
突発性発しん,2013,40,2013-W40,92,81,173,260,gender
ヘルパンギーナ,2013,40,2013-W40,38,26,64,260,gender
流行性耳下腺炎,2013,40,2013-W40,28,21,49,260,gender
川崎病,2013,40,2013-W40,7,3,10,260,gender
インフルエンザ,2011,33,2011-W33,0,2,2,394,gender
RSウイルス感染症,2011,33,2011-W33,23,28,51,246,gender
咽頭結膜熱,2011,33,2011-W33,33,28,61,246,gender
Ａ群溶血性レンサ球菌咽頭炎,2011,33,2011-W33,45,59,104,246,gender
感染性胃腸炎,2011,33,2011-W33,270,236,506,246,gender
水痘,2011,33,2011-W33,48,58,106,246,gender
手足口病,2011,33,2011-W33,553,483,1036,246,gender
突発性発しん,2011,33,2011-W33,52,51,103,246,gender
ヘルパンギーナ,2011,33,2011-W33,270,264,534,246,gender
流行性耳下腺炎,2011,33,2011-W33,30,27,57,246,gender
川崎病,2011,33,2011-W33,2,1,3,246,gender
インフルエンザ,2012,6,2012-W06,9360,8864,18224,418,gender
RSウイルス感染症,2012,6,2012-W06,29,33,62,263,gender
咽頭結膜熱,2012,6,2012-W06,22,12,34,263,gender
Ａ群溶血性レンサ球菌咽頭炎,2012,6,2012-W06,231,201,432,263,gender
感染性胃腸炎,2012,6,2012-W06,877,802,1679,263,gender
水痘,2012,6,2012-W06,162,147,309,263,gender
手足口病,2012,6,2012-W06,8,5,13,263,gender
突発性発しん,2012,6,2012-W06,51,50,101,263,gender
ヘルパンギーナ,2012,6,2012-W06,4,1,5,263,gender
流行性耳下腺炎,2012,6,2012-W06,18,21,39,263,gender
川崎病,2012,6,2012-W06,1,1,2,263,gender
インフルエンザ,2000,24,2000-W24,1,0,1,178,gender
RSウイルス感染症,2000,24,2000-W24,0,0,0,142,gender
咽頭結膜熱,2000,24,2000-W24,9,4,13,142,gender
Ａ群溶血性レンサ球菌咽頭炎,2000,24,2000-W24,67,46,113,142,gender
感染性胃腸炎,2000,24,2000-W24,214,185,399,142,gender
水痘,2000,24,2000-W24,91,85,176,142,gender
手足口病,2000,24,2000-W24,72,70,142,142,gender
突発性発しん,2000,24,2000-W24,42,41,83,142,gender
ヘルパンギーナ,2000,24,2000-W24,121,112,233,142,gender
流行性耳下腺炎,2000,24,2000-W24,50,38,88,142,gender
川崎病,2000,24,2000-W24,2,2,4,142,gender
インフルエンザ,2003,39,2003-W39,0,0,0,178,gender
RSウイルス感染症,2003,39,2003-W39,0,0,0,142,gender
咽頭結膜熱,2003,39,2003-W39,11,7,18,142,gender
Ａ群溶血性レンサ球菌咽頭炎,2003,39,2003-W39,30,17,47,142,gender
感染性胃腸炎,2003,39,2003-W39,161,154,315,142,gender
水痘,2003,39,2003-W39,26,16,42,142,gender
手足口病,2003,39,2003-W39,50,31,81,142,gender
突発性発しん,2003,39,2003-W39,43,47,90,142,gender
ヘルパンギーナ,2003,39,2003-W39,38,31,69,142,gender
流行性耳下腺炎,2003,39,2003-W39,9,8,17,142,gender
川崎病,2003,39,2003-W39,1,0,1,142,gender
インフルエンザ,2022,45,2022-W45,44,40,84,411,gender
RSウイルス感染症,2022,45,2022-W45,58,43,101,261,gender
咽頭結膜熱,2022,45,2022-W45,18,10,28,261,gender
Ａ群溶血性レンサ球菌咽頭炎,2022,45,2022-W45,31,33,64,261,gender
感染性胃腸炎,2022,45,2022-W45,601,502,1103,261,gender
水痘,2022,45,2022-W45,21,15,36,261,gender
手足口病,2022,45,2022-W45,72,54,126,261,gender
突発性発しん,2022,45,2022-W45,31,48,79,261,gender
ヘルパンギーナ,2022,45,2022-W45,19,15,34,261,gender
流行性耳下腺炎,2022,45,2022-W45,8,3,11,261,gender
川崎病,2022,45,2022-W45,0,1,1,261,gender
インフルエンザ,2012,10,2012-W10,4686,4641,9327,419,gender
RSウイルス感染症,2012,10,2012-W10,26,19,45,264,gender
咽頭結膜熱,2012,10,2012-W10,22,14,36,264,gender
Ａ群溶血性レンサ球菌咽頭炎,2012,10,2012-W10,339,270,609,264,gender
感染性胃腸炎,2012,10,2012-W10,1205,1082,2287,264,gender
水痘,2012,10,2012-W10,156,147,303,264,gender
手足口病,2012,10,2012-W10,2,0,2,264,gender
突発性発しん,2012,10,2012-W10,63,46,109,264,gender
ヘルパンギーナ,2012,10,2012-W10,2,1,3,264,gender
流行性耳下腺炎,2012,10,2012-W10,28,29,57,264,gender
川崎病,2012,10,2012-W10,2,1,3,264,gender
インフルエンザ,2020,36,2020-W36,0,0,0,412,gender
RSウイルス感染症,2020,36,2020-W36,0,0,0,259,gender
咽頭結膜熱,2020,36,2020-W36,15,10,25,259,gender
Ａ群溶血性レンサ球菌咽頭炎,2020,36,2020-W36,46,51,97,259,gender
感染性胃腸炎,2020,36,2020-W36,323,275,598,259,gender
水痘,2020,36,2020-W36,14,9,23,259,gender
手足口病,2020,36,2020-W36,12,15,27,259,gender
突発性発しん,2020,36,2020-W36,65,78,143,259,gender
ヘルパンギーナ,2020,36,2020-W36,16,12,28,259,gender
流行性耳下腺炎,2020,36,2020-W36,3,7,10,259,gender
川崎病,2020,36,2020-W36,0,1,1,259,gender
インフルエンザ,2014,17,2014-W17,434,417,851,414,gender
RSウイルス感染症,2014,17,2014-W17,17,16,33,264,gender
咽頭結膜熱,2014,17,2014-W17,61,44,105,264,gender
Ａ群溶血性レンサ球菌咽頭炎,2014,17,2014-W17,422,332,754,264,gender
感染性胃腸炎,2014,17,2014-W17,1118,1004,2122,264,gender
水痘,2014,17,2014-W17,133,112,245,264,gender
手足口病,2014,17,2014-W17,12,7,19,264,gender
突発性発しん,2014,17,2014-W17,94,80,174,264,gender
ヘルパンギーナ,2014,17,2014-W17,7,1,8,264,gender
流行性耳下腺炎,2014,17,2014-W17,38,22,60,264,gender
川崎病,2014,17,2014-W17,3,2,5,264,gender
インフルエンザ,2019,47,2019-W47,614,615,1229,410,gender
RSウイルス感染症,2019,47,2019-W47,31,29,60,257,gender
咽頭結膜熱,2019,47,2019-W47,38,55,93,257,gender
Ａ群溶血性レンサ球菌咽頭炎,2019,47,2019-W47,323,301,624,257,gender
感染性胃腸炎,2019,47,2019-W47,774,639,1413,257,gender
水痘,2019,47,2019-W47,62,55,117,257,gender
手足口病,2019,47,2019-W47,211,175,386,257,gender
突発性発しん,2019,47,2019-W47,39,40,79,257,gender
ヘルパンギーナ,2019,47,2019-W47,23,24,47,257,gender
流行性耳下腺炎,2019,47,2019-W47,16,5,21,257,gender
川崎病,2019,47,2019-W47,0,1,1,257,gender
インフルエンザ,2024,42,2024-W42,157,151,308,418,gender
新型コロナウイルス感染症（COVID-19）,2024,42,2024-W42,261,282,543,418,gender
RSウイルス感染症,2024,42,2024-W42,17,18,35,263,gender
咽頭結膜熱,2024,42,2024-W42,11,20,31,263,gender
Ａ群溶血性レンサ球菌咽頭炎,2024,42,2024-W42,200,192,392,263,gender
感染性胃腸炎,2024,42,2024-W42,381,285,666,263,gender
水痘,2024,42,2024-W42,20,13,33,263,gender
手足口病,2024,42,2024-W42,1606,1361,2967,263,gender
突発性発しん,2024,42,2024-W42,31,34,65,263,gender
ヘルパンギーナ,2024,42,2024-W42,35,26,61,263,gender
流行性耳下腺炎,2024,42,2024-W42,6,2,8,263,gender
川崎病,2024,42,2024-W42,1,0,1,263,gender
インフルエンザ,2019,8,2019-W08,1353,1386,2739,414,gender
RSウイルス感染症,2019,8,2019-W08,30,27,57,262,gender
咽頭結膜熱,2019,8,2019-W08,26,14,40,262,gender
Ａ群溶血性レンサ球菌咽頭炎,2019,8,2019-W08,348,267,615,262,gender
感染性胃腸炎,2019,8,2019-W08,993,895,1888,262,gender
水痘,2019,8,2019-W08,34,57,91,262,gender
手足口病,2019,8,2019-W08,10,9,19,262,gender
突発性発しん,2019,8,2019-W08,56,53,109,262,gender
ヘルパンギーナ,2019,8,2019-W08,1,1,2,262,gender
流行性耳下腺炎,2019,8,2019-W08,7,5,12,262,gender
川崎病,2019,8,2019-W08,1,1,2,262,gender
インフルエンザ,2018,29,2018-W29,4,2,6,411,gender
RSウイルス感染症,2018,29,2018-W29,81,98,179,259,gender
咽頭結膜熱,2018,29,2018-W29,82,53,135,259,gender
Ａ群溶血性レンサ球菌咽頭炎,2018,29,2018-W29,231,234,465,259,gender
感染性胃腸炎,2018,29,2018-W29,586,477,1063,259,gender
水痘,2018,29,2018-W29,40,35,75,259,gender
手足口病,2018,29,2018-W29,154,143,297,259,gender
突発性発しん,2018,29,2018-W29,66,57,123,259,gender
ヘルパンギーナ,2018,29,2018-W29,420,391,811,259,gender
流行性耳下腺炎,2018,29,2018-W29,33,16,49,259,gender
川崎病,2018,29,2018-W29,1,0,1,259,gender
インフルエンザ,2004,50,2004-W50,38,30,68,178,gender
RSウイルス感染症,2004,50,2004-W50,9,12,21,142,gender
咽頭結膜熱,2004,50,2004-W50,19,17,36,142,gender
Ａ群溶血性レンサ球菌咽頭炎,2004,50,2004-W50,62,61,123,142,gender
感染性胃腸炎,2004,50,2004-W50,1048,960,2008,142,gender
水痘,2004,50,2004-W50,89,95,184,142,gender
手足口病,2004,50,2004-W50,64,40,104,142,gender
突発性発しん,2004,50,2004-W50,34,21,55,142,gender
ヘルパンギーナ,2004,50,2004-W50,7,4,11,142,gender
流行性耳下腺炎,2004,50,2004-W50,75,57,132,142,gender
川崎病,2004,50,2004-W50,2,0,2,142,gender
インフルエンザ,2006,23,2006-W23,2,1,3,178,gender
RSウイルス感染症,2006,23,2006-W23,3,1,4,142,gender
咽頭結膜熱,2006,23,2006-W23,94,81,175,142,gender
Ａ群溶血性レンサ球菌咽頭炎,2006,23,2006-W23,161,112,273,142,gender
感染性胃腸炎,2006,23,2006-W23,276,268,544,142,gender
水痘,2006,23,2006-W23,157,103,260,142,gender
手足口病,2006,23,2006-W23,36,18,54,142,gender
突発性発しん,2006,23,2006-W23,29,35,64,142,gender
ヘルパンギーナ,2006,23,2006-W23,246,255,501,142,gender
流行性耳下腺炎,2006,23,2006-W23,43,61,104,142,gender
川崎病,2006,23,2006-W23,0,3,3,142,gender
インフルエンザ,2007,42,2007-W42,25,21,46,288,gender
RSウイルス感染症,2007,42,2007-W42,10,9,19,150,gender
咽頭結膜熱,2007,42,2007-W42,11,11,22,150,gender
Ａ群溶血性レンサ球菌咽頭炎,2007,42,2007-W42,109,75,184,150,gender
感染性胃腸炎,2007,42,2007-W42,303,264,567,150,gender
水痘,2007,42,2007-W42,36,36,72,150,gender
手足口病,2007,42,2007-W42,64,49,113,150,gender
突発性発しん,2007,42,2007-W42,50,43,93,150,gender
ヘルパンギーナ,2007,42,2007-W42,25,19,44,150,gender
流行性耳下腺炎,2007,42,2007-W42,12,19,31,150,gender
川崎病,2007,42,2007-W42,1,1,2,150,gender
インフルエンザ,2019,7,2019-W07,2105,2176,4281,415,gender
RSウイルス感染症,2019,7,2019-W07,35,28,63,262,gender
咽頭結膜熱,2019,7,2019-W07,23,19,42,262,gender
Ａ群溶血性レンサ球菌咽頭炎,2019,7,2019-W07,242,210,452,262,gender
感染性胃腸炎,2019,7,2019-W07,746,707,1453,262,gender
水痘,2019,7,2019-W07,48,43,91,262,gender
手足口病,2019,7,2019-W07,12,8,20,262,gender
突発性発しん,2019,7,2019-W07,39,39,78,262,gender
ヘルパンギーナ,2019,7,2019-W07,1,2,3,262,gender
流行性耳下腺炎,2019,7,2019-W07,5,5,10,262,gender
川崎病,2019,7,2019-W07,2,0,2,262,gender
インフルエンザ,2005,31,2005-W31,0,0,0,178,gender
RSウイルス感染症,2005,31,2005-W31,4,5,9,142,gender
咽頭結膜熱,2005,31,2005-W31,36,23,59,142,gender
Ａ群溶血性レンサ球菌咽頭炎,2005,31,2005-W31,41,35,76,142,gender
感染性胃腸炎,2005,31,2005-W31,168,150,318,142,gender
水痘,2005,31,2005-W31,46,41,87,142,gender
手足口病,2005,31,2005-W31,80,81,161,142,gender
突発性発しん,2005,31,2005-W31,48,40,88,142,gender
ヘルパンギーナ,2005,31,2005-W31,168,162,330,142,gender
流行性耳下腺炎,2005,31,2005-W31,87,89,176,142,gender
川崎病,2005,31,2005-W31,0,0,0,142,gender
インフルエンザ,2019,48,2019-W48,1315,1235,2550,414,gender
RSウイルス感染症,2019,48,2019-W48,30,29,59,260,gender
咽頭結膜熱,2019,48,2019-W48,73,48,121,260,gender
Ａ群溶血性レンサ球菌咽頭炎,2019,48,2019-W48,492,379,871,260,gender
感染性胃腸炎,2019,48,2019-W48,908,803,1711,260,gender
水痘,2019,48,2019-W48,108,100,208,260,gender
手足口病,2019,48,2019-W48,244,190,434,260,gender
突発性発しん,2019,48,2019-W48,59,53,112,260,gender
ヘルパンギーナ,2019,48,2019-W48,18,14,32,260,gender
流行性耳下腺炎,2019,48,2019-W48,10,8,18,260,gender
川崎病,2019,48,2019-W48,2,1,3,260,gender
インフルエンザ,2014,18,2014-W18,212,210,422,397,gender
RSウイルス感染症,2014,18,2014-W18,10,10,20,251,gender
咽頭結膜熱,2014,18,2014-W18,47,41,88,251,gender
Ａ群溶血性レンサ球菌咽頭炎,2014,18,2014-W18,284,256,540,251,gender
感染性胃腸炎,2014,18,2014-W18,908,718,1626,251,gender
水痘,2014,18,2014-W18,87,95,182,251,gender
手足口病,2014,18,2014-W18,11,16,27,251,gender
突発性発しん,2014,18,2014-W18,79,80,159,251,gender
ヘルパンギーナ,2014,18,2014-W18,5,5,10,251,gender
流行性耳下腺炎,2014,18,2014-W18,26,19,45,251,gender
川崎病,2014,18,2014-W18,1,0,1,251,gender
インフルエンザ,2025,23,2025-W23,41,43,84,418,gender
新型コロナウイルス感染症（COVID-19）,2025,23,2025-W23,164,228,392,418,gender
RSウイルス感染症,2025,23,2025-W23,23,10,33,263,gender
咽頭結膜熱,2025,23,2025-W23,86,51,137,263,gender
Ａ群溶血性レンサ球菌咽頭炎,2025,23,2025-W23,651,513,1164,263,gender
感染性胃腸炎,2025,23,2025-W23,977,806,1783,263,gender
水痘,2025,23,2025-W23,95,88,183,263,gender
手足口病,2025,23,2025-W23,21,23,44,263,gender
突発性発しん,2025,23,2025-W23,45,41,86,263,gender
ヘルパンギーナ,2025,23,2025-W23,18,16,34,263,gender
流行性耳下腺炎,2025,23,2025-W23,13,6,19,263,gender
川崎病,2025,23,2025-W23,2,4,6,263,gender
インフルエンザ,2018,26,2018-W26,8,5,13,411,gender
RSウイルス感染症,2018,26,2018-W26,54,42,96,262,gender
咽頭結膜熱,2018,26,2018-W26,104,95,199,262,gender
Ａ群溶血性レンサ球菌咽頭炎,2018,26,2018-W26,411,361,772,262,gender
感染性胃腸炎,2018,26,2018-W26,921,753,1674,262,gender
水痘,2018,26,2018-W26,51,54,105,262,gender
手足口病,2018,26,2018-W26,92,100,192,262,gender
突発性発しん,2018,26,2018-W26,90,87,177,262,gender
ヘルパンギーナ,2018,26,2018-W26,179,177,356,262,gender
流行性耳下腺炎,2018,26,2018-W26,29,15,44,262,gender
川崎病,2018,26,2018-W26,5,1,6,262,gender
インフルエンザ,2017,5,2017-W05,7244,7450,14694,415,gender
RSウイルス感染症,2017,5,2017-W05,16,20,36,261,gender
咽頭結膜熱,2017,5,2017-W05,27,24,51,261,gender
Ａ群溶血性レンサ球菌咽頭炎,2017,5,2017-W05,280,239,519,261,gender
感染性胃腸炎,2017,5,2017-W05,761,692,1453,261,gender
水痘,2017,5,2017-W05,38,28,66,261,gender
手足口病,2017,5,2017-W05,6,4,10,261,gender
突発性発しん,2017,5,2017-W05,68,46,114,261,gender
ヘルパンギーナ,2017,5,2017-W05,1,2,3,261,gender
流行性耳下腺炎,2017,5,2017-W05,48,34,82,261,gender
川崎病,2017,5,2017-W05,1,2,3,261,gender
インフルエンザ,2012,9,2012-W09,5412,5594,11006,418,gender
RSウイルス感染症,2012,9,2012-W09,28,24,52,263,gender
咽頭結膜熱,2012,9,2012-W09,25,15,40,263,gender
Ａ群溶血性レンサ球菌咽頭炎,2012,9,2012-W09,265,176,441,263,gender
感染性胃腸炎,2012,9,2012-W09,1076,902,1978,263,gender
水痘,2012,9,2012-W09,139,135,274,263,gender
手足口病,2012,9,2012-W09,1,1,2,263,gender
突発性発しん,2012,9,2012-W09,56,54,110,263,gender
ヘルパンギーナ,2012,9,2012-W09,3,3,6,263,gender
流行性耳下腺炎,2012,9,2012-W09,12,30,42,263,gender
川崎病,2012,9,2012-W09,1,1,2,263,gender
インフルエンザ,2023,24,2023-W24,305,245,550,414,gender
新型コロナウイルス感染症（COVID-19）,2023,24,2023-W24,1194,1228,2422,414,gender
RSウイルス感染症,2023,24,2023-W24,298,306,604,260,gender
咽頭結膜熱,2023,24,2023-W24,86,48,134,260,gender
Ａ群溶血性レンサ球菌咽頭炎,2023,24,2023-W24,273,177,450,260,gender
感染性胃腸炎,2023,24,2023-W24,937,806,1743,260,gender
水痘,2023,24,2023-W24,13,21,34,260,gender
手足口病,2023,24,2023-W24,106,85,191,260,gender
突発性発しん,2023,24,2023-W24,46,37,83,260,gender
ヘルパンギーナ,2023,24,2023-W24,813,771,1584,260,gender
流行性耳下腺炎,2023,24,2023-W24,12,4,16,260,gender
川崎病,2023,24,2023-W24,1,2,3,260,gender
インフルエンザ,2001,45,2001-W45,4,1,5,178,gender
RSウイルス感染症,2001,45,2001-W45,0,0,0,142,gender
咽頭結膜熱,2001,45,2001-W45,3,0,3,142,gender
Ａ群溶血性レンサ球菌咽頭炎,2001,45,2001-W45,32,36,68,142,gender
感染性胃腸炎,2001,45,2001-W45,245,230,475,142,gender
水痘,2001,45,2001-W45,58,40,98,142,gender
手足口病,2001,45,2001-W45,15,21,36,142,gender
突発性発しん,2001,45,2001-W45,34,26,60,142,gender
ヘルパンギーナ,2001,45,2001-W45,6,4,10,142,gender
流行性耳下腺炎,2001,45,2001-W45,60,50,110,142,gender
川崎病,2001,45,2001-W45,0,0,0,142,gender
インフルエンザ,2020,39,2020-W39,0,0,0,410,gender
RSウイルス感染症,2020,39,2020-W39,0,0,0,258,gender
咽頭結膜熱,2020,39,2020-W39,9,6,15,258,gender
Ａ群溶血性レンサ球菌咽頭炎,2020,39,2020-W39,37,36,73,258,gender
感染性胃腸炎,2020,39,2020-W39,249,189,438,258,gender
水痘,2020,39,2020-W39,20,21,41,258,gender
手足口病,2020,39,2020-W39,4,8,12,258,gender
突発性発しん,2020,39,2020-W39,42,50,92,258,gender
ヘルパンギーナ,2020,39,2020-W39,10,9,19,258,gender
流行性耳下腺炎,2020,39,2020-W39,13,6,19,258,gender
川崎病,2020,39,2020-W39,0,2,2,258,gender
インフルエンザ,2003,36,2003-W36,0,0,0,178,gender
RSウイルス感染症,2003,36,2003-W36,0,0,0,142,gender
咽頭結膜熱,2003,36,2003-W36,13,14,27,142,gender
Ａ群溶血性レンサ球菌咽頭炎,2003,36,2003-W36,24,23,47,142,gender
感染性胃腸炎,2003,36,2003-W36,133,121,254,142,gender
水痘,2003,36,2003-W36,28,13,41,142,gender
手足口病,2003,36,2003-W36,81,70,151,142,gender
突発性発しん,2003,36,2003-W36,43,51,94,142,gender
ヘルパンギーナ,2003,36,2003-W36,67,51,118,142,gender
流行性耳下腺炎,2003,36,2003-W36,12,9,21,142,gender
川崎病,2003,36,2003-W36,3,1,4,142,gender
インフルエンザ,2000,15,2000-W15,2,1,3,178,gender
RSウイルス感染症,2000,15,2000-W15,0,0,0,142,gender
咽頭結膜熱,2000,15,2000-W15,1,1,2,142,gender
Ａ群溶血性レンサ球菌咽頭炎,2000,15,2000-W15,47,36,83,142,gender
感染性胃腸炎,2000,15,2000-W15,349,368,717,142,gender
水痘,2000,15,2000-W15,77,77,154,142,gender
手足口病,2000,15,2000-W15,7,5,12,142,gender
突発性発しん,2000,15,2000-W15,32,36,68,142,gender
ヘルパンギーナ,2000,15,2000-W15,8,5,13,142,gender
流行性耳下腺炎,2000,15,2000-W15,23,36,59,142,gender
川崎病,2000,15,2000-W15,1,1,2,142,gender
インフルエンザ,2010,52,2010-W52,315,261,576,276,gender
RSウイルス感染症,2010,52,2010-W52,45,53,98,147,gender
咽頭結膜熱,2010,52,2010-W52,39,26,65,147,gender
Ａ群溶血性レンサ球菌咽頭炎,2010,52,2010-W52,97,89,186,147,gender
感染性胃腸炎,2010,52,2010-W52,571,553,1124,147,gender
水痘,2010,52,2010-W52,89,71,160,147,gender
手足口病,2010,52,2010-W52,8,4,12,147,gender
突発性発しん,2010,52,2010-W52,19,18,37,147,gender
ヘルパンギーナ,2010,52,2010-W52,1,2,3,147,gender
流行性耳下腺炎,2010,52,2010-W52,17,19,36,147,gender
川崎病,2010,52,2010-W52,2,0,2,147,gender
インフルエンザ,2012,21,2012-W21,30,27,57,414,gender
RSウイルス感染症,2012,21,2012-W21,14,16,30,261,gender
咽頭結膜熱,2012,21,2012-W21,77,48,125,261,gender
Ａ群溶血性レンサ球菌咽頭炎,2012,21,2012-W21,536,446,982,261,gender
感染性胃腸炎,2012,21,2012-W21,1321,1117,2438,261,gender
水痘,2012,21,2012-W21,147,151,298,261,gender
手足口病,2012,21,2012-W21,28,34,62,261,gender
突発性発しん,2012,21,2012-W21,116,101,217,261,gender
ヘルパンギーナ,2012,21,2012-W21,19,7,26,261,gender
流行性耳下腺炎,2012,21,2012-W21,28,16,44,261,gender
川崎病,2012,21,2012-W21,2,2,4,261,gender
インフルエンザ,2014,26,2014-W26,3,4,7,414,gender
RSウイルス感染症,2014,26,2014-W26,18,12,30,264,gender
咽頭結膜熱,2014,26,2014-W26,131,112,243,264,gender
Ａ群溶血性レンサ球菌咽頭炎,2014,26,2014-W26,435,325,760,264,gender
感染性胃腸炎,2014,26,2014-W26,807,717,1524,264,gender
水痘,2014,26,2014-W26,123,124,247,264,gender
手足口病,2014,26,2014-W26,93,61,154,264,gender
突発性発しん,2014,26,2014-W26,109,108,217,264,gender
ヘルパンギーナ,2014,26,2014-W26,366,336,702,264,gender
流行性耳下腺炎,2014,26,2014-W26,49,30,79,264,gender
川崎病,2014,26,2014-W26,2,2,4,264,gender
インフルエンザ,2006,12,2006-W12,146,138,284,178,gender
RSウイルス感染症,2006,12,2006-W12,2,1,3,142,gender
咽頭結膜熱,2006,12,2006-W12,23,21,44,142,gender
Ａ群溶血性レンサ球菌咽頭炎,2006,12,2006-W12,168,154,322,142,gender
感染性胃腸炎,2006,12,2006-W12,475,446,921,142,gender
水痘,2006,12,2006-W12,133,102,235,142,gender
手足口病,2006,12,2006-W12,0,3,3,142,gender
突発性発しん,2006,12,2006-W12,33,34,67,142,gender
ヘルパンギーナ,2006,12,2006-W12,6,5,11,142,gender
流行性耳下腺炎,2006,12,2006-W12,57,69,126,142,gender
川崎病,2006,12,2006-W12,0,0,0,142,gender
インフルエンザ,2023,1,2023-W01,792,683,1475,409,gender
RSウイルス感染症,2023,1,2023-W01,6,6,12,257,gender
咽頭結膜熱,2023,1,2023-W01,12,5,17,257,gender
Ａ群溶血性レンサ球菌咽頭炎,2023,1,2023-W01,12,16,28,257,gender
感染性胃腸炎,2023,1,2023-W01,646,566,1212,257,gender
水痘,2023,1,2023-W01,13,11,24,257,gender
手足口病,2023,1,2023-W01,8,5,13,257,gender
突発性発しん,2023,1,2023-W01,19,20,39,257,gender
ヘルパンギーナ,2023,1,2023-W01,3,0,3,257,gender
流行性耳下腺炎,2023,1,2023-W01,1,3,4,257,gender
川崎病,2023,1,2023-W01,2,0,2,257,gender
インフルエンザ,2009,31,2009-W31,153,124,277,286,gender
RSウイルス感染症,2009,31,2009-W31,3,4,7,148,gender
咽頭結膜熱,2009,31,2009-W31,22,17,39,148,gender
Ａ群溶血性レンサ球菌咽頭炎,2009,31,2009-W31,58,37,95,148,gender
感染性胃腸炎,2009,31,2009-W31,246,213,459,148,gender
水痘,2009,31,2009-W31,41,40,81,148,gender
手足口病,2009,31,2009-W31,158,135,293,148,gender
突発性発しん,2009,31,2009-W31,50,42,92,148,gender
ヘルパンギーナ,2009,31,2009-W31,140,117,257,148,gender
流行性耳下腺炎,2009,31,2009-W31,63,63,126,148,gender
川崎病,2009,31,2009-W31,0,2,2,148,gender
インフルエンザ,2018,18,2018-W18,43,53,96,405,gender
RSウイルス感染症,2018,18,2018-W18,23,18,41,253,gender
咽頭結膜熱,2018,18,2018-W18,42,26,68,253,gender
Ａ群溶血性レンサ球菌咽頭炎,2018,18,2018-W18,203,154,357,253,gender
感染性胃腸炎,2018,18,2018-W18,449,391,840,253,gender
水痘,2018,18,2018-W18,29,29,58,253,gender
手足口病,2018,18,2018-W18,9,6,15,253,gender
突発性発しん,2018,18,2018-W18,54,52,106,253,gender
ヘルパンギーナ,2018,18,2018-W18,6,2,8,253,gender
流行性耳下腺炎,2018,18,2018-W18,6,6,12,253,gender
川崎病,2018,18,2018-W18,3,0,3,253,gender
インフルエンザ,2015,48,2015-W48,43,32,75,411,gender
RSウイルス感染症,2015,48,2015-W48,163,147,310,260,gender
咽頭結膜熱,2015,48,2015-W48,54,44,98,260,gender
Ａ群溶血性レンサ球菌咽頭炎,2015,48,2015-W48,338,305,643,260,gender
感染性胃腸炎,2015,48,2015-W48,1036,938,1974,260,gender
水痘,2015,48,2015-W48,93,74,167,260,gender
手足口病,2015,48,2015-W48,37,19,56,260,gender
突発性発しん,2015,48,2015-W48,68,69,137,260,gender
ヘルパンギーナ,2015,48,2015-W48,5,8,13,260,gender
流行性耳下腺炎,2015,48,2015-W48,81,90,171,260,gender
川崎病,2015,48,2015-W48,1,2,3,260,gender
インフルエンザ,2011,8,2011-W08,3508,3359,6867,417,gender
RSウイルス感染症,2011,8,2011-W08,16,19,35,262,gender
咽頭結膜熱,2011,8,2011-W08,54,39,93,262,gender
Ａ群溶血性レンサ球菌咽頭炎,2011,8,2011-W08,416,367,783,262,gender
感染性胃腸炎,2011,8,2011-W08,1566,1388,2954,262,gender
水痘,2011,8,2011-W08,194,169,363,262,gender
手足口病,2011,8,2011-W08,4,6,10,262,gender
突発性発しん,2011,8,2011-W08,75,63,138,262,gender
ヘルパンギーナ,2011,8,2011-W08,1,3,4,262,gender
流行性耳下腺炎,2011,8,2011-W08,47,35,82,262,gender
川崎病,2011,8,2011-W08,4,1,5,262,gender
インフルエンザ,2001,34,2001-W34,0,0,0,178,gender
RSウイルス感染症,2001,34,2001-W34,0,0,0,142,gender
咽頭結膜熱,2001,34,2001-W34,10,10,20,142,gender
Ａ群溶血性レンサ球菌咽頭炎,2001,34,2001-W34,9,10,19,142,gender
感染性胃腸炎,2001,34,2001-W34,116,88,204,142,gender
水痘,2001,34,2001-W34,19,28,47,142,gender
手足口病,2001,34,2001-W34,15,12,27,142,gender
突発性発しん,2001,34,2001-W34,44,34,78,142,gender
ヘルパンギーナ,2001,34,2001-W34,41,24,65,142,gender
流行性耳下腺炎,2001,34,2001-W34,66,51,117,142,gender
川崎病,2001,34,2001-W34,1,0,1,142,gender
インフルエンザ,2020,48,2020-W48,2,2,4,408,gender
RSウイルス感染症,2020,48,2020-W48,4,2,6,258,gender
咽頭結膜熱,2020,48,2020-W48,23,16,39,258,gender
Ａ群溶血性レンサ球菌咽頭炎,2020,48,2020-W48,48,39,87,258,gender
感染性胃腸炎,2020,48,2020-W48,334,281,615,258,gender
水痘,2020,48,2020-W48,25,33,58,258,gender
手足口病,2020,48,2020-W48,1,7,8,258,gender
突発性発しん,2020,48,2020-W48,53,61,114,258,gender
ヘルパンギーナ,2020,48,2020-W48,4,8,12,258,gender
流行性耳下腺炎,2020,48,2020-W48,6,4,10,258,gender
川崎病,2020,48,2020-W48,0,0,0,258,gender
インフルエンザ,2014,4,2014-W04,6321,5996,12317,415,gender
RSウイルス感染症,2014,4,2014-W04,48,37,85,262,gender
咽頭結膜熱,2014,4,2014-W04,29,28,57,262,gender
Ａ群溶血性レンサ球菌咽頭炎,2014,4,2014-W04,330,292,622,262,gender
感染性胃腸炎,2014,4,2014-W04,1707,1690,3397,262,gender
水痘,2014,4,2014-W04,163,135,298,262,gender
手足口病,2014,4,2014-W04,5,4,9,262,gender
突発性発しん,2014,4,2014-W04,61,57,118,262,gender
ヘルパンギーナ,2014,4,2014-W04,4,0,4,262,gender
流行性耳下腺炎,2014,4,2014-W04,18,16,34,262,gender
川崎病,2014,4,2014-W04,4,1,5,262,gender
インフルエンザ,2003,47,2003-W47,6,6,12,178,gender
RSウイルス感染症,2003,47,2003-W47,1,1,2,142,gender
咽頭結膜熱,2003,47,2003-W47,9,9,18,142,gender
Ａ群溶血性レンサ球菌咽頭炎,2003,47,2003-W47,65,49,114,142,gender
感染性胃腸炎,2003,47,2003-W47,666,612,1278,142,gender
水痘,2003,47,2003-W47,73,90,163,142,gender
手足口病,2003,47,2003-W47,22,20,42,142,gender
突発性発しん,2003,47,2003-W47,41,49,90,142,gender
ヘルパンギーナ,2003,47,2003-W47,5,6,11,142,gender
流行性耳下腺炎,2003,47,2003-W47,9,8,17,142,gender
川崎病,2003,47,2003-W47,0,0,0,142,gender
インフルエンザ,2021,26,2021-W26,0,0,0,412,gender
RSウイルス感染症,2021,26,2021-W26,818,763,1581,259,gender
咽頭結膜熱,2021,26,2021-W26,27,39,66,259,gender
Ａ群溶血性レンサ球菌咽頭炎,2021,26,2021-W26,34,33,67,259,gender
感染性胃腸炎,2021,26,2021-W26,517,432,949,259,gender
水痘,2021,26,2021-W26,19,4,23,259,gender
手足口病,2021,26,2021-W26,12,10,22,259,gender
突発性発しん,2021,26,2021-W26,46,50,96,259,gender
ヘルパンギーナ,2021,26,2021-W26,12,18,30,259,gender
流行性耳下腺炎,2021,26,2021-W26,11,4,15,259,gender
川崎病,2021,26,2021-W26,3,1,4,259,gender
インフルエンザ,2002,29,2002-W29,0,0,0,178,gender
RSウイルス感染症,2002,29,2002-W29,0,0,0,142,gender
咽頭結膜熱,2002,29,2002-W29,11,6,17,142,gender
Ａ群溶血性レンサ球菌咽頭炎,2002,29,2002-W29,35,15,50,142,gender
感染性胃腸炎,2002,29,2002-W29,138,119,257,142,gender
水痘,2002,29,2002-W29,70,47,117,142,gender
手足口病,2002,29,2002-W29,178,146,324,142,gender
突発性発しん,2002,29,2002-W29,49,35,84,142,gender
ヘルパンギーナ,2002,29,2002-W29,290,244,534,142,gender
流行性耳下腺炎,2002,29,2002-W29,44,41,85,142,gender
川崎病,2002,29,2002-W29,2,0,2,142,gender
インフルエンザ,2007,33,2007-W33,0,0,0,255,gender
RSウイルス感染症,2007,33,2007-W33,0,0,0,130,gender
咽頭結膜熱,2007,33,2007-W33,17,8,25,130,gender
Ａ群溶血性レンサ球菌咽頭炎,2007,33,2007-W33,36,29,65,130,gender
感染性胃腸炎,2007,33,2007-W33,158,137,295,130,gender
水痘,2007,33,2007-W33,30,21,51,130,gender
手足口病,2007,33,2007-W33,80,78,158,130,gender
突発性発しん,2007,33,2007-W33,30,33,63,130,gender
ヘルパンギーナ,2007,33,2007-W33,146,122,268,130,gender
流行性耳下腺炎,2007,33,2007-W33,10,7,17,130,gender
川崎病,2007,33,2007-W33,1,0,1,130,gender
インフルエンザ,2008,10,2008-W10,415,434,849,286,gender
RSウイルス感染症,2008,10,2008-W10,10,3,13,150,gender
咽頭結膜熱,2008,10,2008-W10,14,12,26,150,gender
Ａ群溶血性レンサ球菌咽頭炎,2008,10,2008-W10,210,177,387,150,gender
感染性胃腸炎,2008,10,2008-W10,1228,1109,2337,150,gender
水痘,2008,10,2008-W10,96,83,179,150,gender
手足口病,2008,10,2008-W10,1,2,3,150,gender
突発性発しん,2008,10,2008-W10,44,37,81,150,gender
ヘルパンギーナ,2008,10,2008-W10,0,1,1,150,gender
流行性耳下腺炎,2008,10,2008-W10,36,23,59,150,gender
川崎病,2008,10,2008-W10,1,1,2,150,gender
インフルエンザ,2005,40,2005-W40,5,2,7,178,gender
RSウイルス感染症,2005,40,2005-W40,10,9,19,142,gender
咽頭結膜熱,2005,40,2005-W40,15,8,23,142,gender
Ａ群溶血性レンサ球菌咽頭炎,2005,40,2005-W40,53,43,96,142,gender
感染性胃腸炎,2005,40,2005-W40,200,167,367,142,gender
水痘,2005,40,2005-W40,17,29,46,142,gender
手足口病,2005,40,2005-W40,21,12,33,142,gender
突発性発しん,2005,40,2005-W40,50,40,90,142,gender
ヘルパンギーナ,2005,40,2005-W40,27,22,49,142,gender
流行性耳下腺炎,2005,40,2005-W40,81,64,145,142,gender
川崎病,2005,40,2005-W40,0,0,0,142,gender
インフルエンザ,2019,39,2019-W39,206,196,402,414,gender
RSウイルス感染症,2019,39,2019-W39,218,172,390,260,gender
咽頭結膜熱,2019,39,2019-W39,37,34,71,260,gender
Ａ群溶血性レンサ球菌咽頭炎,2019,39,2019-W39,217,173,390,260,gender
感染性胃腸炎,2019,39,2019-W39,448,340,788,260,gender
水痘,2019,39,2019-W39,36,35,71,260,gender
手足口病,2019,39,2019-W39,357,325,682,260,gender
突発性発しん,2019,39,2019-W39,71,70,141,260,gender
ヘルパンギーナ,2019,39,2019-W39,128,120,248,260,gender
流行性耳下腺炎,2019,39,2019-W39,13,7,20,260,gender
川崎病,2019,39,2019-W39,5,1,6,260,gender
インフルエンザ,2003,3,2003-W03,1499,1447,2946,178,gender
RSウイルス感染症,2003,3,2003-W03,0,0,0,142,gender
咽頭結膜熱,2003,3,2003-W03,6,5,11,142,gender
Ａ群溶血性レンサ球菌咽頭炎,2003,3,2003-W03,34,27,61,142,gender
感染性胃腸炎,2003,3,2003-W03,401,398,799,142,gender
水痘,2003,3,2003-W03,70,62,132,142,gender
手足口病,2003,3,2003-W03,3,3,6,142,gender
突発性発しん,2003,3,2003-W03,27,31,58,142,gender
ヘルパンギーナ,2003,3,2003-W03,1,1,2,142,gender
流行性耳下腺炎,2003,3,2003-W03,20,10,30,142,gender
川崎病,2003,3,2003-W03,2,0,2,142,gender
インフルエンザ,2009,40,2009-W40,1490,1326,2816,289,gender
RSウイルス感染症,2009,40,2009-W40,8,5,13,149,gender
咽頭結膜熱,2009,40,2009-W40,2,2,4,149,gender
Ａ群溶血性レンサ球菌咽頭炎,2009,40,2009-W40,53,34,87,149,gender
感染性胃腸炎,2009,40,2009-W40,180,147,327,149,gender
水痘,2009,40,2009-W40,37,23,60,149,gender
手足口病,2009,40,2009-W40,39,26,65,149,gender
突発性発しん,2009,40,2009-W40,49,55,104,149,gender
ヘルパンギーナ,2009,40,2009-W40,17,22,39,149,gender
流行性耳下腺炎,2009,40,2009-W40,62,45,107,149,gender
川崎病,2009,40,2009-W40,1,0,1,149,gender
インフルエンザ,2004,10,2004-W10,130,152,282,178,gender
RSウイルス感染症,2004,10,2004-W10,3,5,8,142,gender
咽頭結膜熱,2004,10,2004-W10,9,5,14,142,gender
Ａ群溶血性レンサ球菌咽頭炎,2004,10,2004-W10,101,89,190,142,gender
感染性胃腸炎,2004,10,2004-W10,623,631,1254,142,gender
水痘,2004,10,2004-W10,107,85,192,142,gender
手足口病,2004,10,2004-W10,0,1,1,142,gender
突発性発しん,2004,10,2004-W10,30,22,52,142,gender
ヘルパンギーナ,2004,10,2004-W10,2,1,3,142,gender
流行性耳下腺炎,2004,10,2004-W10,20,10,30,142,gender
川崎病,2004,10,2004-W10,0,1,1,142,gender
インフルエンザ,2015,39,2015-W39,8,8,16,411,gender
RSウイルス感染症,2015,39,2015-W39,120,89,209,260,gender
咽頭結膜熱,2015,39,2015-W39,22,25,47,260,gender
Ａ群溶血性レンサ球菌咽頭炎,2015,39,2015-W39,88,87,175,260,gender
感染性胃腸炎,2015,39,2015-W39,282,235,517,260,gender
水痘,2015,39,2015-W39,42,31,73,260,gender
手足口病,2015,39,2015-W39,342,252,594,260,gender
突発性発しん,2015,39,2015-W39,56,37,93,260,gender
ヘルパンギーナ,2015,39,2015-W39,55,34,89,260,gender
流行性耳下腺炎,2015,39,2015-W39,48,30,78,260,gender
川崎病,2015,39,2015-W39,1,0,1,260,gender
インフルエンザ,2016,24,2016-W24,6,13,19,413,gender
RSウイルス感染症,2016,24,2016-W24,7,4,11,260,gender
咽頭結膜熱,2016,24,2016-W24,119,119,238,260,gender
Ａ群溶血性レンサ球菌咽頭炎,2016,24,2016-W24,465,375,840,260,gender
感染性胃腸炎,2016,24,2016-W24,906,824,1730,260,gender
水痘,2016,24,2016-W24,61,52,113,260,gender
手足口病,2016,24,2016-W24,52,51,103,260,gender
突発性発しん,2016,24,2016-W24,77,85,162,260,gender
ヘルパンギーナ,2016,24,2016-W24,125,101,226,260,gender
流行性耳下腺炎,2016,24,2016-W24,84,75,159,260,gender
川崎病,2016,24,2016-W24,4,1,5,260,gender
インフルエンザ,2010,23,2010-W23,8,5,13,285,gender
RSウイルス感染症,2010,23,2010-W23,1,4,5,149,gender
咽頭結膜熱,2010,23,2010-W23,29,30,59,149,gender
Ａ群溶血性レンサ球菌咽頭炎,2010,23,2010-W23,192,159,351,149,gender
感染性胃腸炎,2010,23,2010-W23,589,488,1077,149,gender
水痘,2010,23,2010-W23,146,156,302,149,gender
手足口病,2010,23,2010-W23,71,51,122,149,gender
突発性発しん,2010,23,2010-W23,40,51,91,149,gender
ヘルパンギーナ,2010,23,2010-W23,92,66,158,149,gender
流行性耳下腺炎,2010,23,2010-W23,74,70,144,149,gender
川崎病,2010,23,2010-W23,1,1,2,149,gender
インフルエンザ,2012,50,2012-W50,242,225,467,418,gender
RSウイルス感染症,2012,50,2012-W50,77,58,135,263,gender
咽頭結膜熱,2012,50,2012-W50,106,78,184,263,gender
Ａ群溶血性レンサ球菌咽頭炎,2012,50,2012-W50,336,310,646,263,gender
感染性胃腸炎,2012,50,2012-W50,3547,3326,6873,263,gender
水痘,2012,50,2012-W50,181,200,381,263,gender
手足口病,2012,50,2012-W50,63,44,107,263,gender
突発性発しん,2012,50,2012-W50,75,61,136,263,gender
ヘルパンギーナ,2012,50,2012-W50,7,9,16,263,gender
流行性耳下腺炎,2012,50,2012-W50,29,30,59,263,gender
川崎病,2012,50,2012-W50,1,2,3,263,gender
インフルエンザ,2021,18,2021-W18,0,0,0,404,gender
RSウイルス感染症,2021,18,2021-W18,29,29,58,258,gender
咽頭結膜熱,2021,18,2021-W18,12,10,22,258,gender
Ａ群溶血性レンサ球菌咽頭炎,2021,18,2021-W18,30,22,52,258,gender
感染性胃腸炎,2021,18,2021-W18,247,273,520,258,gender
水痘,2021,18,2021-W18,16,11,27,258,gender
手足口病,2021,18,2021-W18,2,3,5,258,gender
突発性発しん,2021,18,2021-W18,46,39,85,258,gender
ヘルパンギーナ,2021,18,2021-W18,1,2,3,258,gender
流行性耳下腺炎,2021,18,2021-W18,5,6,11,258,gender
川崎病,2021,18,2021-W18,1,1,2,258,gender
インフルエンザ,2002,17,2002-W17,4,3,7,178,gender
RSウイルス感染症,2002,17,2002-W17,0,0,0,142,gender
咽頭結膜熱,2002,17,2002-W17,1,2,3,142,gender
Ａ群溶血性レンサ球菌咽頭炎,2002,17,2002-W17,44,45,89,142,gender
感染性胃腸炎,2002,17,2002-W17,283,239,522,142,gender
水痘,2002,17,2002-W17,76,63,139,142,gender
手足口病,2002,17,2002-W17,16,10,26,142,gender
突発性発しん,2002,17,2002-W17,37,40,77,142,gender
ヘルパンギーナ,2002,17,2002-W17,9,10,19,142,gender
流行性耳下腺炎,2002,17,2002-W17,47,44,91,142,gender
川崎病,2002,17,2002-W17,0,0,0,142,gender
インフルエンザ,2015,14,2015-W14,292,288,580,414,gender
RSウイルス感染症,2015,14,2015-W14,21,20,41,262,gender
咽頭結膜熱,2015,14,2015-W14,23,33,56,262,gender
Ａ群溶血性レンサ球菌咽頭炎,2015,14,2015-W14,306,307,613,262,gender
感染性胃腸炎,2015,14,2015-W14,890,871,1761,262,gender
水痘,2015,14,2015-W14,96,90,186,262,gender
手足口病,2015,14,2015-W14,6,11,17,262,gender
突発性発しん,2015,14,2015-W14,73,82,155,262,gender
ヘルパンギーナ,2015,14,2015-W14,4,2,6,262,gender
流行性耳下腺炎,2015,14,2015-W14,33,32,65,262,gender
川崎病,2015,14,2015-W14,0,2,2,262,gender
インフルエンザ,2018,44,2018-W44,43,40,83,412,gender
RSウイルス感染症,2018,44,2018-W44,69,39,108,261,gender
咽頭結膜熱,2018,44,2018-W44,26,27,53,261,gender
Ａ群溶血性レンサ球菌咽頭炎,2018,44,2018-W44,330,263,593,261,gender
感染性胃腸炎,2018,44,2018-W44,693,646,1339,261,gender
水痘,2018,44,2018-W44,46,43,89,261,gender
手足口病,2018,44,2018-W44,184,158,342,261,gender
突発性発しん,2018,44,2018-W44,54,55,109,261,gender
ヘルパンギーナ,2018,44,2018-W44,36,20,56,261,gender
流行性耳下腺炎,2018,44,2018-W44,10,3,13,261,gender
川崎病,2018,44,2018-W44,0,2,2,261,gender
インフルエンザ,2007,20,2007-W20,22,12,34,285,gender
RSウイルス感染症,2007,20,2007-W20,2,2,4,150,gender
咽頭結膜熱,2007,20,2007-W20,56,37,93,150,gender
Ａ群溶血性レンサ球菌咽頭炎,2007,20,2007-W20,218,171,389,150,gender
感染性胃腸炎,2007,20,2007-W20,413,344,757,150,gender
水痘,2007,20,2007-W20,152,123,275,150,gender
手足口病,2007,20,2007-W20,16,8,24,150,gender
突発性発しん,2007,20,2007-W20,67,41,108,150,gender
ヘルパンギーナ,2007,20,2007-W20,13,16,29,150,gender
流行性耳下腺炎,2007,20,2007-W20,27,18,45,150,gender
川崎病,2007,20,2007-W20,1,5,6,150,gender
インフルエンザ,2022,28,2022-W28,3,3,6,405,gender
RSウイルス感染症,2022,28,2022-W28,217,162,379,255,gender
咽頭結膜熱,2022,28,2022-W28,47,25,72,255,gender
Ａ群溶血性レンサ球菌咽頭炎,2022,28,2022-W28,32,23,55,255,gender
感染性胃腸炎,2022,28,2022-W28,675,614,1289,255,gender
水痘,2022,28,2022-W28,11,4,15,255,gender
手足口病,2022,28,2022-W28,342,299,641,255,gender
突発性発しん,2022,28,2022-W28,39,41,80,255,gender
ヘルパンギーナ,2022,28,2022-W28,129,127,256,255,gender
流行性耳下腺炎,2022,28,2022-W28,2,4,6,255,gender
川崎病,2022,28,2022-W28,1,0,1,255,gender
インフルエンザ,2002,5,2002-W05,605,553,1158,178,gender
RSウイルス感染症,2002,5,2002-W05,0,0,0,142,gender
咽頭結膜熱,2002,5,2002-W05,1,6,7,142,gender
Ａ群溶血性レンサ球菌咽頭炎,2002,5,2002-W05,46,57,103,142,gender
感染性胃腸炎,2002,5,2002-W05,703,729,1432,142,gender
水痘,2002,5,2002-W05,75,66,141,142,gender
手足口病,2002,5,2002-W05,3,10,13,142,gender
突発性発しん,2002,5,2002-W05,32,30,62,142,gender
ヘルパンギーナ,2002,5,2002-W05,2,4,6,142,gender
流行性耳下腺炎,2002,5,2002-W05,53,50,103,142,gender
川崎病,2002,5,2002-W05,0,1,1,142,gender
インフルエンザ,2007,9,2007-W09,2737,2733,5470,280,gender
RSウイルス感染症,2007,9,2007-W09,9,3,12,141,gender
咽頭結膜熱,2007,9,2007-W09,11,7,18,141,gender
Ａ群溶血性レンサ球菌咽頭炎,2007,9,2007-W09,187,130,317,141,gender
感染性胃腸炎,2007,9,2007-W09,391,449,840,141,gender
水痘,2007,9,2007-W09,106,90,196,141,gender
手足口病,2007,9,2007-W09,6,5,11,141,gender
突発性発しん,2007,9,2007-W09,41,35,76,141,gender
ヘルパンギーナ,2007,9,2007-W09,2,1,3,141,gender
流行性耳下腺炎,2007,9,2007-W09,14,16,30,141,gender
川崎病,2007,9,2007-W09,1,2,3,141,gender
インフルエンザ,2001,27,2001-W27,0,1,1,178,gender
RSウイルス感染症,2001,27,2001-W27,0,0,0,142,gender
咽頭結膜熱,2001,27,2001-W27,11,10,21,142,gender
Ａ群溶血性レンサ球菌咽頭炎,2001,27,2001-W27,35,26,61,142,gender
感染性胃腸炎,2001,27,2001-W27,125,123,248,142,gender
水痘,2001,27,2001-W27,66,60,126,142,gender
手足口病,2001,27,2001-W27,119,99,218,142,gender
突発性発しん,2001,27,2001-W27,38,40,78,142,gender
ヘルパンギーナ,2001,27,2001-W27,576,510,1086,142,gender
流行性耳下腺炎,2001,27,2001-W27,95,76,171,142,gender
川崎病,2001,27,2001-W27,1,0,1,142,gender
インフルエンザ,2023,46,2023-W46,2622,2460,5082,415,gender
新型コロナウイルス感染症（COVID-19）,2023,46,2023-W46,228,258,486,415,gender
RSウイルス感染症,2023,46,2023-W46,1,2,3,261,gender
咽頭結膜熱,2023,46,2023-W46,489,428,917,261,gender
Ａ群溶血性レンサ球菌咽頭炎,2023,46,2023-W46,669,600,1269,261,gender
感染性胃腸炎,2023,46,2023-W46,776,683,1459,261,gender
水痘,2023,46,2023-W46,35,27,62,261,gender
手足口病,2023,46,2023-W46,100,92,192,261,gender
突発性発しん,2023,46,2023-W46,25,23,48,261,gender
ヘルパンギーナ,2023,46,2023-W46,9,8,17,261,gender
流行性耳下腺炎,2023,46,2023-W46,6,4,10,261,gender
川崎病,2023,46,2023-W46,3,4,7,261,gender
インフルエンザ,2021,6,2021-W06,0,0,0,408,gender
RSウイルス感染症,2021,6,2021-W06,2,2,4,257,gender
咽頭結膜熱,2021,6,2021-W06,15,16,31,257,gender
Ａ群溶血性レンサ球菌咽頭炎,2021,6,2021-W06,45,28,73,257,gender
感染性胃腸炎,2021,6,2021-W06,366,321,687,257,gender
水痘,2021,6,2021-W06,11,9,20,257,gender
手足口病,2021,6,2021-W06,0,4,4,257,gender
突発性発しん,2021,6,2021-W06,55,49,104,257,gender
ヘルパンギーナ,2021,6,2021-W06,0,0,0,257,gender
流行性耳下腺炎,2021,6,2021-W06,3,3,6,257,gender
川崎病,2021,6,2021-W06,3,1,4,257,gender
インフルエンザ,2013,13,2013-W13,188,238,426,416,gender
RSウイルス感染症,2013,13,2013-W13,22,24,46,263,gender
咽頭結膜熱,2013,13,2013-W13,34,33,67,263,gender
Ａ群溶血性レンサ球菌咽頭炎,2013,13,2013-W13,308,263,571,263,gender
感染性胃腸炎,2013,13,2013-W13,1172,1080,2252,263,gender
水痘,2013,13,2013-W13,95,84,179,263,gender
手足口病,2013,13,2013-W13,12,7,19,263,gender
突発性発しん,2013,13,2013-W13,81,78,159,263,gender
ヘルパンギーナ,2013,13,2013-W13,1,1,2,263,gender
流行性耳下腺炎,2013,13,2013-W13,21,16,37,263,gender
川崎病,2013,13,2013-W13,0,4,4,263,gender
インフルエンザ,2021,35,2021-W35,0,0,0,410,gender
RSウイルス感染症,2021,35,2021-W35,131,104,235,258,gender
咽頭結膜熱,2021,35,2021-W35,13,6,19,258,gender
Ａ群溶血性レンサ球菌咽頭炎,2021,35,2021-W35,22,22,44,258,gender
感染性胃腸炎,2021,35,2021-W35,286,281,567,258,gender
水痘,2021,35,2021-W35,6,13,19,258,gender
手足口病,2021,35,2021-W35,8,4,12,258,gender
突発性発しん,2021,35,2021-W35,51,50,101,258,gender
ヘルパンギーナ,2021,35,2021-W35,23,20,43,258,gender
流行性耳下腺炎,2021,35,2021-W35,7,6,13,258,gender
川崎病,2021,35,2021-W35,0,3,3,258,gender
インフルエンザ,2000,49,2000-W49,18,11,29,178,gender
RSウイルス感染症,2000,49,2000-W49,0,0,0,142,gender
咽頭結膜熱,2000,49,2000-W49,4,8,12,142,gender
Ａ群溶血性レンサ球菌咽頭炎,2000,49,2000-W49,36,42,78,142,gender
感染性胃腸炎,2000,49,2000-W49,628,615,1243,142,gender
水痘,2000,49,2000-W49,103,86,189,142,gender
手足口病,2000,49,2000-W49,28,20,48,142,gender
突発性発しん,2000,49,2000-W49,29,40,69,142,gender
ヘルパンギーナ,2000,49,2000-W49,4,2,6,142,gender
流行性耳下腺炎,2000,49,2000-W49,103,78,181,142,gender
川崎病,2000,49,2000-W49,2,0,2,142,gender
インフルエンザ,2022,16,2022-W16,2,0,2,409,gender
RSウイルス感染症,2022,16,2022-W16,8,3,11,257,gender
咽頭結膜熱,2022,16,2022-W16,13,5,18,257,gender
Ａ群溶血性レンサ球菌咽頭炎,2022,16,2022-W16,17,12,29,257,gender
感染性胃腸炎,2022,16,2022-W16,709,662,1371,257,gender
水痘,2022,16,2022-W16,7,8,15,257,gender
手足口病,2022,16,2022-W16,7,5,12,257,gender
突発性発しん,2022,16,2022-W16,61,48,109,257,gender
ヘルパンギーナ,2022,16,2022-W16,1,4,5,257,gender
流行性耳下腺炎,2022,16,2022-W16,6,3,9,257,gender
川崎病,2022,16,2022-W16,3,1,4,257,gender
インフルエンザ,2012,43,2012-W43,6,10,16,415,gender
RSウイルス感染症,2012,43,2012-W43,139,115,254,261,gender
咽頭結膜熱,2012,43,2012-W43,47,35,82,261,gender
Ａ群溶血性レンサ球菌咽頭炎,2012,43,2012-W43,178,164,342,261,gender
感染性胃腸炎,2012,43,2012-W43,652,592,1244,261,gender
水痘,2012,43,2012-W43,81,99,180,261,gender
手足口病,2012,43,2012-W43,58,45,103,261,gender
突発性発しん,2012,43,2012-W43,89,75,164,261,gender
ヘルパンギーナ,2012,43,2012-W43,37,21,58,261,gender
流行性耳下腺炎,2012,43,2012-W43,27,32,59,261,gender
川崎病,2012,43,2012-W43,1,1,2,261,gender
インフルエンザ,2010,30,2010-W30,2,3,5,283,gender
RSウイルス感染症,2010,30,2010-W30,5,2,7,149,gender
咽頭結膜熱,2010,30,2010-W30,31,24,55,149,gender
Ａ群溶血性レンサ球菌咽頭炎,2010,30,2010-W30,47,49,96,149,gender
感染性胃腸炎,2010,30,2010-W30,244,200,444,149,gender
水痘,2010,30,2010-W30,69,43,112,149,gender
手足口病,2010,30,2010-W30,285,179,464,149,gender
突発性発しん,2010,30,2010-W30,51,48,99,149,gender
ヘルパンギーナ,2010,30,2010-W30,366,350,716,149,gender
流行性耳下腺炎,2010,30,2010-W30,69,62,131,149,gender
川崎病,2010,30,2010-W30,0,0,0,149,gender
インフルエンザ,2001,19,2001-W19,6,6,12,178,gender
RSウイルス感染症,2001,19,2001-W19,0,0,0,142,gender
咽頭結膜熱,2001,19,2001-W19,4,3,7,142,gender
Ａ群溶血性レンサ球菌咽頭炎,2001,19,2001-W19,39,30,69,142,gender
感染性胃腸炎,2001,19,2001-W19,244,244,488,142,gender
水痘,2001,19,2001-W19,115,141,256,142,gender
手足口病,2001,19,2001-W19,7,5,12,142,gender
突発性発しん,2001,19,2001-W19,42,36,78,142,gender
ヘルパンギーナ,2001,19,2001-W19,12,5,17,142,gender
流行性耳下腺炎,2001,19,2001-W19,80,58,138,142,gender
川崎病,2001,19,2001-W19,0,4,4,142,gender
インフルエンザ,2009,53,2009-W53,578,567,1145,275,gender
RSウイルス感染症,2009,53,2009-W53,31,39,70,142,gender
咽頭結膜熱,2009,53,2009-W53,5,5,10,142,gender
Ａ群溶血性レンサ球菌咽頭炎,2009,53,2009-W53,26,26,52,142,gender
感染性胃腸炎,2009,53,2009-W53,406,379,785,142,gender
水痘,2009,53,2009-W53,69,49,118,142,gender
手足口病,2009,53,2009-W53,6,4,10,142,gender
突発性発しん,2009,53,2009-W53,21,14,35,142,gender
ヘルパンギーナ,2009,53,2009-W53,4,2,6,142,gender
流行性耳下腺炎,2009,53,2009-W53,22,28,50,142,gender
川崎病,2009,53,2009-W53,1,0,1,142,gender
インフルエンザ,2015,2,2015-W02,4804,5088,9892,414,gender
RSウイルス感染症,2015,2,2015-W02,93,71,164,260,gender
咽頭結膜熱,2015,2,2015-W02,38,32,70,260,gender
Ａ群溶血性レンサ球菌咽頭炎,2015,2,2015-W02,234,193,427,260,gender
感染性胃腸炎,2015,2,2015-W02,1149,1105,2254,260,gender
水痘,2015,2,2015-W02,99,91,190,260,gender
手足口病,2015,2,2015-W02,25,21,46,260,gender
突発性発しん,2015,2,2015-W02,60,41,101,260,gender
ヘルパンギーナ,2015,2,2015-W02,4,2,6,260,gender
流行性耳下腺炎,2015,2,2015-W02,45,40,85,260,gender
川崎病,2015,2,2015-W02,1,2,3,260,gender
インフルエンザ,2014,44,2014-W44,55,38,93,408,gender
RSウイルス感染症,2014,44,2014-W44,154,132,286,259,gender
咽頭結膜熱,2014,44,2014-W44,67,45,112,259,gender
Ａ群溶血性レンサ球菌咽頭炎,2014,44,2014-W44,294,251,545,259,gender
感染性胃腸炎,2014,44,2014-W44,627,628,1255,259,gender
水痘,2014,44,2014-W44,90,83,173,259,gender
手足口病,2014,44,2014-W44,93,82,175,259,gender
突発性発しん,2014,44,2014-W44,87,87,174,259,gender
ヘルパンギーナ,2014,44,2014-W44,23,21,44,259,gender
流行性耳下腺炎,2014,44,2014-W44,30,18,48,259,gender
川崎病,2014,44,2014-W44,0,1,1,259,gender
インフルエンザ,2019,14,2019-W14,217,222,439,409,gender
RSウイルス感染症,2019,14,2019-W14,43,26,69,255,gender
咽頭結膜熱,2019,14,2019-W14,17,19,36,255,gender
Ａ群溶血性レンサ球菌咽頭炎,2019,14,2019-W14,223,188,411,255,gender
感染性胃腸炎,2019,14,2019-W14,806,772,1578,255,gender
水痘,2019,14,2019-W14,53,49,102,255,gender
手足口病,2019,14,2019-W14,5,10,15,255,gender
突発性発しん,2019,14,2019-W14,53,57,110,255,gender
ヘルパンギーナ,2019,14,2019-W14,2,4,6,255,gender
流行性耳下腺炎,2019,14,2019-W14,7,13,20,255,gender
川崎病,2019,14,2019-W14,5,1,6,255,gender
インフルエンザ,2024,11,2024-W11,3177,2670,5847,415,gender
新型コロナウイルス感染症（COVID-19）,2024,11,2024-W11,723,814,1537,415,gender
RSウイルス感染症,2024,11,2024-W11,67,53,120,262,gender
咽頭結膜熱,2024,11,2024-W11,31,33,64,262,gender
Ａ群溶血性レンサ球菌咽頭炎,2024,11,2024-W11,505,409,914,262,gender
感染性胃腸炎,2024,11,2024-W11,771,624,1395,262,gender
水痘,2024,11,2024-W11,19,29,48,262,gender
手足口病,2024,11,2024-W11,3,5,8,262,gender
突発性発しん,2024,11,2024-W11,27,37,64,262,gender
ヘルパンギーナ,2024,11,2024-W11,1,2,3,262,gender
流行性耳下腺炎,2024,11,2024-W11,6,7,13,262,gender
川崎病,2024,11,2024-W11,2,2,4,262,gender
インフルエンザ,2016,37,2016-W37,26,28,54,407,gender
RSウイルス感染症,2016,37,2016-W37,319,257,576,260,gender
咽頭結膜熱,2016,37,2016-W37,55,35,90,260,gender
Ａ群溶血性レンサ球菌咽頭炎,2016,37,2016-W37,230,181,411,260,gender
感染性胃腸炎,2016,37,2016-W37,599,525,1124,260,gender
水痘,2016,37,2016-W37,33,24,57,260,gender
手足口病,2016,37,2016-W37,186,151,337,260,gender
突発性発しん,2016,37,2016-W37,96,83,179,260,gender
ヘルパンギーナ,2016,37,2016-W37,165,172,337,260,gender
流行性耳下腺炎,2016,37,2016-W37,96,91,187,260,gender
川崎病,2016,37,2016-W37,2,2,4,260,gender
インフルエンザ,2023,37,2023-W37,2662,2080,4742,417,gender
新型コロナウイルス感染症（COVID-19）,2023,37,2023-W37,3265,3423,6688,417,gender
RSウイルス感染症,2023,37,2023-W37,17,24,41,262,gender
咽頭結膜熱,2023,37,2023-W37,230,196,426,262,gender
Ａ群溶血性レンサ球菌咽頭炎,2023,37,2023-W37,244,218,462,262,gender
感染性胃腸炎,2023,37,2023-W37,541,449,990,262,gender
水痘,2023,37,2023-W37,9,13,22,262,gender
手足口病,2023,37,2023-W37,243,226,469,262,gender
突発性発しん,2023,37,2023-W37,42,48,90,262,gender
ヘルパンギーナ,2023,37,2023-W37,80,76,156,262,gender
流行性耳下腺炎,2023,37,2023-W37,8,5,13,262,gender
川崎病,2023,37,2023-W37,0,2,2,262,gender
インフルエンザ,2011,11,2011-W11,3109,3207,6316,414,gender
RSウイルス感染症,2011,11,2011-W11,15,7,22,259,gender
咽頭結膜熱,2011,11,2011-W11,38,35,73,259,gender
Ａ群溶血性レンサ球菌咽頭炎,2011,11,2011-W11,277,247,524,259,gender
感染性胃腸炎,2011,11,2011-W11,1148,962,2110,259,gender
水痘,2011,11,2011-W11,160,146,306,259,gender
手足口病,2011,11,2011-W11,8,2,10,259,gender
突発性発しん,2011,11,2011-W11,56,68,124,259,gender
ヘルパンギーナ,2011,11,2011-W11,1,1,2,259,gender
流行性耳下腺炎,2011,11,2011-W11,37,29,66,259,gender
川崎病,2011,11,2011-W11,4,2,6,259,gender
インフルエンザ,2004,8,2004-W08,515,568,1083,178,gender
RSウイルス感染症,2004,8,2004-W08,4,2,6,142,gender
咽頭結膜熱,2004,8,2004-W08,6,7,13,142,gender
Ａ群溶血性レンサ球菌咽頭炎,2004,8,2004-W08,92,69,161,142,gender
感染性胃腸炎,2004,8,2004-W08,662,550,1212,142,gender
水痘,2004,8,2004-W08,110,63,173,142,gender
手足口病,2004,8,2004-W08,1,0,1,142,gender
突発性発しん,2004,8,2004-W08,37,25,62,142,gender
ヘルパンギーナ,2004,8,2004-W08,2,2,4,142,gender
流行性耳下腺炎,2004,8,2004-W08,15,10,25,142,gender
川崎病,2004,8,2004-W08,3,1,4,142,gender
インフルエンザ,2001,4,2001-W04,73,57,130,178,gender
RSウイルス感染症,2001,4,2001-W04,0,0,0,142,gender
咽頭結膜熱,2001,4,2001-W04,3,2,5,142,gender
Ａ群溶血性レンサ球菌咽頭炎,2001,4,2001-W04,26,38,64,142,gender
感染性胃腸炎,2001,4,2001-W04,552,635,1187,142,gender
水痘,2001,4,2001-W04,82,80,162,142,gender
手足口病,2001,4,2001-W04,4,2,6,142,gender
突発性発しん,2001,4,2001-W04,38,33,71,142,gender
ヘルパンギーナ,2001,4,2001-W04,1,3,4,142,gender
流行性耳下腺炎,2001,4,2001-W04,48,41,89,142,gender
川崎病,2001,4,2001-W04,2,1,3,142,gender
インフルエンザ,2021,44,2021-W44,0,0,0,413,gender
RSウイルス感染症,2021,44,2021-W44,8,5,13,260,gender
咽頭結膜熱,2021,44,2021-W44,15,16,31,260,gender
Ａ群溶血性レンサ球菌咽頭炎,2021,44,2021-W44,35,28,63,260,gender
感染性胃腸炎,2021,44,2021-W44,416,311,727,260,gender
水痘,2021,44,2021-W44,18,15,33,260,gender
手足口病,2021,44,2021-W44,67,56,123,260,gender
突発性発しん,2021,44,2021-W44,57,46,103,260,gender
ヘルパンギーナ,2021,44,2021-W44,93,86,179,260,gender
流行性耳下腺炎,2021,44,2021-W44,6,6,12,260,gender
川崎病,2021,44,2021-W44,0,0,0,260,gender
インフルエンザ,2000,38,2000-W38,2,2,4,178,gender
RSウイルス感染症,2000,38,2000-W38,0,0,0,142,gender
咽頭結膜熱,2000,38,2000-W38,10,1,11,142,gender
Ａ群溶血性レンサ球菌咽頭炎,2000,38,2000-W38,11,18,29,142,gender
感染性胃腸炎,2000,38,2000-W38,127,100,227,142,gender
水痘,2000,38,2000-W38,22,15,37,142,gender
手足口病,2000,38,2000-W38,116,110,226,142,gender
突発性発しん,2000,38,2000-W38,52,37,89,142,gender
ヘルパンギーナ,2000,38,2000-W38,28,28,56,142,gender
流行性耳下腺炎,2000,38,2000-W38,40,30,70,142,gender
川崎病,2000,38,2000-W38,1,0,1,142,gender
インフルエンザ,2003,25,2003-W25,0,0,0,178,gender
RSウイルス感染症,2003,25,2003-W25,0,0,0,142,gender
咽頭結膜熱,2003,25,2003-W25,37,37,74,142,gender
Ａ群溶血性レンサ球菌咽頭炎,2003,25,2003-W25,72,79,151,142,gender
感染性胃腸炎,2003,25,2003-W25,229,196,425,142,gender
水痘,2003,25,2003-W25,83,59,142,142,gender
手足口病,2003,25,2003-W25,201,132,333,142,gender
突発性発しん,2003,25,2003-W25,37,50,87,142,gender
ヘルパンギーナ,2003,25,2003-W25,80,66,146,142,gender
流行性耳下腺炎,2003,25,2003-W25,13,12,25,142,gender
川崎病,2003,25,2003-W25,2,0,2,142,gender
インフルエンザ,2022,7,2022-W07,0,0,0,408,gender
RSウイルス感染症,2022,7,2022-W07,1,2,3,257,gender
咽頭結膜熱,2022,7,2022-W07,11,2,13,257,gender
Ａ群溶血性レンサ球菌咽頭炎,2022,7,2022-W07,15,13,28,257,gender
感染性胃腸炎,2022,7,2022-W07,669,575,1244,257,gender
水痘,2022,7,2022-W07,9,7,16,257,gender
手足口病,2022,7,2022-W07,6,5,11,257,gender
突発性発しん,2022,7,2022-W07,29,38,67,257,gender
ヘルパンギーナ,2022,7,2022-W07,0,0,0,257,gender
流行性耳下腺炎,2022,7,2022-W07,7,5,12,257,gender
川崎病,2022,7,2022-W07,3,1,4,257,gender
インフルエンザ,2005,22,2005-W22,7,3,10,178,gender
RSウイルス感染症,2005,22,2005-W22,1,2,3,142,gender
咽頭結膜熱,2005,22,2005-W22,29,21,50,142,gender
Ａ群溶血性レンサ球菌咽頭炎,2005,22,2005-W22,141,101,242,142,gender
感染性胃腸炎,2005,22,2005-W22,401,372,773,142,gender
水痘,2005,22,2005-W22,110,86,196,142,gender
手足口病,2005,22,2005-W22,23,25,48,142,gender
突発性発しん,2005,22,2005-W22,43,38,81,142,gender
ヘルパンギーナ,2005,22,2005-W22,57,44,101,142,gender
流行性耳下腺炎,2005,22,2005-W22,95,98,193,142,gender
川崎病,2005,22,2005-W22,2,1,3,142,gender
インフルエンザ,2007,51,2007-W51,1323,1213,2536,288,gender
RSウイルス感染症,2007,51,2007-W51,73,53,126,150,gender
咽頭結膜熱,2007,51,2007-W51,27,20,47,150,gender
Ａ群溶血性レンサ球菌咽頭炎,2007,51,2007-W51,181,156,337,150,gender
感染性胃腸炎,2007,51,2007-W51,1613,1535,3148,150,gender
水痘,2007,51,2007-W51,128,117,245,150,gender
手足口病,2007,51,2007-W51,18,11,29,150,gender
突発性発しん,2007,51,2007-W51,31,40,71,150,gender
ヘルパンギーナ,2007,51,2007-W51,8,2,10,150,gender
流行性耳下腺炎,2007,51,2007-W51,22,17,39,150,gender
川崎病,2007,51,2007-W51,1,1,2,150,gender
インフルエンザ,2018,35,2018-W35,6,4,10,408,gender
RSウイルス感染症,2018,35,2018-W35,277,232,509,254,gender
咽頭結膜熱,2018,35,2018-W35,37,31,68,254,gender
Ａ群溶血性レンサ球菌咽頭炎,2018,35,2018-W35,165,159,324,254,gender
感染性胃腸炎,2018,35,2018-W35,501,410,911,254,gender
水痘,2018,35,2018-W35,20,25,45,254,gender
手足口病,2018,35,2018-W35,124,105,229,254,gender
突発性発しん,2018,35,2018-W35,64,70,134,254,gender
ヘルパンギーナ,2018,35,2018-W35,185,194,379,254,gender
流行性耳下腺炎,2018,35,2018-W35,22,7,29,254,gender
川崎病,2018,35,2018-W35,4,4,8,254,gender
インフルエンザ,2017,16,2017-W16,895,977,1872,414,gender
RSウイルス感染症,2017,16,2017-W16,35,37,72,262,gender
咽頭結膜熱,2017,16,2017-W16,41,41,82,262,gender
Ａ群溶血性レンサ球菌咽頭炎,2017,16,2017-W16,354,309,663,262,gender
感染性胃腸炎,2017,16,2017-W16,1180,1046,2226,262,gender
水痘,2017,16,2017-W16,50,34,84,262,gender
手足口病,2017,16,2017-W16,20,13,33,262,gender
突発性発しん,2017,16,2017-W16,91,83,174,262,gender
ヘルパンギーナ,2017,16,2017-W16,2,1,3,262,gender
流行性耳下腺炎,2017,16,2017-W16,18,23,41,262,gender
川崎病,2017,16,2017-W16,1,3,4,262,gender
インフルエンザ,2014,35,2014-W35,4,2,6,406,gender
RSウイルス感染症,2014,35,2014-W35,48,31,79,258,gender
咽頭結膜熱,2014,35,2014-W35,61,44,105,258,gender
Ａ群溶血性レンサ球菌咽頭炎,2014,35,2014-W35,116,85,201,258,gender
感染性胃腸炎,2014,35,2014-W35,459,370,829,258,gender
水痘,2014,35,2014-W35,61,42,103,258,gender
手足口病,2014,35,2014-W35,139,124,263,258,gender
突発性発しん,2014,35,2014-W35,85,82,167,258,gender
ヘルパンギーナ,2014,35,2014-W35,261,209,470,258,gender
流行性耳下腺炎,2014,35,2014-W35,69,41,110,258,gender
川崎病,2014,35,2014-W35,1,1,2,258,gender
インフルエンザ,2016,46,2016-W46,352,300,652,416,gender
RSウイルス感染症,2016,46,2016-W46,78,56,134,263,gender
咽頭結膜熱,2016,46,2016-W46,48,29,77,263,gender
Ａ群溶血性レンサ球菌咽頭炎,2016,46,2016-W46,283,261,544,263,gender
感染性胃腸炎,2016,46,2016-W46,2698,2624,5322,263,gender
水痘,2016,46,2016-W46,64,65,129,263,gender
手足口病,2016,46,2016-W46,110,87,197,263,gender
突発性発しん,2016,46,2016-W46,72,70,142,263,gender
ヘルパンギーナ,2016,46,2016-W46,22,28,50,263,gender
流行性耳下腺炎,2016,46,2016-W46,85,96,181,263,gender
川崎病,2016,46,2016-W46,3,2,5,263,gender
インフルエンザ,2016,3,2016-W03,2377,2265,4642,415,gender
RSウイルス感染症,2016,3,2016-W03,54,58,112,262,gender
咽頭結膜熱,2016,3,2016-W03,45,33,78,262,gender
Ａ群溶血性レンサ球菌咽頭炎,2016,3,2016-W03,439,355,794,262,gender
感染性胃腸炎,2016,3,2016-W03,1189,1086,2275,262,gender
水痘,2016,3,2016-W03,70,70,140,262,gender
手足口病,2016,3,2016-W03,4,3,7,262,gender
突発性発しん,2016,3,2016-W03,67,44,111,262,gender
ヘルパンギーナ,2016,3,2016-W03,1,1,2,262,gender
流行性耳下腺炎,2016,3,2016-W03,66,52,118,262,gender
川崎病,2016,3,2016-W03,1,3,4,262,gender
インフルエンザ,2009,22,2009-W22,51,33,84,287,gender
RSウイルス感染症,2009,22,2009-W22,4,3,7,148,gender
咽頭結膜熱,2009,22,2009-W22,25,17,42,148,gender
Ａ群溶血性レンサ球菌咽頭炎,2009,22,2009-W22,133,124,257,148,gender
感染性胃腸炎,2009,22,2009-W22,397,369,766,148,gender
水痘,2009,22,2009-W22,88,66,154,148,gender
手足口病,2009,22,2009-W22,7,7,14,148,gender
突発性発しん,2009,22,2009-W22,50,51,101,148,gender
ヘルパンギーナ,2009,22,2009-W22,9,7,16,148,gender
流行性耳下腺炎,2009,22,2009-W22,63,53,116,148,gender
川崎病,2009,22,2009-W22,0,0,0,148,gender
インフルエンザ,2017,28,2017-W28,15,16,31,386,gender
RSウイルス感染症,2017,28,2017-W28,96,82,178,257,gender
咽頭結膜熱,2017,28,2017-W28,144,122,266,257,gender
Ａ群溶血性レンサ球菌咽頭炎,2017,28,2017-W28,317,336,653,257,gender
感染性胃腸炎,2017,28,2017-W28,790,642,1432,257,gender
水痘,2017,28,2017-W28,52,35,87,257,gender
手足口病,2017,28,2017-W28,980,784,1764,257,gender
突発性発しん,2017,28,2017-W28,98,66,164,257,gender
ヘルパンギーナ,2017,28,2017-W28,198,214,412,257,gender
流行性耳下腺炎,2017,28,2017-W28,47,40,87,257,gender
川崎病,2017,28,2017-W28,1,2,3,257,gender
インフルエンザ,2018,1,2018-W01,2145,2212,4357,404,gender
RSウイルス感染症,2018,1,2018-W01,32,22,54,253,gender
咽頭結膜熱,2018,1,2018-W01,26,20,46,253,gender
Ａ群溶血性レンサ球菌咽頭炎,2018,1,2018-W01,128,99,227,253,gender
感染性胃腸炎,2018,1,2018-W01,388,375,763,253,gender
水痘,2018,1,2018-W01,52,56,108,253,gender
手足口病,2018,1,2018-W01,6,4,10,253,gender
突発性発しん,2018,1,2018-W01,32,20,52,253,gender
ヘルパンギーナ,2018,1,2018-W01,0,0,0,253,gender
流行性耳下腺炎,2018,1,2018-W01,8,8,16,253,gender
川崎病,2018,1,2018-W01,0,0,0,253,gender
インフルエンザ,2012,32,2012-W32,3,2,5,375,gender
RSウイルス感染症,2012,32,2012-W32,62,55,117,247,gender
咽頭結膜熱,2012,32,2012-W32,61,51,112,247,gender
Ａ群溶血性レンサ球菌咽頭炎,2012,32,2012-W32,114,89,203,247,gender
感染性胃腸炎,2012,32,2012-W32,445,391,836,247,gender
水痘,2012,32,2012-W32,59,55,114,247,gender
手足口病,2012,32,2012-W32,123,123,246,247,gender
突発性発しん,2012,32,2012-W32,77,91,168,247,gender
ヘルパンギーナ,2012,32,2012-W32,454,377,831,247,gender
流行性耳下腺炎,2012,32,2012-W32,39,24,63,247,gender
川崎病,2012,32,2012-W32,4,1,5,247,gender
インフルエンザ,2010,41,2010-W41,17,8,25,285,gender
RSウイルス感染症,2010,41,2010-W41,20,10,30,148,gender
咽頭結膜熱,2010,41,2010-W41,13,10,23,148,gender
Ａ群溶血性レンサ球菌咽頭炎,2010,41,2010-W41,72,66,138,148,gender
感染性胃腸炎,2010,41,2010-W41,265,210,475,148,gender
水痘,2010,41,2010-W41,54,50,104,148,gender
手足口病,2010,41,2010-W41,39,25,64,148,gender
突発性発しん,2010,41,2010-W41,38,44,82,148,gender
ヘルパンギーナ,2010,41,2010-W41,4,9,13,148,gender
流行性耳下腺炎,2010,41,2010-W41,32,35,67,148,gender
川崎病,2010,41,2010-W41,0,0,0,148,gender
インフルエンザ,2020,14,2020-W14,7,6,13,413,gender
RSウイルス感染症,2020,14,2020-W14,3,3,6,259,gender
咽頭結膜熱,2020,14,2020-W14,5,9,14,259,gender
Ａ群溶血性レンサ球菌咽頭炎,2020,14,2020-W14,147,145,292,259,gender
感染性胃腸炎,2020,14,2020-W14,288,249,537,259,gender
水痘,2020,14,2020-W14,31,51,82,259,gender
手足口病,2020,14,2020-W14,3,4,7,259,gender
突発性発しん,2020,14,2020-W14,39,41,80,259,gender
ヘルパンギーナ,2020,14,2020-W14,3,3,6,259,gender
流行性耳下腺炎,2020,14,2020-W14,6,3,9,259,gender
川崎病,2020,14,2020-W14,1,1,2,259,gender
インフルエンザ,2011,20,2011-W20,96,106,202,417,gender
RSウイルス感染症,2011,20,2011-W20,10,3,13,263,gender
咽頭結膜熱,2011,20,2011-W20,70,38,108,263,gender
Ａ群溶血性レンサ球菌咽頭炎,2011,20,2011-W20,415,326,741,263,gender
感染性胃腸炎,2011,20,2011-W20,948,869,1817,263,gender
水痘,2011,20,2011-W20,167,145,312,263,gender
手足口病,2011,20,2011-W20,22,10,32,263,gender
突発性発しん,2011,20,2011-W20,84,94,178,263,gender
ヘルパンギーナ,2011,20,2011-W20,9,8,17,263,gender
流行性耳下腺炎,2011,20,2011-W20,53,43,96,263,gender
川崎病,2011,20,2011-W20,4,3,7,263,gender
インフルエンザ,2003,14,2003-W14,23,37,60,178,gender
RSウイルス感染症,2003,14,2003-W14,0,0,0,142,gender
咽頭結膜熱,2003,14,2003-W14,3,5,8,142,gender
Ａ群溶血性レンサ球菌咽頭炎,2003,14,2003-W14,29,36,65,142,gender
感染性胃腸炎,2003,14,2003-W14,319,273,592,142,gender
水痘,2003,14,2003-W14,59,62,121,142,gender
手足口病,2003,14,2003-W14,7,5,12,142,gender
突発性発しん,2003,14,2003-W14,39,40,79,142,gender
ヘルパンギーナ,2003,14,2003-W14,3,1,4,142,gender
流行性耳下腺炎,2003,14,2003-W14,27,13,40,142,gender
川崎病,2003,14,2003-W14,1,2,3,142,gender
インフルエンザ,2016,49,2016-W49,876,799,1675,417,gender
RSウイルス感染症,2016,49,2016-W49,40,42,82,263,gender
咽頭結膜熱,2016,49,2016-W49,70,49,119,263,gender
Ａ群溶血性レンサ球菌咽頭炎,2016,49,2016-W49,390,351,741,263,gender
感染性胃腸炎,2016,49,2016-W49,3665,3499,7164,263,gender
水痘,2016,49,2016-W49,71,89,160,263,gender
手足口病,2016,49,2016-W49,63,54,117,263,gender
突発性発しん,2016,49,2016-W49,66,59,125,263,gender
ヘルパンギーナ,2016,49,2016-W49,6,9,15,263,gender
流行性耳下腺炎,2016,49,2016-W49,76,68,144,263,gender
川崎病,2016,49,2016-W49,1,1,2,263,gender
インフルエンザ,2008,43,2008-W43,4,5,9,283,gender
RSウイルス感染症,2008,43,2008-W43,63,50,113,147,gender
咽頭結膜熱,2008,43,2008-W43,16,12,28,147,gender
Ａ群溶血性レンサ球菌咽頭炎,2008,43,2008-W43,108,124,232,147,gender
感染性胃腸炎,2008,43,2008-W43,323,282,605,147,gender
水痘,2008,43,2008-W43,48,36,84,147,gender
手足口病,2008,43,2008-W43,98,68,166,147,gender
突発性発しん,2008,43,2008-W43,50,61,111,147,gender
ヘルパンギーナ,2008,43,2008-W43,16,11,27,147,gender
流行性耳下腺炎,2008,43,2008-W43,44,40,84,147,gender
川崎病,2008,43,2008-W43,0,1,1,147,gender
インフルエンザ,2005,13,2005-W13,293,295,588,178,gender
RSウイルス感染症,2005,13,2005-W13,5,5,10,142,gender
咽頭結膜熱,2005,13,2005-W13,7,7,14,142,gender
Ａ群溶血性レンサ球菌咽頭炎,2005,13,2005-W13,58,28,86,142,gender
感染性胃腸炎,2005,13,2005-W13,363,333,696,142,gender
水痘,2005,13,2005-W13,61,82,143,142,gender
手足口病,2005,13,2005-W13,6,3,9,142,gender
突発性発しん,2005,13,2005-W13,27,30,57,142,gender
ヘルパンギーナ,2005,13,2005-W13,1,2,3,142,gender
流行性耳下腺炎,2005,13,2005-W13,83,65,148,142,gender
川崎病,2005,13,2005-W13,0,0,0,142,gender
インフルエンザ,2017,27,2017-W27,22,23,45,413,gender
RSウイルス感染症,2017,27,2017-W27,66,50,116,261,gender
咽頭結膜熱,2017,27,2017-W27,144,111,255,261,gender
Ａ群溶血性レンサ球菌咽頭炎,2017,27,2017-W27,405,363,768,261,gender
感染性胃腸炎,2017,27,2017-W27,744,660,1404,261,gender
水痘,2017,27,2017-W27,50,58,108,261,gender
手足口病,2017,27,2017-W27,604,486,1090,261,gender
突発性発しん,2017,27,2017-W27,83,85,168,261,gender
ヘルパンギーナ,2017,27,2017-W27,153,161,314,261,gender
流行性耳下腺炎,2017,27,2017-W27,55,36,91,261,gender
川崎病,2017,27,2017-W27,4,0,4,261,gender
インフルエンザ,2024,51,2024-W51,8635,8092,16727,418,gender
新型コロナウイルス感染症（COVID-19）,2024,51,2024-W51,653,726,1379,418,gender
RSウイルス感染症,2024,51,2024-W51,40,31,71,264,gender
咽頭結膜熱,2024,51,2024-W51,46,34,80,264,gender
Ａ群溶血性レンサ球菌咽頭炎,2024,51,2024-W51,438,389,827,264,gender
感染性胃腸炎,2024,51,2024-W51,965,818,1783,264,gender
水痘,2024,51,2024-W51,84,73,157,264,gender
手足口病,2024,51,2024-W51,105,65,170,264,gender
突発性発しん,2024,51,2024-W51,35,35,70,264,gender
ヘルパンギーナ,2024,51,2024-W51,3,1,4,264,gender
流行性耳下腺炎,2024,51,2024-W51,12,5,17,264,gender
川崎病,2024,51,2024-W51,2,3,5,264,gender
インフルエンザ,2017,19,2017-W19,232,264,496,415,gender
RSウイルス感染症,2017,19,2017-W19,23,17,40,262,gender
咽頭結膜熱,2017,19,2017-W19,81,61,142,262,gender
Ａ群溶血性レンサ球菌咽頭炎,2017,19,2017-W19,410,336,746,262,gender
感染性胃腸炎,2017,19,2017-W19,1084,967,2051,262,gender
水痘,2017,19,2017-W19,90,86,176,262,gender
手足口病,2017,19,2017-W19,31,30,61,262,gender
突発性発しん,2017,19,2017-W19,102,101,203,262,gender
ヘルパンギーナ,2017,19,2017-W19,6,4,10,262,gender
流行性耳下腺炎,2017,19,2017-W19,29,25,54,262,gender
川崎病,2017,19,2017-W19,0,2,2,262,gender
インフルエンザ,2006,30,2006-W30,0,1,1,178,gender
RSウイルス感染症,2006,30,2006-W30,1,3,4,142,gender
咽頭結膜熱,2006,30,2006-W30,112,88,200,142,gender
Ａ群溶血性レンサ球菌咽頭炎,2006,30,2006-W30,61,67,128,142,gender
感染性胃腸炎,2006,30,2006-W30,223,165,388,142,gender
水痘,2006,30,2006-W30,48,50,98,142,gender
手足口病,2006,30,2006-W30,74,59,133,142,gender
突発性発しん,2006,30,2006-W30,49,57,106,142,gender
ヘルパンギーナ,2006,30,2006-W30,110,96,206,142,gender
流行性耳下腺炎,2006,30,2006-W30,56,43,99,142,gender
川崎病,2006,30,2006-W30,1,0,1,142,gender
インフルエンザ,2009,13,2009-W13,1279,1220,2499,287,gender
RSウイルス感染症,2009,13,2009-W13,4,4,8,148,gender
咽頭結膜熱,2009,13,2009-W13,16,14,30,148,gender
Ａ群溶血性レンサ球菌咽頭炎,2009,13,2009-W13,135,112,247,148,gender
感染性胃腸炎,2009,13,2009-W13,401,427,828,148,gender
水痘,2009,13,2009-W13,93,81,174,148,gender
手足口病,2009,13,2009-W13,2,5,7,148,gender
突発性発しん,2009,13,2009-W13,33,25,58,148,gender
ヘルパンギーナ,2009,13,2009-W13,1,2,3,148,gender
流行性耳下腺炎,2009,13,2009-W13,70,44,114,148,gender
川崎病,2009,13,2009-W13,1,0,1,148,gender
インフルエンザ,2004,43,2004-W43,13,11,24,178,gender
RSウイルス感染症,2004,43,2004-W43,1,2,3,142,gender
咽頭結膜熱,2004,43,2004-W43,7,5,12,142,gender
Ａ群溶血性レンサ球菌咽頭炎,2004,43,2004-W43,32,30,62,142,gender
感染性胃腸炎,2004,43,2004-W43,185,157,342,142,gender
水痘,2004,43,2004-W43,42,40,82,142,gender
手足口病,2004,43,2004-W43,83,68,151,142,gender
突発性発しん,2004,43,2004-W43,38,46,84,142,gender
ヘルパンギーナ,2004,43,2004-W43,7,5,12,142,gender
流行性耳下腺炎,2004,43,2004-W43,43,38,81,142,gender
川崎病,2004,43,2004-W43,0,0,0,142,gender
インフルエンザ,2000,37,2000-W37,0,1,1,178,gender
RSウイルス感染症,2000,37,2000-W37,0,0,0,142,gender
咽頭結膜熱,2000,37,2000-W37,5,7,12,142,gender
Ａ群溶血性レンサ球菌咽頭炎,2000,37,2000-W37,16,13,29,142,gender
感染性胃腸炎,2000,37,2000-W37,118,106,224,142,gender
水痘,2000,37,2000-W37,26,17,43,142,gender
手足口病,2000,37,2000-W37,100,90,190,142,gender
突発性発しん,2000,37,2000-W37,46,46,92,142,gender
ヘルパンギーナ,2000,37,2000-W37,30,26,56,142,gender
流行性耳下腺炎,2000,37,2000-W37,51,34,85,142,gender
川崎病,2000,37,2000-W37,0,1,1,142,gender
インフルエンザ,2004,7,2004-W07,873,998,1871,178,gender
RSウイルス感染症,2004,7,2004-W07,2,6,8,142,gender
咽頭結膜熱,2004,7,2004-W07,12,6,18,142,gender
Ａ群溶血性レンサ球菌咽頭炎,2004,7,2004-W07,70,44,114,142,gender
感染性胃腸炎,2004,7,2004-W07,487,453,940,142,gender
水痘,2004,7,2004-W07,83,77,160,142,gender
手足口病,2004,7,2004-W07,3,2,5,142,gender
突発性発しん,2004,7,2004-W07,35,26,61,142,gender
ヘルパンギーナ,2004,7,2004-W07,3,1,4,142,gender
流行性耳下腺炎,2004,7,2004-W07,18,19,37,142,gender
川崎病,2004,7,2004-W07,1,0,1,142,gender
インフルエンザ,2023,38,2023-W38,2746,2314,5060,415,gender
新型コロナウイルス感染症（COVID-19）,2023,38,2023-W38,1714,1974,3688,415,gender
RSウイルス感染症,2023,38,2023-W38,6,8,14,260,gender
咽頭結膜熱,2023,38,2023-W38,219,184,403,260,gender
Ａ群溶血性レンサ球菌咽頭炎,2023,38,2023-W38,208,175,383,260,gender
感染性胃腸炎,2023,38,2023-W38,398,319,717,260,gender
水痘,2023,38,2023-W38,19,14,33,260,gender
手足口病,2023,38,2023-W38,236,193,429,260,gender
突発性発しん,2023,38,2023-W38,26,26,52,260,gender
ヘルパンギーナ,2023,38,2023-W38,71,51,122,260,gender
流行性耳下腺炎,2023,38,2023-W38,4,7,11,260,gender
川崎病,2023,38,2023-W38,3,0,3,260,gender
インフルエンザ,2002,44,2002-W44,2,0,2,178,gender
RSウイルス感染症,2002,44,2002-W44,0,0,0,142,gender
咽頭結膜熱,2002,44,2002-W44,2,3,5,142,gender
Ａ群溶血性レンサ球菌咽頭炎,2002,44,2002-W44,30,21,51,142,gender
感染性胃腸炎,2002,44,2002-W44,276,238,514,142,gender
水痘,2002,44,2002-W44,45,23,68,142,gender
手足口病,2002,44,2002-W44,25,14,39,142,gender
突発性発しん,2002,44,2002-W44,33,29,62,142,gender
ヘルパンギーナ,2002,44,2002-W44,12,8,20,142,gender
流行性耳下腺炎,2002,44,2002-W44,18,20,38,142,gender
川崎病,2002,44,2002-W44,0,0,0,142,gender
インフルエンザ,2020,25,2020-W25,0,0,0,413,gender
RSウイルス感染症,2020,25,2020-W25,0,0,0,259,gender
咽頭結膜熱,2020,25,2020-W25,3,0,3,259,gender
Ａ群溶血性レンサ球菌咽頭炎,2020,25,2020-W25,49,38,87,259,gender
感染性胃腸炎,2020,25,2020-W25,275,241,516,259,gender
水痘,2020,25,2020-W25,3,4,7,259,gender
手足口病,2020,25,2020-W25,20,16,36,259,gender
突発性発しん,2020,25,2020-W25,63,69,132,259,gender
ヘルパンギーナ,2020,25,2020-W25,4,6,10,259,gender
流行性耳下腺炎,2020,25,2020-W25,13,7,20,259,gender
川崎病,2020,25,2020-W25,0,1,1,259,gender
インフルエンザ,2022,8,2022-W08,0,0,0,407,gender
RSウイルス感染症,2022,8,2022-W08,2,1,3,254,gender
咽頭結膜熱,2022,8,2022-W08,0,0,0,254,gender
Ａ群溶血性レンサ球菌咽頭炎,2022,8,2022-W08,6,6,12,254,gender
感染性胃腸炎,2022,8,2022-W08,518,484,1002,254,gender
水痘,2022,8,2022-W08,2,3,5,254,gender
手足口病,2022,8,2022-W08,2,1,3,254,gender
突発性発しん,2022,8,2022-W08,18,18,36,254,gender
ヘルパンギーナ,2022,8,2022-W08,0,0,0,254,gender
流行性耳下腺炎,2022,8,2022-W08,5,4,9,254,gender
川崎病,2022,8,2022-W08,0,1,1,254,gender
インフルエンザ,2010,1,2010-W01,761,837,1598,288,gender
RSウイルス感染症,2010,1,2010-W01,36,22,58,148,gender
咽頭結膜熱,2010,1,2010-W01,6,3,9,148,gender
Ａ群溶血性レンサ球菌咽頭炎,2010,1,2010-W01,63,53,116,148,gender
感染性胃腸炎,2010,1,2010-W01,768,730,1498,148,gender
水痘,2010,1,2010-W01,98,105,203,148,gender
手足口病,2010,1,2010-W01,6,5,11,148,gender
突発性発しん,2010,1,2010-W01,32,35,67,148,gender
ヘルパンギーナ,2010,1,2010-W01,0,3,3,148,gender
流行性耳下腺炎,2010,1,2010-W01,83,68,151,148,gender
川崎病,2010,1,2010-W01,0,0,0,148,gender
インフルエンザ,2015,25,2015-W25,8,13,21,414,gender
RSウイルス感染症,2015,25,2015-W25,13,1,14,261,gender
咽頭結膜熱,2015,25,2015-W25,103,89,192,261,gender
Ａ群溶血性レンサ球菌咽頭炎,2015,25,2015-W25,487,459,946,261,gender
感染性胃腸炎,2015,25,2015-W25,914,823,1737,261,gender
水痘,2015,25,2015-W25,91,68,159,261,gender
手足口病,2015,25,2015-W25,402,319,721,261,gender
突発性発しん,2015,25,2015-W25,99,102,201,261,gender
ヘルパンギーナ,2015,25,2015-W25,80,76,156,261,gender
流行性耳下腺炎,2015,25,2015-W25,46,32,78,261,gender
川崎病,2015,25,2015-W25,2,1,3,261,gender
インフルエンザ,2016,38,2016-W38,19,20,39,408,gender
RSウイルス感染症,2016,38,2016-W38,264,247,511,258,gender
咽頭結膜熱,2016,38,2016-W38,30,20,50,258,gender
Ａ群溶血性レンサ球菌咽頭炎,2016,38,2016-W38,147,157,304,258,gender
感染性胃腸炎,2016,38,2016-W38,521,421,942,258,gender
水痘,2016,38,2016-W38,34,43,77,258,gender
手足口病,2016,38,2016-W38,176,152,328,258,gender
突発性発しん,2016,38,2016-W38,62,75,137,258,gender
ヘルパンギーナ,2016,38,2016-W38,120,119,239,258,gender
流行性耳下腺炎,2016,38,2016-W38,103,83,186,258,gender
川崎病,2016,38,2016-W38,4,1,5,258,gender
インフルエンザ,2007,11,2007-W11,3275,3188,6463,281,gender
RSウイルス感染症,2007,11,2007-W11,5,5,10,141,gender
咽頭結膜熱,2007,11,2007-W11,10,17,27,141,gender
Ａ群溶血性レンサ球菌咽頭炎,2007,11,2007-W11,133,127,260,141,gender
感染性胃腸炎,2007,11,2007-W11,431,405,836,141,gender
水痘,2007,11,2007-W11,106,96,202,141,gender
手足口病,2007,11,2007-W11,4,7,11,141,gender
突発性発しん,2007,11,2007-W11,39,32,71,141,gender
ヘルパンギーナ,2007,11,2007-W11,1,1,2,141,gender
流行性耳下腺炎,2007,11,2007-W11,16,24,40,141,gender
川崎病,2007,11,2007-W11,0,0,0,141,gender
インフルエンザ,2008,32,2008-W32,2,3,5,275,gender
RSウイルス感染症,2008,32,2008-W32,4,4,8,144,gender
咽頭結膜熱,2008,32,2008-W32,67,61,128,144,gender
Ａ群溶血性レンサ球菌咽頭炎,2008,32,2008-W32,51,44,95,144,gender
感染性胃腸炎,2008,32,2008-W32,235,220,455,144,gender
水痘,2008,32,2008-W32,35,44,79,144,gender
手足口病,2008,32,2008-W32,130,100,230,144,gender
突発性発しん,2008,32,2008-W32,55,58,113,144,gender
ヘルパンギーナ,2008,32,2008-W32,200,204,404,144,gender
流行性耳下腺炎,2008,32,2008-W32,50,39,89,144,gender
川崎病,2008,32,2008-W32,1,0,1,144,gender
インフルエンザ,2001,16,2001-W16,30,41,71,178,gender
RSウイルス感染症,2001,16,2001-W16,0,0,0,142,gender
咽頭結膜熱,2001,16,2001-W16,1,4,5,142,gender
Ａ群溶血性レンサ球菌咽頭炎,2001,16,2001-W16,22,24,46,142,gender
感染性胃腸炎,2001,16,2001-W16,236,233,469,142,gender
水痘,2001,16,2001-W16,89,73,162,142,gender
手足口病,2001,16,2001-W16,5,7,12,142,gender
突発性発しん,2001,16,2001-W16,42,37,79,142,gender
ヘルパンギーナ,2001,16,2001-W16,6,3,9,142,gender
流行性耳下腺炎,2001,16,2001-W16,69,68,137,142,gender
川崎病,2001,16,2001-W16,2,1,3,142,gender
インフルエンザ,2022,19,2022-W19,0,3,3,409,gender
RSウイルス感染症,2022,19,2022-W19,4,5,9,256,gender
咽頭結膜熱,2022,19,2022-W19,19,12,31,256,gender
Ａ群溶血性レンサ球菌咽頭炎,2022,19,2022-W19,22,13,35,256,gender
感染性胃腸炎,2022,19,2022-W19,732,605,1337,256,gender
水痘,2022,19,2022-W19,16,19,35,256,gender
手足口病,2022,19,2022-W19,7,6,13,256,gender
突発性発しん,2022,19,2022-W19,54,46,100,256,gender
ヘルパンギーナ,2022,19,2022-W19,2,8,10,256,gender
流行性耳下腺炎,2022,19,2022-W19,11,6,17,256,gender
川崎病,2022,19,2022-W19,1,0,1,256,gender
インフルエンザ,2011,51,2011-W51,145,146,291,417,gender
RSウイルス感染症,2011,51,2011-W51,71,73,144,262,gender
咽頭結膜熱,2011,51,2011-W51,63,62,125,262,gender
Ａ群溶血性レンサ球菌咽頭炎,2011,51,2011-W51,366,335,701,262,gender
感染性胃腸炎,2011,51,2011-W51,2722,2691,5413,262,gender
水痘,2011,51,2011-W51,389,343,732,262,gender
手足口病,2011,51,2011-W51,19,16,35,262,gender
突発性発しん,2011,51,2011-W51,74,102,176,262,gender
ヘルパンギーナ,2011,51,2011-W51,6,5,11,262,gender
流行性耳下腺炎,2011,51,2011-W51,46,39,85,262,gender
川崎病,2011,51,2011-W51,1,2,3,262,gender
インフルエンザ,2013,22,2013-W22,75,73,148,414,gender
RSウイルス感染症,2013,22,2013-W22,11,12,23,262,gender
咽頭結膜熱,2013,22,2013-W22,134,92,226,262,gender
Ａ群溶血性レンサ球菌咽頭炎,2013,22,2013-W22,390,351,741,262,gender
感染性胃腸炎,2013,22,2013-W22,938,882,1820,262,gender
水痘,2013,22,2013-W22,177,127,304,262,gender
手足口病,2013,22,2013-W22,69,54,123,262,gender
突発性発しん,2013,22,2013-W22,128,120,248,262,gender
ヘルパンギーナ,2013,22,2013-W22,13,17,30,262,gender
流行性耳下腺炎,2013,22,2013-W22,42,23,65,262,gender
川崎病,2013,22,2013-W22,3,2,5,262,gender
インフルエンザ,2007,6,2007-W06,1159,1085,2244,280,gender
RSウイルス感染症,2007,6,2007-W06,24,17,41,141,gender
咽頭結膜熱,2007,6,2007-W06,27,21,48,141,gender
Ａ群溶血性レンサ球菌咽頭炎,2007,6,2007-W06,150,134,284,141,gender
感染性胃腸炎,2007,6,2007-W06,431,439,870,141,gender
水痘,2007,6,2007-W06,126,111,237,141,gender
手足口病,2007,6,2007-W06,7,7,14,141,gender
突発性発しん,2007,6,2007-W06,33,30,63,141,gender
ヘルパンギーナ,2007,6,2007-W06,2,0,2,141,gender
流行性耳下腺炎,2007,6,2007-W06,14,6,20,141,gender
川崎病,2007,6,2007-W06,1,1,2,141,gender
インフルエンザ,2001,28,2001-W28,0,0,0,178,gender
RSウイルス感染症,2001,28,2001-W28,0,0,0,142,gender
咽頭結膜熱,2001,28,2001-W28,10,18,28,142,gender
Ａ群溶血性レンサ球菌咽頭炎,2001,28,2001-W28,18,17,35,142,gender
感染性胃腸炎,2001,28,2001-W28,144,141,285,142,gender
水痘,2001,28,2001-W28,57,59,116,142,gender
手足口病,2001,28,2001-W28,105,85,190,142,gender
突発性発しん,2001,28,2001-W28,35,42,77,142,gender
ヘルパンギーナ,2001,28,2001-W28,599,581,1180,142,gender
流行性耳下腺炎,2001,28,2001-W28,72,67,139,142,gender
川崎病,2001,28,2001-W28,1,0,1,142,gender
インフルエンザ,2022,27,2022-W27,0,0,0,412,gender
RSウイルス感染症,2022,27,2022-W27,161,117,278,259,gender
咽頭結膜熱,2022,27,2022-W27,47,28,75,259,gender
Ａ群溶血性レンサ球菌咽頭炎,2022,27,2022-W27,32,16,48,259,gender
感染性胃腸炎,2022,27,2022-W27,791,644,1435,259,gender
水痘,2022,27,2022-W27,6,11,17,259,gender
手足口病,2022,27,2022-W27,309,258,567,259,gender
突発性発しん,2022,27,2022-W27,65,51,116,259,gender
ヘルパンギーナ,2022,27,2022-W27,103,94,197,259,gender
流行性耳下腺炎,2022,27,2022-W27,7,2,9,259,gender
川崎病,2022,27,2022-W27,1,2,3,259,gender
インフルエンザ,2000,46,2000-W46,5,3,8,178,gender
RSウイルス感染症,2000,46,2000-W46,0,0,0,142,gender
咽頭結膜熱,2000,46,2000-W46,2,2,4,142,gender
Ａ群溶血性レンサ球菌咽頭炎,2000,46,2000-W46,41,47,88,142,gender
感染性胃腸炎,2000,46,2000-W46,253,242,495,142,gender
水痘,2000,46,2000-W46,63,50,113,142,gender
手足口病,2000,46,2000-W46,59,44,103,142,gender
突発性発しん,2000,46,2000-W46,28,33,61,142,gender
ヘルパンギーナ,2000,46,2000-W46,8,9,17,142,gender
流行性耳下腺炎,2000,46,2000-W46,70,55,125,142,gender
川崎病,2000,46,2000-W46,1,0,1,142,gender
インフルエンザ,2024,5,2024-W05,4651,3747,8398,414,gender
新型コロナウイルス感染症（COVID-19）,2024,5,2024-W05,2275,2438,4713,414,gender
RSウイルス感染症,2024,5,2024-W05,6,10,16,261,gender
咽頭結膜熱,2024,5,2024-W05,72,57,129,261,gender
Ａ群溶血性レンサ球菌咽頭炎,2024,5,2024-W05,587,503,1090,261,gender
感染性胃腸炎,2024,5,2024-W05,1334,1154,2488,261,gender
水痘,2024,5,2024-W05,11,14,25,261,gender
手足口病,2024,5,2024-W05,10,6,16,261,gender
突発性発しん,2024,5,2024-W05,33,32,65,261,gender
ヘルパンギーナ,2024,5,2024-W05,1,1,2,261,gender
流行性耳下腺炎,2024,5,2024-W05,7,6,13,261,gender
川崎病,2024,5,2024-W05,2,3,5,261,gender
インフルエンザ,2023,49,2023-W49,4367,4038,8405,414,gender
新型コロナウイルス感染症（COVID-19）,2023,49,2023-W49,466,489,955,414,gender
RSウイルス感染症,2023,49,2023-W49,5,3,8,261,gender
咽頭結膜熱,2023,49,2023-W49,448,394,842,261,gender
Ａ群溶血性レンサ球菌咽頭炎,2023,49,2023-W49,885,746,1631,261,gender
感染性胃腸炎,2023,49,2023-W49,1230,1095,2325,261,gender
水痘,2023,49,2023-W49,26,17,43,261,gender
手足口病,2023,49,2023-W49,62,49,111,261,gender
突発性発しん,2023,49,2023-W49,34,25,59,261,gender
ヘルパンギーナ,2023,49,2023-W49,3,1,4,261,gender
流行性耳下腺炎,2023,49,2023-W49,7,3,10,261,gender
川崎病,2023,49,2023-W49,1,0,1,261,gender
インフルエンザ,2002,35,2002-W35,0,0,0,178,gender
RSウイルス感染症,2002,35,2002-W35,0,0,0,142,gender
咽頭結膜熱,2002,35,2002-W35,13,13,26,142,gender
Ａ群溶血性レンサ球菌咽頭炎,2002,35,2002-W35,16,12,28,142,gender
感染性胃腸炎,2002,35,2002-W35,150,121,271,142,gender
水痘,2002,35,2002-W35,21,23,44,142,gender
手足口病,2002,35,2002-W35,36,25,61,142,gender
突発性発しん,2002,35,2002-W35,52,40,92,142,gender
ヘルパンギーナ,2002,35,2002-W35,40,20,60,142,gender
流行性耳下腺炎,2002,35,2002-W35,25,27,52,142,gender
川崎病,2002,35,2002-W35,0,0,0,142,gender
インフルエンザ,2021,9,2021-W09,1,0,1,409,gender
RSウイルス感染症,2021,9,2021-W09,9,8,17,256,gender
咽頭結膜熱,2021,9,2021-W09,9,8,17,256,gender
Ａ群溶血性レンサ球菌咽頭炎,2021,9,2021-W09,54,45,99,256,gender
感染性胃腸炎,2021,9,2021-W09,374,350,724,256,gender
水痘,2021,9,2021-W09,9,11,20,256,gender
手足口病,2021,9,2021-W09,4,2,6,256,gender
突発性発しん,2021,9,2021-W09,57,50,107,256,gender
ヘルパンギーナ,2021,9,2021-W09,0,1,1,256,gender
流行性耳下腺炎,2021,9,2021-W09,6,6,12,256,gender
川崎病,2021,9,2021-W09,1,0,1,256,gender
インフルエンザ,2006,41,2006-W41,1,0,1,178,gender
RSウイルス感染症,2006,41,2006-W41,6,2,8,142,gender
咽頭結膜熱,2006,41,2006-W41,12,11,23,142,gender
Ａ群溶血性レンサ球菌咽頭炎,2006,41,2006-W41,75,57,132,142,gender
感染性胃腸炎,2006,41,2006-W41,247,209,456,142,gender
水痘,2006,41,2006-W41,47,38,85,142,gender
手足口病,2006,41,2006-W41,68,43,111,142,gender
突発性発しん,2006,41,2006-W41,36,31,67,142,gender
ヘルパンギーナ,2006,41,2006-W41,6,11,17,142,gender
流行性耳下腺炎,2006,41,2006-W41,20,22,42,142,gender
川崎病,2006,41,2006-W41,0,2,2,142,gender
インフルエンザ,2009,4,2009-W04,4596,4570,9166,287,gender
RSウイルス感染症,2009,4,2009-W04,4,8,12,148,gender
咽頭結膜熱,2009,4,2009-W04,10,11,21,148,gender
Ａ群溶血性レンサ球菌咽頭炎,2009,4,2009-W04,148,149,297,148,gender
感染性胃腸炎,2009,4,2009-W04,565,559,1124,148,gender
水痘,2009,4,2009-W04,92,83,175,148,gender
手足口病,2009,4,2009-W04,8,4,12,148,gender
突発性発しん,2009,4,2009-W04,32,33,65,148,gender
ヘルパンギーナ,2009,4,2009-W04,2,4,6,148,gender
流行性耳下腺炎,2009,4,2009-W04,29,23,52,148,gender
川崎病,2009,4,2009-W04,1,2,3,148,gender
インフルエンザ,2004,32,2004-W32,0,0,0,178,gender
RSウイルス感染症,2004,32,2004-W32,2,1,3,142,gender
咽頭結膜熱,2004,32,2004-W32,35,45,80,142,gender
Ａ群溶血性レンサ球菌咽頭炎,2004,32,2004-W32,29,19,48,142,gender
感染性胃腸炎,2004,32,2004-W32,168,153,321,142,gender
水痘,2004,32,2004-W32,15,34,49,142,gender
手足口病,2004,32,2004-W32,63,36,99,142,gender
突発性発しん,2004,32,2004-W32,43,51,94,142,gender
ヘルパンギーナ,2004,32,2004-W32,149,128,277,142,gender
流行性耳下腺炎,2004,32,2004-W32,36,26,62,142,gender
川崎病,2004,32,2004-W32,1,0,1,142,gender
インフルエンザ,2024,20,2024-W20,41,30,71,419,gender
新型コロナウイルス感染症（COVID-19）,2024,20,2024-W20,516,650,1166,419,gender
RSウイルス感染症,2024,20,2024-W20,164,156,320,264,gender
咽頭結膜熱,2024,20,2024-W20,70,52,122,264,gender
Ａ群溶血性レンサ球菌咽頭炎,2024,20,2024-W20,558,475,1033,264,gender
感染性胃腸炎,2024,20,2024-W20,735,582,1317,264,gender
水痘,2024,20,2024-W20,27,25,52,264,gender
手足口病,2024,20,2024-W20,74,66,140,264,gender
突発性発しん,2024,20,2024-W20,41,27,68,264,gender
ヘルパンギーナ,2024,20,2024-W20,16,15,31,264,gender
流行性耳下腺炎,2024,20,2024-W20,10,5,15,264,gender
川崎病,2024,20,2024-W20,7,1,8,264,gender
インフルエンザ,2019,25,2019-W25,28,39,67,413,gender
RSウイルス感染症,2019,25,2019-W25,49,28,77,259,gender
咽頭結膜熱,2019,25,2019-W25,93,75,168,259,gender
Ａ群溶血性レンサ球菌咽頭炎,2019,25,2019-W25,437,326,763,259,gender
感染性胃腸炎,2019,25,2019-W25,909,752,1661,259,gender
水痘,2019,25,2019-W25,82,60,142,259,gender
手足口病,2019,25,2019-W25,384,324,708,259,gender
突発性発しん,2019,25,2019-W25,81,71,152,259,gender
ヘルパンギーナ,2019,25,2019-W25,113,111,224,259,gender
流行性耳下腺炎,2019,25,2019-W25,10,12,22,259,gender
川崎病,2019,25,2019-W25,2,1,3,259,gender
インフルエンザ,2020,30,2020-W30,0,0,0,413,gender
RSウイルス感染症,2020,30,2020-W30,0,0,0,260,gender
咽頭結膜熱,2020,30,2020-W30,8,12,20,260,gender
Ａ群溶血性レンサ球菌咽頭炎,2020,30,2020-W30,76,65,141,260,gender
感染性胃腸炎,2020,30,2020-W30,328,239,567,260,gender
水痘,2020,30,2020-W30,14,10,24,260,gender
手足口病,2020,30,2020-W30,7,12,19,260,gender
突発性発しん,2020,30,2020-W30,81,51,132,260,gender
ヘルパンギーナ,2020,30,2020-W30,7,7,14,260,gender
流行性耳下腺炎,2020,30,2020-W30,6,4,10,260,gender
川崎病,2020,30,2020-W30,0,0,0,260,gender
インフルエンザ,2012,16,2012-W16,614,670,1284,417,gender
RSウイルス感染症,2012,16,2012-W16,28,15,43,262,gender
咽頭結膜熱,2012,16,2012-W16,33,22,55,262,gender
Ａ群溶血性レンサ球菌咽頭炎,2012,16,2012-W16,320,265,585,262,gender
感染性胃腸炎,2012,16,2012-W16,1812,1675,3487,262,gender
水痘,2012,16,2012-W16,100,112,212,262,gender
手足口病,2012,16,2012-W16,5,6,11,262,gender
突発性発しん,2012,16,2012-W16,72,86,158,262,gender
ヘルパンギーナ,2012,16,2012-W16,4,1,5,262,gender
流行性耳下腺炎,2012,16,2012-W16,26,16,42,262,gender
川崎病,2012,16,2012-W16,1,3,4,262,gender
インフルエンザ,2022,43,2022-W43,7,2,9,412,gender
RSウイルス感染症,2022,43,2022-W43,114,113,227,260,gender
咽頭結膜熱,2022,43,2022-W43,6,5,11,260,gender
Ａ群溶血性レンサ球菌咽頭炎,2022,43,2022-W43,38,30,68,260,gender
感染性胃腸炎,2022,43,2022-W43,472,388,860,260,gender
水痘,2022,43,2022-W43,23,16,39,260,gender
手足口病,2022,43,2022-W43,147,141,288,260,gender
突発性発しん,2022,43,2022-W43,41,40,81,260,gender
ヘルパンギーナ,2022,43,2022-W43,36,33,69,260,gender
流行性耳下腺炎,2022,43,2022-W43,7,5,12,260,gender
川崎病,2022,43,2022-W43,5,0,5,260,gender
インフルエンザ,2000,22,2000-W22,1,0,1,178,gender
RSウイルス感染症,2000,22,2000-W22,0,0,0,142,gender
咽頭結膜熱,2000,22,2000-W22,5,4,9,142,gender
Ａ群溶血性レンサ球菌咽頭炎,2000,22,2000-W22,58,46,104,142,gender
感染性胃腸炎,2000,22,2000-W22,264,239,503,142,gender
水痘,2000,22,2000-W22,108,99,207,142,gender
手足口病,2000,22,2000-W22,22,31,53,142,gender
突発性発しん,2000,22,2000-W22,46,43,89,142,gender
ヘルパンギーナ,2000,22,2000-W22,51,45,96,142,gender
流行性耳下腺炎,2000,22,2000-W22,57,40,97,142,gender
川崎病,2000,22,2000-W22,2,0,2,142,gender
インフルエンザ,2002,51,2002-W51,167,164,331,178,gender
RSウイルス感染症,2002,51,2002-W51,0,0,0,142,gender
咽頭結膜熱,2002,51,2002-W51,6,12,18,142,gender
Ａ群溶血性レンサ球菌咽頭炎,2002,51,2002-W51,61,55,116,142,gender
感染性胃腸炎,2002,51,2002-W51,714,771,1485,142,gender
水痘,2002,51,2002-W51,117,111,228,142,gender
手足口病,2002,51,2002-W51,6,3,9,142,gender
突発性発しん,2002,51,2002-W51,33,35,68,142,gender
ヘルパンギーナ,2002,51,2002-W51,3,2,5,142,gender
流行性耳下腺炎,2002,51,2002-W51,27,23,50,142,gender
川崎病,2002,51,2002-W51,3,0,3,142,gender
インフルエンザ,2006,25,2006-W25,1,2,3,178,gender
RSウイルス感染症,2006,25,2006-W25,0,0,0,142,gender
咽頭結膜熱,2006,25,2006-W25,127,112,239,142,gender
Ａ群溶血性レンサ球菌咽頭炎,2006,25,2006-W25,150,119,269,142,gender
感染性胃腸炎,2006,25,2006-W25,276,214,490,142,gender
水痘,2006,25,2006-W25,140,122,262,142,gender
手足口病,2006,25,2006-W25,50,34,84,142,gender
突発性発しん,2006,25,2006-W25,54,40,94,142,gender
ヘルパンギーナ,2006,25,2006-W25,435,355,790,142,gender
流行性耳下腺炎,2006,25,2006-W25,66,59,125,142,gender
川崎病,2006,25,2006-W25,2,0,2,142,gender
インフルエンザ,2024,44,2024-W44,208,179,387,419,gender
新型コロナウイルス感染症（COVID-19）,2024,44,2024-W44,199,257,456,419,gender
RSウイルス感染症,2024,44,2024-W44,39,27,66,264,gender
咽頭結膜熱,2024,44,2024-W44,20,25,45,264,gender
Ａ群溶血性レンサ球菌咽頭炎,2024,44,2024-W44,218,200,418,264,gender
感染性胃腸炎,2024,44,2024-W44,430,313,743,264,gender
水痘,2024,44,2024-W44,35,15,50,264,gender
手足口病,2024,44,2024-W44,1268,1043,2311,264,gender
突発性発しん,2024,44,2024-W44,29,33,62,264,gender
ヘルパンギーナ,2024,44,2024-W44,23,17,40,264,gender
流行性耳下腺炎,2024,44,2024-W44,5,3,8,264,gender
川崎病,2024,44,2024-W44,2,0,2,264,gender
インフルエンザ,2005,38,2005-W38,0,0,0,178,gender
RSウイルス感染症,2005,38,2005-W38,3,2,5,142,gender
咽頭結膜熱,2005,38,2005-W38,30,23,53,142,gender
Ａ群溶血性レンサ球菌咽頭炎,2005,38,2005-W38,46,31,77,142,gender
感染性胃腸炎,2005,38,2005-W38,190,142,332,142,gender
水痘,2005,38,2005-W38,29,17,46,142,gender
手足口病,2005,38,2005-W38,25,18,43,142,gender
突発性発しん,2005,38,2005-W38,45,40,85,142,gender
ヘルパンギーナ,2005,38,2005-W38,39,32,71,142,gender
流行性耳下腺炎,2005,38,2005-W38,72,63,135,142,gender
川崎病,2005,38,2005-W38,0,2,2,142,gender
インフルエンザ,2014,11,2014-W11,4361,4202,8563,416,gender
RSウイルス感染症,2014,11,2014-W11,18,19,37,261,gender
咽頭結膜熱,2014,11,2014-W11,26,23,49,261,gender
Ａ群溶血性レンサ球菌咽頭炎,2014,11,2014-W11,289,237,526,261,gender
感染性胃腸炎,2014,11,2014-W11,730,685,1415,261,gender
水痘,2014,11,2014-W11,95,87,182,261,gender
手足口病,2014,11,2014-W11,4,4,8,261,gender
突発性発しん,2014,11,2014-W11,58,41,99,261,gender
ヘルパンギーナ,2014,11,2014-W11,3,2,5,261,gender
流行性耳下腺炎,2014,11,2014-W11,8,20,28,261,gender
川崎病,2014,11,2014-W11,4,1,5,261,gender
インフルエンザ,2019,41,2019-W41,213,198,411,409,gender
RSウイルス感染症,2019,41,2019-W41,107,108,215,259,gender
咽頭結膜熱,2019,41,2019-W41,38,27,65,259,gender
Ａ群溶血性レンサ球菌咽頭炎,2019,41,2019-W41,245,178,423,259,gender
感染性胃腸炎,2019,41,2019-W41,460,349,809,259,gender
水痘,2019,41,2019-W41,39,24,63,259,gender
手足口病,2019,41,2019-W41,348,252,600,259,gender
突発性発しん,2019,41,2019-W41,53,39,92,259,gender
ヘルパンギーナ,2019,41,2019-W41,101,82,183,259,gender
流行性耳下腺炎,2019,41,2019-W41,11,7,18,259,gender
川崎病,2019,41,2019-W41,0,0,0,259,gender
インフルエンザ,2017,32,2017-W32,20,16,36,383,gender
RSウイルス感染症,2017,32,2017-W32,262,220,482,243,gender
咽頭結膜熱,2017,32,2017-W32,82,81,163,243,gender
Ａ群溶血性レンサ球菌咽頭炎,2017,32,2017-W32,125,104,229,243,gender
感染性胃腸炎,2017,32,2017-W32,431,349,780,243,gender
水痘,2017,32,2017-W32,29,30,59,243,gender
手足口病,2017,32,2017-W32,1415,1251,2666,243,gender
突発性発しん,2017,32,2017-W32,57,45,102,243,gender
ヘルパンギーナ,2017,32,2017-W32,253,232,485,243,gender
流行性耳下腺炎,2017,32,2017-W32,25,21,46,243,gender
川崎病,2017,32,2017-W32,3,1,4,243,gender
インフルエンザ,2023,8,2023-W08,1858,1641,3499,410,gender
RSウイルス感染症,2023,8,2023-W08,7,4,11,257,gender
咽頭結膜熱,2023,8,2023-W08,19,13,32,257,gender
Ａ群溶血性レンサ球菌咽頭炎,2023,8,2023-W08,49,56,105,257,gender
感染性胃腸炎,2023,8,2023-W08,778,686,1464,257,gender
水痘,2023,8,2023-W08,5,6,11,257,gender
手足口病,2023,8,2023-W08,5,5,10,257,gender
突発性発しん,2023,8,2023-W08,24,18,42,257,gender
ヘルパンギーナ,2023,8,2023-W08,0,0,0,257,gender
流行性耳下腺炎,2023,8,2023-W08,8,4,12,257,gender
川崎病,2023,8,2023-W08,0,3,3,257,gender
インフルエンザ,2009,38,2009-W38,1497,1348,2845,282,gender
RSウイルス感染症,2009,38,2009-W38,15,12,27,146,gender
咽頭結膜熱,2009,38,2009-W38,3,3,6,146,gender
Ａ群溶血性レンサ球菌咽頭炎,2009,38,2009-W38,58,39,97,146,gender
感染性胃腸炎,2009,38,2009-W38,220,165,385,146,gender
水痘,2009,38,2009-W38,29,24,53,146,gender
手足口病,2009,38,2009-W38,71,52,123,146,gender
突発性発しん,2009,38,2009-W38,54,39,93,146,gender
ヘルパンギーナ,2009,38,2009-W38,53,62,115,146,gender
流行性耳下腺炎,2009,38,2009-W38,43,45,88,146,gender
川崎病,2009,38,2009-W38,1,1,2,146,gender
インフルエンザ,2025,14,2025-W14,251,244,495,419,gender
新型コロナウイルス感染症（COVID-19）,2025,14,2025-W14,250,289,539,419,gender
RSウイルス感染症,2025,14,2025-W14,39,41,80,264,gender
咽頭結膜熱,2025,14,2025-W14,21,14,35,264,gender
Ａ群溶血性レンサ球菌咽頭炎,2025,14,2025-W14,367,273,640,264,gender
感染性胃腸炎,2025,14,2025-W14,855,804,1659,264,gender
水痘,2025,14,2025-W14,71,50,121,264,gender
手足口病,2025,14,2025-W14,5,7,12,264,gender
突発性発しん,2025,14,2025-W14,26,32,58,264,gender
ヘルパンギーナ,2025,14,2025-W14,0,2,2,264,gender
流行性耳下腺炎,2025,14,2025-W14,4,8,12,264,gender
川崎病,2025,14,2025-W14,1,1,2,264,gender
インフルエンザ,2015,41,2015-W41,16,20,36,412,gender
RSウイルス感染症,2015,41,2015-W41,205,193,398,261,gender
咽頭結膜熱,2015,41,2015-W41,42,45,87,261,gender
Ａ群溶血性レンサ球菌咽頭炎,2015,41,2015-W41,238,200,438,261,gender
感染性胃腸炎,2015,41,2015-W41,531,386,917,261,gender
水痘,2015,41,2015-W41,35,42,77,261,gender
手足口病,2015,41,2015-W41,226,172,398,261,gender
突発性発しん,2015,41,2015-W41,69,71,140,261,gender
ヘルパンギーナ,2015,41,2015-W41,30,29,59,261,gender
流行性耳下腺炎,2015,41,2015-W41,77,53,130,261,gender
川崎病,2015,41,2015-W41,2,1,3,261,gender
インフルエンザ,2018,11,2018-W11,1042,1143,2185,414,gender
RSウイルス感染症,2018,11,2018-W11,60,40,100,261,gender
咽頭結膜熱,2018,11,2018-W11,24,24,48,261,gender
Ａ群溶血性レンサ球菌咽頭炎,2018,11,2018-W11,358,326,684,261,gender
感染性胃腸炎,2018,11,2018-W11,733,636,1369,261,gender
水痘,2018,11,2018-W11,43,37,80,261,gender
手足口病,2018,11,2018-W11,3,3,6,261,gender
突発性発しん,2018,11,2018-W11,54,46,100,261,gender
ヘルパンギーナ,2018,11,2018-W11,2,1,3,261,gender
流行性耳下腺炎,2018,11,2018-W11,12,14,26,261,gender
川崎病,2018,11,2018-W11,3,1,4,261,gender
インフルエンザ,2005,7,2005-W07,3785,3928,7713,178,gender
RSウイルス感染症,2005,7,2005-W07,2,3,5,142,gender
咽頭結膜熱,2005,7,2005-W07,10,13,23,142,gender
Ａ群溶血性レンサ球菌咽頭炎,2005,7,2005-W07,49,49,98,142,gender
感染性胃腸炎,2005,7,2005-W07,509,504,1013,142,gender
水痘,2005,7,2005-W07,88,71,159,142,gender
手足口病,2005,7,2005-W07,9,11,20,142,gender
突発性発しん,2005,7,2005-W07,29,32,61,142,gender
ヘルパンギーナ,2005,7,2005-W07,1,2,3,142,gender
流行性耳下腺炎,2005,7,2005-W07,64,45,109,142,gender
川崎病,2005,7,2005-W07,0,0,0,142,gender
インフルエンザ,2012,28,2012-W28,9,12,21,412,gender
RSウイルス感染症,2012,28,2012-W28,18,10,28,260,gender
咽頭結膜熱,2012,28,2012-W28,91,81,172,260,gender
Ａ群溶血性レンサ球菌咽頭炎,2012,28,2012-W28,301,271,572,260,gender
感染性胃腸炎,2012,28,2012-W28,797,637,1434,260,gender
水痘,2012,28,2012-W28,129,128,257,260,gender
手足口病,2012,28,2012-W28,211,147,358,260,gender
突発性発しん,2012,28,2012-W28,105,99,204,260,gender
ヘルパンギーナ,2012,28,2012-W28,1099,991,2090,260,gender
流行性耳下腺炎,2012,28,2012-W28,41,38,79,260,gender
川崎病,2012,28,2012-W28,1,2,3,260,gender
インフルエンザ,2011,35,2011-W35,1,0,1,414,gender
RSウイルス感染症,2011,35,2011-W35,51,42,93,261,gender
咽頭結膜熱,2011,35,2011-W35,36,27,63,261,gender
Ａ群溶血性レンサ球菌咽頭炎,2011,35,2011-W35,78,81,159,261,gender
感染性胃腸炎,2011,35,2011-W35,424,316,740,261,gender
水痘,2011,35,2011-W35,59,44,103,261,gender
手足口病,2011,35,2011-W35,649,522,1171,261,gender
突発性発しん,2011,35,2011-W35,105,101,206,261,gender
ヘルパンギーナ,2011,35,2011-W35,325,350,675,261,gender
流行性耳下腺炎,2011,35,2011-W35,36,22,58,261,gender
川崎病,2011,35,2011-W35,3,2,5,261,gender
インフルエンザ,2013,46,2013-W46,24,28,52,412,gender
RSウイルス感染症,2013,46,2013-W46,139,106,245,260,gender
咽頭結膜熱,2013,46,2013-W46,65,63,128,260,gender
Ａ群溶血性レンサ球菌咽頭炎,2013,46,2013-W46,199,187,386,260,gender
感染性胃腸炎,2013,46,2013-W46,975,865,1840,260,gender
水痘,2013,46,2013-W46,133,102,235,260,gender
手足口病,2013,46,2013-W46,53,42,95,260,gender
突発性発しん,2013,46,2013-W46,86,82,168,260,gender
ヘルパンギーナ,2013,46,2013-W46,12,11,23,260,gender
流行性耳下腺炎,2013,46,2013-W46,21,23,44,260,gender
川崎病,2013,46,2013-W46,4,4,8,260,gender
インフルエンザ,2023,13,2023-W13,792,695,1487,415,gender
RSウイルス感染症,2023,13,2023-W13,25,19,44,259,gender
咽頭結膜熱,2023,13,2023-W13,24,20,44,259,gender
Ａ群溶血性レンサ球菌咽頭炎,2023,13,2023-W13,52,36,88,259,gender
感染性胃腸炎,2023,13,2023-W13,491,407,898,259,gender
水痘,2023,13,2023-W13,13,16,29,259,gender
手足口病,2023,13,2023-W13,5,2,7,259,gender
突発性発しん,2023,13,2023-W13,35,31,66,259,gender
ヘルパンギーナ,2023,13,2023-W13,4,1,5,259,gender
流行性耳下腺炎,2023,13,2023-W13,8,2,10,259,gender
川崎病,2023,13,2023-W13,1,2,3,259,gender
インフルエンザ,2016,13,2016-W13,1559,1532,3091,415,gender
RSウイルス感染症,2016,13,2016-W13,6,7,13,261,gender
咽頭結膜熱,2016,13,2016-W13,22,15,37,261,gender
Ａ群溶血性レンサ球菌咽頭炎,2016,13,2016-W13,279,229,508,261,gender
感染性胃腸炎,2016,13,2016-W13,680,657,1337,261,gender
水痘,2016,13,2016-W13,46,46,92,261,gender
手足口病,2016,13,2016-W13,6,0,6,261,gender
突発性発しん,2016,13,2016-W13,62,45,107,261,gender
ヘルパンギーナ,2016,13,2016-W13,0,1,1,261,gender
流行性耳下腺炎,2016,13,2016-W13,62,53,115,261,gender
川崎病,2016,13,2016-W13,1,2,3,261,gender
インフルエンザ,2024,35,2024-W35,74,56,130,416,gender
新型コロナウイルス感染症（COVID-19）,2024,35,2024-W35,917,1070,1987,416,gender
RSウイルス感染症,2024,35,2024-W35,30,38,68,263,gender
咽頭結膜熱,2024,35,2024-W35,32,24,56,263,gender
Ａ群溶血性レンサ球菌咽頭炎,2024,35,2024-W35,183,161,344,263,gender
感染性胃腸炎,2024,35,2024-W35,411,319,730,263,gender
水痘,2024,35,2024-W35,10,9,19,263,gender
手足口病,2024,35,2024-W35,887,702,1589,263,gender
突発性発しん,2024,35,2024-W35,48,45,93,263,gender
ヘルパンギーナ,2024,35,2024-W35,95,99,194,263,gender
流行性耳下腺炎,2024,35,2024-W35,8,4,12,263,gender
川崎病,2024,35,2024-W35,0,0,0,263,gender
インフルエンザ,2005,49,2005-W49,41,40,81,178,gender
RSウイルス感染症,2005,49,2005-W49,41,33,74,142,gender
咽頭結膜熱,2005,49,2005-W49,37,33,70,142,gender
Ａ群溶血性レンサ球菌咽頭炎,2005,49,2005-W49,154,124,278,142,gender
感染性胃腸炎,2005,49,2005-W49,1138,1114,2252,142,gender
水痘,2005,49,2005-W49,97,97,194,142,gender
手足口病,2005,49,2005-W49,10,17,27,142,gender
突発性発しん,2005,49,2005-W49,36,38,74,142,gender
ヘルパンギーナ,2005,49,2005-W49,3,9,12,142,gender
流行性耳下腺炎,2005,49,2005-W49,80,86,166,142,gender
川崎病,2005,49,2005-W49,2,0,2,142,gender
インフルエンザ,2008,19,2008-W19,11,8,19,286,gender
RSウイルス感染症,2008,19,2008-W19,2,0,2,149,gender
咽頭結膜熱,2008,19,2008-W19,41,17,58,149,gender
Ａ群溶血性レンサ球菌咽頭炎,2008,19,2008-W19,137,113,250,149,gender
感染性胃腸炎,2008,19,2008-W19,370,375,745,149,gender
水痘,2008,19,2008-W19,132,118,250,149,gender
手足口病,2008,19,2008-W19,11,5,16,149,gender
突発性発しん,2008,19,2008-W19,48,33,81,149,gender
ヘルパンギーナ,2008,19,2008-W19,6,2,8,149,gender
流行性耳下腺炎,2008,19,2008-W19,29,20,49,149,gender
川崎病,2008,19,2008-W19,1,2,3,149,gender
インフルエンザ,2019,30,2019-W30,19,17,36,410,gender
RSウイルス感染症,2019,30,2019-W30,208,157,365,259,gender
咽頭結膜熱,2019,30,2019-W30,62,39,101,259,gender
Ａ群溶血性レンサ球菌咽頭炎,2019,30,2019-W30,261,203,464,259,gender
感染性胃腸炎,2019,30,2019-W30,595,512,1107,259,gender
水痘,2019,30,2019-W30,77,48,125,259,gender
手足口病,2019,30,2019-W30,2647,2187,4834,259,gender
突発性発しん,2019,30,2019-W30,60,58,118,259,gender
ヘルパンギーナ,2019,30,2019-W30,644,670,1314,259,gender
流行性耳下腺炎,2019,30,2019-W30,9,8,17,259,gender
川崎病,2019,30,2019-W30,0,3,3,259,gender
インフルエンザ,2004,27,2004-W27,0,0,0,178,gender
RSウイルス感染症,2004,27,2004-W27,2,2,4,142,gender
咽頭結膜熱,2004,27,2004-W27,61,62,123,142,gender
Ａ群溶血性レンサ球菌咽頭炎,2004,27,2004-W27,70,54,124,142,gender
感染性胃腸炎,2004,27,2004-W27,196,179,375,142,gender
水痘,2004,27,2004-W27,45,55,100,142,gender
手足口病,2004,27,2004-W27,81,54,135,142,gender
突発性発しん,2004,27,2004-W27,52,53,105,142,gender
ヘルパンギーナ,2004,27,2004-W27,316,270,586,142,gender
流行性耳下腺炎,2004,27,2004-W27,48,29,77,142,gender
川崎病,2004,27,2004-W27,0,0,0,142,gender
インフルエンザ,2002,20,2002-W20,4,2,6,178,gender
RSウイルス感染症,2002,20,2002-W20,0,0,0,142,gender
咽頭結膜熱,2002,20,2002-W20,3,3,6,142,gender
Ａ群溶血性レンサ球菌咽頭炎,2002,20,2002-W20,78,51,129,142,gender
感染性胃腸炎,2002,20,2002-W20,248,248,496,142,gender
水痘,2002,20,2002-W20,83,71,154,142,gender
手足口病,2002,20,2002-W20,26,21,47,142,gender
突発性発しん,2002,20,2002-W20,40,46,86,142,gender
ヘルパンギーナ,2002,20,2002-W20,18,27,45,142,gender
流行性耳下腺炎,2002,20,2002-W20,51,31,82,142,gender
川崎病,2002,20,2002-W20,1,2,3,142,gender
インフルエンザ,2011,1,2011-W01,943,827,1770,413,gender
RSウイルス感染症,2011,1,2011-W01,69,54,123,260,gender
咽頭結膜熱,2011,1,2011-W01,71,56,127,260,gender
Ａ群溶血性レンサ球菌咽頭炎,2011,1,2011-W01,176,164,340,260,gender
感染性胃腸炎,2011,1,2011-W01,980,966,1946,260,gender
水痘,2011,1,2011-W01,307,287,594,260,gender
手足口病,2011,1,2011-W01,2,15,17,260,gender
突発性発しん,2011,1,2011-W01,61,52,113,260,gender
ヘルパンギーナ,2011,1,2011-W01,2,2,4,260,gender
流行性耳下腺炎,2011,1,2011-W01,66,74,140,260,gender
川崎病,2011,1,2011-W01,3,1,4,260,gender
インフルエンザ,2020,41,2020-W41,1,0,1,410,gender
RSウイルス感染症,2020,41,2020-W41,1,1,2,258,gender
咽頭結膜熱,2020,41,2020-W41,11,6,17,258,gender
Ａ群溶血性レンサ球菌咽頭炎,2020,41,2020-W41,70,62,132,258,gender
感染性胃腸炎,2020,41,2020-W41,286,243,529,258,gender
水痘,2020,41,2020-W41,12,8,20,258,gender
手足口病,2020,41,2020-W41,4,6,10,258,gender
突発性発しん,2020,41,2020-W41,76,71,147,258,gender
ヘルパンギーナ,2020,41,2020-W41,9,7,16,258,gender
流行性耳下腺炎,2020,41,2020-W41,9,7,16,258,gender
川崎病,2020,41,2020-W41,2,0,2,258,gender
インフルエンザ,2010,14,2010-W14,13,10,23,287,gender
RSウイルス感染症,2010,14,2010-W14,9,5,14,148,gender
咽頭結膜熱,2010,14,2010-W14,13,7,20,148,gender
Ａ群溶血性レンサ球菌咽頭炎,2010,14,2010-W14,97,98,195,148,gender
感染性胃腸炎,2010,14,2010-W14,582,562,1144,148,gender
水痘,2010,14,2010-W14,136,107,243,148,gender
手足口病,2010,14,2010-W14,20,12,32,148,gender
突発性発しん,2010,14,2010-W14,37,45,82,148,gender
ヘルパンギーナ,2010,14,2010-W14,4,7,11,148,gender
流行性耳下腺炎,2010,14,2010-W14,65,42,107,148,gender
川崎病,2010,14,2010-W14,0,0,0,148,gender
インフルエンザ,2022,32,2022-W32,8,5,13,380,gender
RSウイルス感染症,2022,32,2022-W32,181,158,339,245,gender
咽頭結膜熱,2022,32,2022-W32,8,5,13,245,gender
Ａ群溶血性レンサ球菌咽頭炎,2022,32,2022-W32,9,7,16,245,gender
感染性胃腸炎,2022,32,2022-W32,232,187,419,245,gender
水痘,2022,32,2022-W32,9,4,13,245,gender
手足口病,2022,32,2022-W32,622,492,1114,245,gender
突発性発しん,2022,32,2022-W32,27,21,48,245,gender
ヘルパンギーナ,2022,32,2022-W32,131,117,248,245,gender
流行性耳下腺炎,2022,32,2022-W32,5,4,9,245,gender
川崎病,2022,32,2022-W32,0,0,0,245,gender
インフルエンザ,2021,11,2021-W11,0,0,0,407,gender
RSウイルス感染症,2021,11,2021-W11,15,15,30,257,gender
咽頭結膜熱,2021,11,2021-W11,7,8,15,257,gender
Ａ群溶血性レンサ球菌咽頭炎,2021,11,2021-W11,42,40,82,257,gender
感染性胃腸炎,2021,11,2021-W11,310,291,601,257,gender
水痘,2021,11,2021-W11,9,9,18,257,gender
手足口病,2021,11,2021-W11,0,0,0,257,gender
突発性発しん,2021,11,2021-W11,47,45,92,257,gender
ヘルパンギーナ,2021,11,2021-W11,4,1,5,257,gender
流行性耳下腺炎,2021,11,2021-W11,5,3,8,257,gender
川崎病,2021,11,2021-W11,1,0,1,257,gender
インフルエンザ,2011,44,2011-W44,9,3,12,419,gender
RSウイルス感染症,2011,44,2011-W44,56,42,98,264,gender
咽頭結膜熱,2011,44,2011-W44,22,20,42,264,gender
Ａ群溶血性レンサ球菌咽頭炎,2011,44,2011-W44,209,180,389,264,gender
感染性胃腸炎,2011,44,2011-W44,544,493,1037,264,gender
水痘,2011,44,2011-W44,179,133,312,264,gender
手足口病,2011,44,2011-W44,137,111,248,264,gender
突発性発しん,2011,44,2011-W44,80,71,151,264,gender
ヘルパンギーナ,2011,44,2011-W44,19,13,32,264,gender
流行性耳下腺炎,2011,44,2011-W44,50,23,73,264,gender
川崎病,2011,44,2011-W44,2,3,5,264,gender
インフルエンザ,2013,37,2013-W37,1,3,4,410,gender
RSウイルス感染症,2013,37,2013-W37,164,144,308,260,gender
咽頭結膜熱,2013,37,2013-W37,74,56,130,260,gender
Ａ群溶血性レンサ球菌咽頭炎,2013,37,2013-W37,119,99,218,260,gender
感染性胃腸炎,2013,37,2013-W37,466,398,864,260,gender
水痘,2013,37,2013-W37,56,74,130,260,gender
手足口病,2013,37,2013-W37,422,345,767,260,gender
突発性発しん,2013,37,2013-W37,96,98,194,260,gender
ヘルパンギーナ,2013,37,2013-W37,107,109,216,260,gender
流行性耳下腺炎,2013,37,2013-W37,31,14,45,260,gender
川崎病,2013,37,2013-W37,3,1,4,260,gender
インフルエンザ,2008,4,2008-W04,1280,1195,2475,289,gender
RSウイルス感染症,2008,4,2008-W04,21,6,27,150,gender
咽頭結膜熱,2008,4,2008-W04,10,6,16,150,gender
Ａ群溶血性レンサ球菌咽頭炎,2008,4,2008-W04,159,126,285,150,gender
感染性胃腸炎,2008,4,2008-W04,720,646,1366,150,gender
水痘,2008,4,2008-W04,120,105,225,150,gender
手足口病,2008,4,2008-W04,10,2,12,150,gender
突発性発しん,2008,4,2008-W04,51,39,90,150,gender
ヘルパンギーナ,2008,4,2008-W04,2,1,3,150,gender
流行性耳下腺炎,2008,4,2008-W04,17,9,26,150,gender
川崎病,2008,4,2008-W04,1,2,3,150,gender
インフルエンザ,2008,27,2008-W27,5,2,7,284,gender
RSウイルス感染症,2008,27,2008-W27,0,0,0,147,gender
咽頭結膜熱,2008,27,2008-W27,58,63,121,147,gender
Ａ群溶血性レンサ球菌咽頭炎,2008,27,2008-W27,203,182,385,147,gender
感染性胃腸炎,2008,27,2008-W27,470,397,867,147,gender
水痘,2008,27,2008-W27,101,93,194,147,gender
手足口病,2008,27,2008-W27,101,87,188,147,gender
突発性発しん,2008,27,2008-W27,52,54,106,147,gender
ヘルパンギーナ,2008,27,2008-W27,241,219,460,147,gender
流行性耳下腺炎,2008,27,2008-W27,55,45,100,147,gender
川崎病,2008,27,2008-W27,1,0,1,147,gender
インフルエンザ,2025,5,2025-W05,805,781,1586,418,gender
新型コロナウイルス感染症（COVID-19）,2025,5,2025-W05,720,828,1548,418,gender
RSウイルス感染症,2025,5,2025-W05,97,77,174,263,gender
咽頭結膜熱,2025,5,2025-W05,35,19,54,263,gender
Ａ群溶血性レンサ球菌咽頭炎,2025,5,2025-W05,372,299,671,263,gender
感染性胃腸炎,2025,5,2025-W05,1221,1055,2276,263,gender
水痘,2025,5,2025-W05,38,23,61,263,gender
手足口病,2025,5,2025-W05,8,6,14,263,gender
突発性発しん,2025,5,2025-W05,24,26,50,263,gender
ヘルパンギーナ,2025,5,2025-W05,0,2,2,263,gender
流行性耳下腺炎,2025,5,2025-W05,6,1,7,263,gender
川崎病,2025,5,2025-W05,5,3,8,263,gender
インフルエンザ,2020,9,2020-W09,749,741,1490,416,gender
RSウイルス感染症,2020,9,2020-W09,31,25,56,262,gender
咽頭結膜熱,2020,9,2020-W09,31,20,51,262,gender
Ａ群溶血性レンサ球菌咽頭炎,2020,9,2020-W09,400,340,740,262,gender
感染性胃腸炎,2020,9,2020-W09,665,629,1294,262,gender
水痘,2020,9,2020-W09,63,57,120,262,gender
手足口病,2020,9,2020-W09,4,8,12,262,gender
突発性発しん,2020,9,2020-W09,26,33,59,262,gender
ヘルパンギーナ,2020,9,2020-W09,4,5,9,262,gender
流行性耳下腺炎,2020,9,2020-W09,6,6,12,262,gender
川崎病,2020,9,2020-W09,2,1,3,262,gender
インフルエンザ,2017,43,2017-W43,73,69,142,415,gender
RSウイルス感染症,2017,43,2017-W43,68,63,131,261,gender
咽頭結膜熱,2017,43,2017-W43,69,55,124,261,gender
Ａ群溶血性レンサ球菌咽頭炎,2017,43,2017-W43,346,302,648,261,gender
感染性胃腸炎,2017,43,2017-W43,580,478,1058,261,gender
水痘,2017,43,2017-W43,51,34,85,261,gender
手足口病,2017,43,2017-W43,387,310,697,261,gender
突発性発しん,2017,43,2017-W43,63,58,121,261,gender
ヘルパンギーナ,2017,43,2017-W43,71,48,119,261,gender
流行性耳下腺炎,2017,43,2017-W43,23,17,40,261,gender
川崎病,2017,43,2017-W43,1,2,3,261,gender
インフルエンザ,2006,6,2006-W06,1597,1566,3163,178,gender
RSウイルス感染症,2006,6,2006-W06,4,6,10,142,gender
咽頭結膜熱,2006,6,2006-W06,16,22,38,142,gender
Ａ群溶血性レンサ球菌咽頭炎,2006,6,2006-W06,172,131,303,142,gender
感染性胃腸炎,2006,6,2006-W06,451,419,870,142,gender
水痘,2006,6,2006-W06,73,65,138,142,gender
手足口病,2006,6,2006-W06,3,2,5,142,gender
突発性発しん,2006,6,2006-W06,27,29,56,142,gender
ヘルパンギーナ,2006,6,2006-W06,0,0,0,142,gender
流行性耳下腺炎,2006,6,2006-W06,34,34,68,142,gender
川崎病,2006,6,2006-W06,0,0,0,142,gender
インフルエンザ,2004,19,2004-W19,0,0,0,178,gender
RSウイルス感染症,2004,19,2004-W19,4,2,6,142,gender
咽頭結膜熱,2004,19,2004-W19,8,9,17,142,gender
Ａ群溶血性レンサ球菌咽頭炎,2004,19,2004-W19,61,56,117,142,gender
感染性胃腸炎,2004,19,2004-W19,210,186,396,142,gender
水痘,2004,19,2004-W19,79,49,128,142,gender
手足口病,2004,19,2004-W19,1,2,3,142,gender
突発性発しん,2004,19,2004-W19,26,20,46,142,gender
ヘルパンギーナ,2004,19,2004-W19,6,5,11,142,gender
流行性耳下腺炎,2004,19,2004-W19,22,16,38,142,gender
川崎病,2004,19,2004-W19,0,0,0,142,gender
インフルエンザ,2009,49,2009-W49,2435,2296,4731,289,gender
RSウイルス感染症,2009,49,2009-W49,13,6,19,150,gender
咽頭結膜熱,2009,49,2009-W49,5,4,9,150,gender
Ａ群溶血性レンサ球菌咽頭炎,2009,49,2009-W49,92,64,156,150,gender
感染性胃腸炎,2009,49,2009-W49,376,357,733,150,gender
水痘,2009,49,2009-W49,101,85,186,150,gender
手足口病,2009,49,2009-W49,36,19,55,150,gender
突発性発しん,2009,49,2009-W49,46,44,90,150,gender
ヘルパンギーナ,2009,49,2009-W49,13,9,22,150,gender
流行性耳下腺炎,2009,49,2009-W49,58,42,100,150,gender
川崎病,2009,49,2009-W49,1,1,2,150,gender
インフルエンザ,2015,30,2015-W30,7,3,10,413,gender
RSウイルス感染症,2015,30,2015-W30,17,6,23,262,gender
咽頭結膜熱,2015,30,2015-W30,70,47,117,262,gender
Ａ群溶血性レンサ球菌咽頭炎,2015,30,2015-W30,267,238,505,262,gender
感染性胃腸炎,2015,30,2015-W30,526,456,982,262,gender
水痘,2015,30,2015-W30,61,54,115,262,gender
手足口病,2015,30,2015-W30,1930,1696,3626,262,gender
突発性発しん,2015,30,2015-W30,75,82,157,262,gender
ヘルパンギーナ,2015,30,2015-W30,412,393,805,262,gender
流行性耳下腺炎,2015,30,2015-W30,56,33,89,262,gender
川崎病,2015,30,2015-W30,6,1,7,262,gender
インフルエンザ,2014,51,2014-W51,4396,4221,8617,417,gender
RSウイルス感染症,2014,51,2014-W51,229,200,429,264,gender
咽頭結膜熱,2014,51,2014-W51,95,64,159,264,gender
Ａ群溶血性レンサ球菌咽頭炎,2014,51,2014-W51,471,359,830,264,gender
感染性胃腸炎,2014,51,2014-W51,1801,1724,3525,264,gender
水痘,2014,51,2014-W51,130,128,258,264,gender
手足口病,2014,51,2014-W51,55,44,99,264,gender
突発性発しん,2014,51,2014-W51,67,65,132,264,gender
ヘルパンギーナ,2014,51,2014-W51,8,3,11,264,gender
流行性耳下腺炎,2014,51,2014-W51,30,31,61,264,gender
川崎病,2014,51,2014-W51,2,4,6,264,gender
インフルエンザ,2020,6,2020-W06,1456,1374,2830,412,gender
RSウイルス感染症,2020,6,2020-W06,22,27,49,260,gender
咽頭結膜熱,2020,6,2020-W06,37,31,68,260,gender
Ａ群溶血性レンサ球菌咽頭炎,2020,6,2020-W06,523,424,947,260,gender
感染性胃腸炎,2020,6,2020-W06,1089,1028,2117,260,gender
水痘,2020,6,2020-W06,54,59,113,260,gender
手足口病,2020,6,2020-W06,15,9,24,260,gender
突発性発しん,2020,6,2020-W06,49,33,82,260,gender
ヘルパンギーナ,2020,6,2020-W06,9,4,13,260,gender
流行性耳下腺炎,2020,6,2020-W06,7,11,18,260,gender
川崎病,2020,6,2020-W06,1,1,2,260,gender
インフルエンザ,2008,28,2008-W28,3,2,5,286,gender
RSウイルス感染症,2008,28,2008-W28,0,1,1,148,gender
咽頭結膜熱,2008,28,2008-W28,72,71,143,148,gender
Ａ群溶血性レンサ球菌咽頭炎,2008,28,2008-W28,140,130,270,148,gender
感染性胃腸炎,2008,28,2008-W28,399,340,739,148,gender
水痘,2008,28,2008-W28,89,81,170,148,gender
手足口病,2008,28,2008-W28,154,100,254,148,gender
突発性発しん,2008,28,2008-W28,52,70,122,148,gender
ヘルパンギーナ,2008,28,2008-W28,407,396,803,148,gender
流行性耳下腺炎,2008,28,2008-W28,84,63,147,148,gender
川崎病,2008,28,2008-W28,1,1,2,148,gender
インフルエンザ,2016,22,2016-W22,15,19,34,413,gender
RSウイルス感染症,2016,22,2016-W22,9,3,12,259,gender
咽頭結膜熱,2016,22,2016-W22,126,83,209,259,gender
Ａ群溶血性レンサ球菌咽頭炎,2016,22,2016-W22,484,364,848,259,gender
感染性胃腸炎,2016,22,2016-W22,928,851,1779,259,gender
水痘,2016,22,2016-W22,60,45,105,259,gender
手足口病,2016,22,2016-W22,25,18,43,259,gender
突発性発しん,2016,22,2016-W22,115,100,215,259,gender
ヘルパンギーナ,2016,22,2016-W22,34,30,64,259,gender
流行性耳下腺炎,2016,22,2016-W22,83,61,144,259,gender
川崎病,2016,22,2016-W22,2,3,5,259,gender
インフルエンザ,2009,46,2009-W46,3677,3442,7119,289,gender
RSウイルス感染症,2009,46,2009-W46,9,6,15,149,gender
咽頭結膜熱,2009,46,2009-W46,7,7,14,149,gender
Ａ群溶血性レンサ球菌咽頭炎,2009,46,2009-W46,73,65,138,149,gender
感染性胃腸炎,2009,46,2009-W46,225,206,431,149,gender
水痘,2009,46,2009-W46,53,40,93,149,gender
手足口病,2009,46,2009-W46,19,23,42,149,gender
突発性発しん,2009,46,2009-W46,39,35,74,149,gender
ヘルパンギーナ,2009,46,2009-W46,12,3,15,149,gender
流行性耳下腺炎,2009,46,2009-W46,63,52,115,149,gender
川崎病,2009,46,2009-W46,4,0,4,149,gender
インフルエンザ,2004,16,2004-W16,1,3,4,178,gender
RSウイルス感染症,2004,16,2004-W16,1,0,1,142,gender
咽頭結膜熱,2004,16,2004-W16,20,14,34,142,gender
Ａ群溶血性レンサ球菌咽頭炎,2004,16,2004-W16,86,118,204,142,gender
感染性胃腸炎,2004,16,2004-W16,374,348,722,142,gender
水痘,2004,16,2004-W16,88,84,172,142,gender
手足口病,2004,16,2004-W16,1,1,2,142,gender
突発性発しん,2004,16,2004-W16,36,41,77,142,gender
ヘルパンギーナ,2004,16,2004-W16,3,3,6,142,gender
流行性耳下腺炎,2004,16,2004-W16,19,21,40,142,gender
川崎病,2004,16,2004-W16,3,1,4,142,gender
インフルエンザ,2003,5,2003-W05,2589,2415,5004,178,gender
RSウイルス感染症,2003,5,2003-W05,0,0,0,142,gender
咽頭結膜熱,2003,5,2003-W05,7,4,11,142,gender
Ａ群溶血性レンサ球菌咽頭炎,2003,5,2003-W05,38,40,78,142,gender
感染性胃腸炎,2003,5,2003-W05,453,465,918,142,gender
水痘,2003,5,2003-W05,65,45,110,142,gender
手足口病,2003,5,2003-W05,2,1,3,142,gender
突発性発しん,2003,5,2003-W05,35,25,60,142,gender
ヘルパンギーナ,2003,5,2003-W05,0,4,4,142,gender
流行性耳下腺炎,2003,5,2003-W05,22,9,31,142,gender
川崎病,2003,5,2003-W05,0,0,0,142,gender
インフルエンザ,2006,9,2006-W09,452,440,892,178,gender
RSウイルス感染症,2006,9,2006-W09,1,3,4,142,gender
咽頭結膜熱,2006,9,2006-W09,22,13,35,142,gender
Ａ群溶血性レンサ球菌咽頭炎,2006,9,2006-W09,170,145,315,142,gender
感染性胃腸炎,2006,9,2006-W09,524,480,1004,142,gender
水痘,2006,9,2006-W09,89,94,183,142,gender
手足口病,2006,9,2006-W09,2,2,4,142,gender
突発性発しん,2006,9,2006-W09,26,27,53,142,gender
ヘルパンギーナ,2006,9,2006-W09,8,8,16,142,gender
流行性耳下腺炎,2006,9,2006-W09,47,37,84,142,gender
川崎病,2006,9,2006-W09,0,0,0,142,gender
インフルエンザ,2002,11,2002-W11,464,441,905,178,gender
RSウイルス感染症,2002,11,2002-W11,0,0,0,142,gender
咽頭結膜熱,2002,11,2002-W11,1,3,4,142,gender
Ａ群溶血性レンサ球菌咽頭炎,2002,11,2002-W11,38,43,81,142,gender
感染性胃腸炎,2002,11,2002-W11,487,464,951,142,gender
水痘,2002,11,2002-W11,66,61,127,142,gender
手足口病,2002,11,2002-W11,5,4,9,142,gender
突発性発しん,2002,11,2002-W11,36,30,66,142,gender
ヘルパンギーナ,2002,11,2002-W11,1,1,2,142,gender
流行性耳下腺炎,2002,11,2002-W11,55,35,90,142,gender
川崎病,2002,11,2002-W11,1,0,1,142,gender
インフルエンザ,2013,38,2013-W38,0,1,1,407,gender
RSウイルス感染症,2013,38,2013-W38,153,110,263,257,gender
咽頭結膜熱,2013,38,2013-W38,59,58,117,257,gender
Ａ群溶血性レンサ球菌咽頭炎,2013,38,2013-W38,108,92,200,257,gender
感染性胃腸炎,2013,38,2013-W38,392,361,753,257,gender
水痘,2013,38,2013-W38,68,47,115,257,gender
手足口病,2013,38,2013-W38,294,264,558,257,gender
突発性発しん,2013,38,2013-W38,93,75,168,257,gender
ヘルパンギーナ,2013,38,2013-W38,65,56,121,257,gender
流行性耳下腺炎,2013,38,2013-W38,24,13,37,257,gender
川崎病,2013,38,2013-W38,2,0,2,257,gender
インフルエンザ,2010,25,2010-W25,5,2,7,283,gender
RSウイルス感染症,2010,25,2010-W25,6,3,9,147,gender
咽頭結膜熱,2010,25,2010-W25,22,19,41,147,gender
Ａ群溶血性レンサ球菌咽頭炎,2010,25,2010-W25,149,121,270,147,gender
感染性胃腸炎,2010,25,2010-W25,383,323,706,147,gender
水痘,2010,25,2010-W25,128,109,237,147,gender
手足口病,2010,25,2010-W25,151,125,276,147,gender
突発性発しん,2010,25,2010-W25,50,60,110,147,gender
ヘルパンギーナ,2010,25,2010-W25,294,308,602,147,gender
流行性耳下腺炎,2010,25,2010-W25,94,82,176,147,gender
川崎病,2010,25,2010-W25,1,0,1,147,gender
インフルエンザ,2021,20,2021-W20,1,0,1,406,gender
RSウイルス感染症,2021,20,2021-W20,117,102,219,259,gender
咽頭結膜熱,2021,20,2021-W20,18,23,41,259,gender
Ａ群溶血性レンサ球菌咽頭炎,2021,20,2021-W20,54,34,88,259,gender
感染性胃腸炎,2021,20,2021-W20,614,515,1129,259,gender
水痘,2021,20,2021-W20,22,12,34,259,gender
手足口病,2021,20,2021-W20,6,14,20,259,gender
突発性発しん,2021,20,2021-W20,71,77,148,259,gender
ヘルパンギーナ,2021,20,2021-W20,2,3,5,259,gender
流行性耳下腺炎,2021,20,2021-W20,12,4,16,259,gender
川崎病,2021,20,2021-W20,2,0,2,259,gender
インフルエンザ,2003,41,2003-W41,0,0,0,178,gender
RSウイルス感染症,2003,41,2003-W41,0,0,0,142,gender
咽頭結膜熱,2003,41,2003-W41,7,4,11,142,gender
Ａ群溶血性レンサ球菌咽頭炎,2003,41,2003-W41,33,23,56,142,gender
感染性胃腸炎,2003,41,2003-W41,221,187,408,142,gender
水痘,2003,41,2003-W41,29,26,55,142,gender
手足口病,2003,41,2003-W41,16,19,35,142,gender
突発性発しん,2003,41,2003-W41,49,30,79,142,gender
ヘルパンギーナ,2003,41,2003-W41,24,12,36,142,gender
流行性耳下腺炎,2003,41,2003-W41,13,9,22,142,gender
川崎病,2003,41,2003-W41,0,0,0,142,gender
インフルエンザ,2014,2,2014-W02,1098,1000,2098,415,gender
RSウイルス感染症,2014,2,2014-W02,76,47,123,262,gender
咽頭結膜熱,2014,2,2014-W02,63,48,111,262,gender
Ａ群溶血性レンサ球菌咽頭炎,2014,2,2014-W02,242,237,479,262,gender
感染性胃腸炎,2014,2,2014-W02,1578,1571,3149,262,gender
水痘,2014,2,2014-W02,241,201,442,262,gender
手足口病,2014,2,2014-W02,8,13,21,262,gender
突発性発しん,2014,2,2014-W02,69,56,125,262,gender
ヘルパンギーナ,2014,2,2014-W02,1,3,4,262,gender
流行性耳下腺炎,2014,2,2014-W02,36,26,62,262,gender
川崎病,2014,2,2014-W02,0,0,0,262,gender
インフルエンザ,2001,32,2001-W32,0,0,0,178,gender
RSウイルス感染症,2001,32,2001-W32,0,0,0,142,gender
咽頭結膜熱,2001,32,2001-W32,22,18,40,142,gender
Ａ群溶血性レンサ球菌咽頭炎,2001,32,2001-W32,8,4,12,142,gender
感染性胃腸炎,2001,32,2001-W32,106,100,206,142,gender
水痘,2001,32,2001-W32,20,33,53,142,gender
手足口病,2001,32,2001-W32,35,21,56,142,gender
突発性発しん,2001,32,2001-W32,39,41,80,142,gender
ヘルパンギーナ,2001,32,2001-W32,101,80,181,142,gender
流行性耳下腺炎,2001,32,2001-W32,53,54,107,142,gender
川崎病,2001,32,2001-W32,1,0,1,142,gender
インフルエンザ,2008,16,2008-W16,58,83,141,289,gender
RSウイルス感染症,2008,16,2008-W16,2,2,4,150,gender
咽頭結膜熱,2008,16,2008-W16,19,9,28,150,gender
Ａ群溶血性レンサ球菌咽頭炎,2008,16,2008-W16,184,151,335,150,gender
感染性胃腸炎,2008,16,2008-W16,612,577,1189,150,gender
水痘,2008,16,2008-W16,105,93,198,150,gender
手足口病,2008,16,2008-W16,4,4,8,150,gender
突発性発しん,2008,16,2008-W16,59,57,116,150,gender
ヘルパンギーナ,2008,16,2008-W16,2,1,3,150,gender
流行性耳下腺炎,2008,16,2008-W16,29,16,45,150,gender
川崎病,2008,16,2008-W16,1,2,3,150,gender
インフルエンザ,2005,46,2005-W46,15,10,25,178,gender
RSウイルス感染症,2005,46,2005-W46,34,26,60,142,gender
咽頭結膜熱,2005,46,2005-W46,29,22,51,142,gender
Ａ群溶血性レンサ球菌咽頭炎,2005,46,2005-W46,124,121,245,142,gender
感染性胃腸炎,2005,46,2005-W46,468,435,903,142,gender
水痘,2005,46,2005-W46,76,72,148,142,gender
手足口病,2005,46,2005-W46,19,15,34,142,gender
突発性発しん,2005,46,2005-W46,32,23,55,142,gender
ヘルパンギーナ,2005,46,2005-W46,6,13,19,142,gender
流行性耳下腺炎,2005,46,2005-W46,106,76,182,142,gender
川崎病,2005,46,2005-W46,0,1,1,142,gender
インフルエンザ,2007,35,2007-W35,1,2,3,283,gender
RSウイルス感染症,2007,35,2007-W35,3,2,5,146,gender
咽頭結膜熱,2007,35,2007-W35,13,16,29,146,gender
Ａ群溶血性レンサ球菌咽頭炎,2007,35,2007-W35,43,45,88,146,gender
感染性胃腸炎,2007,35,2007-W35,267,215,482,146,gender
水痘,2007,35,2007-W35,26,11,37,146,gender
手足口病,2007,35,2007-W35,79,78,157,146,gender
突発性発しん,2007,35,2007-W35,55,48,103,146,gender
ヘルパンギーナ,2007,35,2007-W35,102,89,191,146,gender
流行性耳下腺炎,2007,35,2007-W35,17,11,28,146,gender
川崎病,2007,35,2007-W35,1,3,4,146,gender
インフルエンザ,2018,51,2018-W51,1625,1608,3233,415,gender
RSウイルス感染症,2018,51,2018-W51,39,25,64,262,gender
咽頭結膜熱,2018,51,2018-W51,57,49,106,262,gender
Ａ群溶血性レンサ球菌咽頭炎,2018,51,2018-W51,504,436,940,262,gender
感染性胃腸炎,2018,51,2018-W51,1848,1725,3573,262,gender
水痘,2018,51,2018-W51,86,89,175,262,gender
手足口病,2018,51,2018-W51,105,76,181,262,gender
突発性発しん,2018,51,2018-W51,53,50,103,262,gender
ヘルパンギーナ,2018,51,2018-W51,3,5,8,262,gender
流行性耳下腺炎,2018,51,2018-W51,10,6,16,262,gender
川崎病,2018,51,2018-W51,6,2,8,262,gender
インフルエンザ,2004,28,2004-W28,0,0,0,178,gender
RSウイルス感染症,2004,28,2004-W28,1,4,5,142,gender
咽頭結膜熱,2004,28,2004-W28,79,75,154,142,gender
Ａ群溶血性レンサ球菌咽頭炎,2004,28,2004-W28,54,46,100,142,gender
感染性胃腸炎,2004,28,2004-W28,209,197,406,142,gender
水痘,2004,28,2004-W28,55,34,89,142,gender
手足口病,2004,28,2004-W28,116,83,199,142,gender
突発性発しん,2004,28,2004-W28,41,47,88,142,gender
ヘルパンギーナ,2004,28,2004-W28,398,386,784,142,gender
流行性耳下腺炎,2004,28,2004-W28,39,30,69,142,gender
川崎病,2004,28,2004-W28,0,0,0,142,gender
インフルエンザ,2012,27,2012-W27,2,2,4,418,gender
RSウイルス感染症,2012,27,2012-W27,14,19,33,263,gender
咽頭結膜熱,2012,27,2012-W27,102,87,189,263,gender
Ａ群溶血性レンサ球菌咽頭炎,2012,27,2012-W27,349,284,633,263,gender
感染性胃腸炎,2012,27,2012-W27,950,801,1751,263,gender
水痘,2012,27,2012-W27,102,117,219,263,gender
手足口病,2012,27,2012-W27,123,108,231,263,gender
突発性発しん,2012,27,2012-W27,120,110,230,263,gender
ヘルパンギーナ,2012,27,2012-W27,622,550,1172,263,gender
流行性耳下腺炎,2012,27,2012-W27,55,50,105,263,gender
川崎病,2012,27,2012-W27,3,3,6,263,gender
インフルエンザ,2013,49,2013-W49,121,161,282,414,gender
RSウイルス感染症,2013,49,2013-W49,115,103,218,261,gender
咽頭結膜熱,2013,49,2013-W49,87,67,154,261,gender
Ａ群溶血性レンサ球菌咽頭炎,2013,49,2013-W49,334,272,606,261,gender
感染性胃腸炎,2013,49,2013-W49,2834,2764,5598,261,gender
水痘,2013,49,2013-W49,164,184,348,261,gender
手足口病,2013,49,2013-W49,30,31,61,261,gender
突発性発しん,2013,49,2013-W49,90,88,178,261,gender
ヘルパンギーナ,2013,49,2013-W49,5,8,13,261,gender
流行性耳下腺炎,2013,49,2013-W49,31,25,56,261,gender
川崎病,2013,49,2013-W49,4,2,6,261,gender
インフルエンザ,2023,7,2023-W07,2218,1920,4138,412,gender
RSウイルス感染症,2023,7,2023-W07,6,3,9,260,gender
咽頭結膜熱,2023,7,2023-W07,13,12,25,260,gender
Ａ群溶血性レンサ球菌咽頭炎,2023,7,2023-W07,55,37,92,260,gender
感染性胃腸炎,2023,7,2023-W07,936,899,1835,260,gender
水痘,2023,7,2023-W07,15,9,24,260,gender
手足口病,2023,7,2023-W07,9,7,16,260,gender
突発性発しん,2023,7,2023-W07,26,27,53,260,gender
ヘルパンギーナ,2023,7,2023-W07,5,1,6,260,gender
流行性耳下腺炎,2023,7,2023-W07,3,4,7,260,gender
川崎病,2023,7,2023-W07,2,2,4,260,gender
インフルエンザ,2009,37,2009-W37,921,775,1696,287,gender
RSウイルス感染症,2009,37,2009-W37,7,8,15,148,gender
咽頭結膜熱,2009,37,2009-W37,5,3,8,148,gender
Ａ群溶血性レンサ球菌咽頭炎,2009,37,2009-W37,41,41,82,148,gender
感染性胃腸炎,2009,37,2009-W37,253,216,469,148,gender
水痘,2009,37,2009-W37,19,16,35,148,gender
手足口病,2009,37,2009-W37,94,77,171,148,gender
突発性発しん,2009,37,2009-W37,47,50,97,148,gender
ヘルパンギーナ,2009,37,2009-W37,80,63,143,148,gender
流行性耳下腺炎,2009,37,2009-W37,45,46,91,148,gender
川崎病,2009,37,2009-W37,0,0,0,148,gender
インフルエンザ,2006,14,2006-W14,32,31,63,178,gender
RSウイルス感染症,2006,14,2006-W14,1,1,2,142,gender
咽頭結膜熱,2006,14,2006-W14,19,17,36,142,gender
Ａ群溶血性レンサ球菌咽頭炎,2006,14,2006-W14,117,95,212,142,gender
感染性胃腸炎,2006,14,2006-W14,437,391,828,142,gender
水痘,2006,14,2006-W14,100,110,210,142,gender
手足口病,2006,14,2006-W14,5,1,6,142,gender
突発性発しん,2006,14,2006-W14,45,35,80,142,gender
ヘルパンギーナ,2006,14,2006-W14,5,10,15,142,gender
流行性耳下腺炎,2006,14,2006-W14,67,48,115,142,gender
川崎病,2006,14,2006-W14,1,2,3,142,gender
インフルエンザ,2014,20,2014-W20,58,46,104,413,gender
RSウイルス感染症,2014,20,2014-W20,20,10,30,263,gender
咽頭結膜熱,2014,20,2014-W20,62,72,134,263,gender
Ａ群溶血性レンサ球菌咽頭炎,2014,20,2014-W20,442,386,828,263,gender
感染性胃腸炎,2014,20,2014-W20,1080,909,1989,263,gender
水痘,2014,20,2014-W20,144,148,292,263,gender
手足口病,2014,20,2014-W20,18,7,25,263,gender
突発性発しん,2014,20,2014-W20,107,89,196,263,gender
ヘルパンギーナ,2014,20,2014-W20,9,18,27,263,gender
流行性耳下腺炎,2014,20,2014-W20,28,21,49,263,gender
川崎病,2014,20,2014-W20,0,0,0,263,gender
インフルエンザ,2005,8,2005-W08,3128,3305,6433,178,gender
RSウイルス感染症,2005,8,2005-W08,1,1,2,142,gender
咽頭結膜熱,2005,8,2005-W08,4,6,10,142,gender
Ａ群溶血性レンサ球菌咽頭炎,2005,8,2005-W08,74,60,134,142,gender
感染性胃腸炎,2005,8,2005-W08,447,382,829,142,gender
水痘,2005,8,2005-W08,93,73,166,142,gender
手足口病,2005,8,2005-W08,12,7,19,142,gender
突発性発しん,2005,8,2005-W08,23,18,41,142,gender
ヘルパンギーナ,2005,8,2005-W08,4,2,6,142,gender
流行性耳下腺炎,2005,8,2005-W08,49,48,97,142,gender
川崎病,2005,8,2005-W08,0,0,0,142,gender
インフルエンザ,2018,20,2018-W20,46,28,74,416,gender
RSウイルス感染症,2018,20,2018-W20,41,30,71,263,gender
咽頭結膜熱,2018,20,2018-W20,83,74,157,263,gender
Ａ群溶血性レンサ球菌咽頭炎,2018,20,2018-W20,497,426,923,263,gender
感染性胃腸炎,2018,20,2018-W20,1063,1004,2067,263,gender
水痘,2018,20,2018-W20,48,35,83,263,gender
手足口病,2018,20,2018-W20,30,22,52,263,gender
突発性発しん,2018,20,2018-W20,85,88,173,263,gender
ヘルパンギーナ,2018,20,2018-W20,5,6,11,263,gender
流行性耳下腺炎,2018,20,2018-W20,10,12,22,263,gender
川崎病,2018,20,2018-W20,1,2,3,263,gender
インフルエンザ,2025,25,2025-W25,37,23,60,418,gender
新型コロナウイルス感染症（COVID-19）,2025,25,2025-W25,162,189,351,418,gender
RSウイルス感染症,2025,25,2025-W25,18,19,37,263,gender
咽頭結膜熱,2025,25,2025-W25,71,48,119,263,gender
Ａ群溶血性レンサ球菌咽頭炎,2025,25,2025-W25,476,374,850,263,gender
感染性胃腸炎,2025,25,2025-W25,935,743,1678,263,gender
水痘,2025,25,2025-W25,95,81,176,263,gender
手足口病,2025,25,2025-W25,40,41,81,263,gender
突発性発しん,2025,25,2025-W25,46,49,95,263,gender
ヘルパンギーナ,2025,25,2025-W25,41,26,67,263,gender
流行性耳下腺炎,2025,25,2025-W25,20,10,30,263,gender
川崎病,2025,25,2025-W25,7,3,10,263,gender
インフルエンザ,2005,37,2005-W37,3,0,3,178,gender
RSウイルス感染症,2005,37,2005-W37,1,2,3,142,gender
咽頭結膜熱,2005,37,2005-W37,31,27,58,142,gender
Ａ群溶血性レンサ球菌咽頭炎,2005,37,2005-W37,47,31,78,142,gender
感染性胃腸炎,2005,37,2005-W37,202,177,379,142,gender
水痘,2005,37,2005-W37,19,25,44,142,gender
手足口病,2005,37,2005-W37,32,24,56,142,gender
突発性発しん,2005,37,2005-W37,59,59,118,142,gender
ヘルパンギーナ,2005,37,2005-W37,38,55,93,142,gender
流行性耳下腺炎,2005,37,2005-W37,62,62,124,142,gender
川崎病,2005,37,2005-W37,0,1,1,142,gender
インフルエンザ,2007,44,2007-W44,82,92,174,286,gender
RSウイルス感染症,2007,44,2007-W44,28,28,56,149,gender
咽頭結膜熱,2007,44,2007-W44,17,11,28,149,gender
Ａ群溶血性レンサ球菌咽頭炎,2007,44,2007-W44,103,95,198,149,gender
感染性胃腸炎,2007,44,2007-W44,299,257,556,149,gender
水痘,2007,44,2007-W44,46,50,96,149,gender
手足口病,2007,44,2007-W44,33,17,50,149,gender
突発性発しん,2007,44,2007-W44,39,38,77,149,gender
ヘルパンギーナ,2007,44,2007-W44,15,8,23,149,gender
流行性耳下腺炎,2007,44,2007-W44,12,5,17,149,gender
川崎病,2007,44,2007-W44,2,0,2,149,gender
インフルエンザ,2019,1,2019-W01,1518,1638,3156,343,gender
RSウイルス感染症,2019,1,2019-W01,18,12,30,201,gender
咽頭結膜熱,2019,1,2019-W01,7,10,17,201,gender
Ａ群溶血性レンサ球菌咽頭炎,2019,1,2019-W01,58,49,107,201,gender
感染性胃腸炎,2019,1,2019-W01,316,265,581,201,gender
水痘,2019,1,2019-W01,34,35,69,201,gender
手足口病,2019,1,2019-W01,11,10,21,201,gender
突発性発しん,2019,1,2019-W01,16,12,28,201,gender
ヘルパンギーナ,2019,1,2019-W01,0,0,0,201,gender
流行性耳下腺炎,2019,1,2019-W01,1,1,2,201,gender
川崎病,2019,1,2019-W01,1,1,2,201,gender
インフルエンザ,2003,30,2003-W30,0,0,0,178,gender
RSウイルス感染症,2003,30,2003-W30,0,0,0,142,gender
咽頭結膜熱,2003,30,2003-W30,39,35,74,142,gender
Ａ群溶血性レンサ球菌咽頭炎,2003,30,2003-W30,38,28,66,142,gender
感染性胃腸炎,2003,30,2003-W30,127,102,229,142,gender
水痘,2003,30,2003-W30,45,53,98,142,gender
手足口病,2003,30,2003-W30,353,334,687,142,gender
突発性発しん,2003,30,2003-W30,40,36,76,142,gender
ヘルパンギーナ,2003,30,2003-W30,312,259,571,142,gender
流行性耳下腺炎,2003,30,2003-W30,15,15,30,142,gender
川崎病,2003,30,2003-W30,2,1,3,142,gender
インフルエンザ,2012,19,2012-W19,74,73,147,418,gender
RSウイルス感染症,2012,19,2012-W19,8,10,18,263,gender
咽頭結膜熱,2012,19,2012-W19,70,53,123,263,gender
Ａ群溶血性レンサ球菌咽頭炎,2012,19,2012-W19,331,310,641,263,gender
感染性胃腸炎,2012,19,2012-W19,1113,1022,2135,263,gender
水痘,2012,19,2012-W19,179,179,358,263,gender
手足口病,2012,19,2012-W19,12,19,31,263,gender
突発性発しん,2012,19,2012-W19,110,97,207,263,gender
ヘルパンギーナ,2012,19,2012-W19,5,5,10,263,gender
流行性耳下腺炎,2012,19,2012-W19,51,31,82,263,gender
川崎病,2012,19,2012-W19,2,1,3,263,gender
インフルエンザ,2001,43,2001-W43,0,1,1,178,gender
RSウイルス感染症,2001,43,2001-W43,0,0,0,142,gender
咽頭結膜熱,2001,43,2001-W43,3,10,13,142,gender
Ａ群溶血性レンサ球菌咽頭炎,2001,43,2001-W43,23,26,49,142,gender
感染性胃腸炎,2001,43,2001-W43,181,186,367,142,gender
水痘,2001,43,2001-W43,28,25,53,142,gender
手足口病,2001,43,2001-W43,19,13,32,142,gender
突発性発しん,2001,43,2001-W43,31,48,79,142,gender
ヘルパンギーナ,2001,43,2001-W43,10,8,18,142,gender
流行性耳下腺炎,2001,43,2001-W43,66,46,112,142,gender
川崎病,2001,43,2001-W43,0,0,0,142,gender
インフルエンザ,2023,22,2023-W22,363,343,706,417,gender
新型コロナウイルス感染症（COVID-19）,2023,22,2023-W22,1109,1099,2208,417,gender
RSウイルス感染症,2023,22,2023-W22,196,168,364,262,gender
咽頭結膜熱,2023,22,2023-W22,72,75,147,262,gender
Ａ群溶血性レンサ球菌咽頭炎,2023,22,2023-W22,285,189,474,262,gender
感染性胃腸炎,2023,22,2023-W22,1097,916,2013,262,gender
水痘,2023,22,2023-W22,22,17,39,262,gender
手足口病,2023,22,2023-W22,49,53,102,262,gender
突発性発しん,2023,22,2023-W22,68,42,110,262,gender
ヘルパンギーナ,2023,22,2023-W22,327,313,640,262,gender
流行性耳下腺炎,2023,22,2023-W22,18,7,25,262,gender
川崎病,2023,22,2023-W22,2,1,3,262,gender
インフルエンザ,2017,3,2017-W03,5989,5885,11874,416,gender
RSウイルス感染症,2017,3,2017-W03,16,22,38,262,gender
咽頭結膜熱,2017,3,2017-W03,25,32,57,262,gender
Ａ群溶血性レンサ球菌咽頭炎,2017,3,2017-W03,284,233,517,262,gender
感染性胃腸炎,2017,3,2017-W03,955,831,1786,262,gender
水痘,2017,3,2017-W03,34,36,70,262,gender
手足口病,2017,3,2017-W03,8,10,18,262,gender
突発性発しん,2017,3,2017-W03,51,56,107,262,gender
ヘルパンギーナ,2017,3,2017-W03,0,1,1,262,gender
流行性耳下腺炎,2017,3,2017-W03,35,31,66,262,gender
川崎病,2017,3,2017-W03,2,2,4,262,gender
インフルエンザ,2021,51,2021-W51,1,0,1,411,gender
RSウイルス感染症,2021,51,2021-W51,11,8,19,260,gender
咽頭結膜熱,2021,51,2021-W51,29,23,52,260,gender
Ａ群溶血性レンサ球菌咽頭炎,2021,51,2021-W51,55,33,88,260,gender
感染性胃腸炎,2021,51,2021-W51,1175,1097,2272,260,gender
水痘,2021,51,2021-W51,15,23,38,260,gender
手足口病,2021,51,2021-W51,89,62,151,260,gender
突発性発しん,2021,51,2021-W51,42,37,79,260,gender
ヘルパンギーナ,2021,51,2021-W51,29,24,53,260,gender
流行性耳下腺炎,2021,51,2021-W51,5,3,8,260,gender
川崎病,2021,51,2021-W51,1,0,1,260,gender
インフルエンザ,2009,24,2009-W24,15,8,23,286,gender
RSウイルス感染症,2009,24,2009-W24,4,6,10,147,gender
咽頭結膜熱,2009,24,2009-W24,33,15,48,147,gender
Ａ群溶血性レンサ球菌咽頭炎,2009,24,2009-W24,147,147,294,147,gender
感染性胃腸炎,2009,24,2009-W24,384,339,723,147,gender
水痘,2009,24,2009-W24,107,104,211,147,gender
手足口病,2009,24,2009-W24,15,15,30,147,gender
突発性発しん,2009,24,2009-W24,48,38,86,147,gender
ヘルパンギーナ,2009,24,2009-W24,6,10,16,147,gender
流行性耳下腺炎,2009,24,2009-W24,53,58,111,147,gender
川崎病,2009,24,2009-W24,1,2,3,147,gender
インフルエンザ,2016,40,2016-W40,52,44,96,411,gender
RSウイルス感染症,2016,40,2016-W40,378,345,723,259,gender
咽頭結膜熱,2016,40,2016-W40,33,37,70,259,gender
Ａ群溶血性レンサ球菌咽頭炎,2016,40,2016-W40,221,178,399,259,gender
感染性胃腸炎,2016,40,2016-W40,635,535,1170,259,gender
水痘,2016,40,2016-W40,47,49,96,259,gender
手足口病,2016,40,2016-W40,290,208,498,259,gender
突発性発しん,2016,40,2016-W40,83,74,157,259,gender
ヘルパンギーナ,2016,40,2016-W40,227,211,438,259,gender
流行性耳下腺炎,2016,40,2016-W40,111,104,215,259,gender
川崎病,2016,40,2016-W40,5,2,7,259,gender
インフルエンザ,2016,5,2016-W05,8253,8112,16365,415,gender
RSウイルス感染症,2016,5,2016-W05,41,26,67,261,gender
咽頭結膜熱,2016,5,2016-W05,34,30,64,261,gender
Ａ群溶血性レンサ球菌咽頭炎,2016,5,2016-W05,461,419,880,261,gender
感染性胃腸炎,2016,5,2016-W05,1095,1108,2203,261,gender
水痘,2016,5,2016-W05,69,54,123,261,gender
手足口病,2016,5,2016-W05,5,2,7,261,gender
突発性発しん,2016,5,2016-W05,55,60,115,261,gender
ヘルパンギーナ,2016,5,2016-W05,1,3,4,261,gender
流行性耳下腺炎,2016,5,2016-W05,87,60,147,261,gender
川崎病,2016,5,2016-W05,1,1,2,261,gender
インフルエンザ,2013,9,2013-W09,982,931,1913,416,gender
RSウイルス感染症,2013,9,2013-W09,34,33,67,264,gender
咽頭結膜熱,2013,9,2013-W09,34,33,67,264,gender
Ａ群溶血性レンサ球菌咽頭炎,2013,9,2013-W09,351,283,634,264,gender
感染性胃腸炎,2013,9,2013-W09,1390,1291,2681,264,gender
水痘,2013,9,2013-W09,83,85,168,264,gender
手足口病,2013,9,2013-W09,16,8,24,264,gender
突発性発しん,2013,9,2013-W09,61,67,128,264,gender
ヘルパンギーナ,2013,9,2013-W09,3,5,8,264,gender
流行性耳下腺炎,2013,9,2013-W09,25,21,46,264,gender
川崎病,2013,9,2013-W09,4,4,8,264,gender
インフルエンザ,2014,33,2014-W33,2,3,5,368,gender
RSウイルス感染症,2014,33,2014-W33,21,16,37,226,gender
咽頭結膜熱,2014,33,2014-W33,34,26,60,226,gender
Ａ群溶血性レンサ球菌咽頭炎,2014,33,2014-W33,65,62,127,226,gender
感染性胃腸炎,2014,33,2014-W33,338,271,609,226,gender
水痘,2014,33,2014-W33,47,40,87,226,gender
手足口病,2014,33,2014-W33,81,56,137,226,gender
突発性発しん,2014,33,2014-W33,65,52,117,226,gender
ヘルパンギーナ,2014,33,2014-W33,314,276,590,226,gender
流行性耳下腺炎,2014,33,2014-W33,46,31,77,226,gender
川崎病,2014,33,2014-W33,3,0,3,226,gender
インフルエンザ,2020,12,2020-W12,69,75,144,414,gender
RSウイルス感染症,2020,12,2020-W12,10,5,15,260,gender
咽頭結膜熱,2020,12,2020-W12,26,10,36,260,gender
Ａ群溶血性レンサ球菌咽頭炎,2020,12,2020-W12,210,167,377,260,gender
感染性胃腸炎,2020,12,2020-W12,346,318,664,260,gender
水痘,2020,12,2020-W12,25,37,62,260,gender
手足口病,2020,12,2020-W12,3,5,8,260,gender
突発性発しん,2020,12,2020-W12,48,41,89,260,gender
ヘルパンギーナ,2020,12,2020-W12,3,1,4,260,gender
流行性耳下腺炎,2020,12,2020-W12,11,4,15,260,gender
川崎病,2020,12,2020-W12,3,0,3,260,gender
インフルエンザ,2010,47,2010-W47,88,84,172,288,gender
RSウイルス感染症,2010,47,2010-W47,33,42,75,150,gender
咽頭結膜熱,2010,47,2010-W47,31,23,54,150,gender
Ａ群溶血性レンサ球菌咽頭炎,2010,47,2010-W47,152,123,275,150,gender
感染性胃腸炎,2010,47,2010-W47,1050,953,2003,150,gender
水痘,2010,47,2010-W47,104,95,199,150,gender
手足口病,2010,47,2010-W47,10,17,27,150,gender
突発性発しん,2010,47,2010-W47,44,39,83,150,gender
ヘルパンギーナ,2010,47,2010-W47,5,6,11,150,gender
流行性耳下腺炎,2010,47,2010-W47,40,19,59,150,gender
川崎病,2010,47,2010-W47,0,1,1,150,gender
インフルエンザ,2012,34,2012-W34,7,4,11,401,gender
RSウイルス感染症,2012,34,2012-W34,82,64,146,251,gender
咽頭結膜熱,2012,34,2012-W34,59,55,114,251,gender
Ａ群溶血性レンサ球菌咽頭炎,2012,34,2012-W34,96,89,185,251,gender
感染性胃腸炎,2012,34,2012-W34,417,347,764,251,gender
水痘,2012,34,2012-W34,60,52,112,251,gender
手足口病,2012,34,2012-W34,76,85,161,251,gender
突発性発しん,2012,34,2012-W34,80,87,167,251,gender
ヘルパンギーナ,2012,34,2012-W34,171,192,363,251,gender
流行性耳下腺炎,2012,34,2012-W34,36,20,56,251,gender
川崎病,2012,34,2012-W34,5,3,8,251,gender
インフルエンザ,2011,29,2011-W29,1,2,3,413,gender
RSウイルス感染症,2011,29,2011-W29,29,17,46,262,gender
咽頭結膜熱,2011,29,2011-W29,117,95,212,262,gender
Ａ群溶血性レンサ球菌咽頭炎,2011,29,2011-W29,160,142,302,262,gender
感染性胃腸炎,2011,29,2011-W29,451,371,822,262,gender
水痘,2011,29,2011-W29,89,66,155,262,gender
手足口病,2011,29,2011-W29,1423,1074,2497,262,gender
突発性発しん,2011,29,2011-W29,102,106,208,262,gender
ヘルパンギーナ,2011,29,2011-W29,961,835,1796,262,gender
流行性耳下腺炎,2011,29,2011-W29,65,50,115,262,gender
川崎病,2011,29,2011-W29,3,2,5,262,gender
インフルエンザ,2018,7,2018-W07,4439,4698,9137,416,gender
RSウイルス感染症,2018,7,2018-W07,32,25,57,263,gender
咽頭結膜熱,2018,7,2018-W07,25,12,37,263,gender
Ａ群溶血性レンサ球菌咽頭炎,2018,7,2018-W07,311,264,575,263,gender
感染性胃腸炎,2018,7,2018-W07,568,528,1096,263,gender
水痘,2018,7,2018-W07,39,27,66,263,gender
手足口病,2018,7,2018-W07,2,2,4,263,gender
突発性発しん,2018,7,2018-W07,44,48,92,263,gender
ヘルパンギーナ,2018,7,2018-W07,0,0,0,263,gender
流行性耳下腺炎,2018,7,2018-W07,10,12,22,263,gender
川崎病,2018,7,2018-W07,3,4,7,263,gender
インフルエンザ,2001,50,2001-W50,16,10,26,178,gender
RSウイルス感染症,2001,50,2001-W50,0,0,0,142,gender
咽頭結膜熱,2001,50,2001-W50,2,7,9,142,gender
Ａ群溶血性レンサ球菌咽頭炎,2001,50,2001-W50,60,50,110,142,gender
感染性胃腸炎,2001,50,2001-W50,847,823,1670,142,gender
水痘,2001,50,2001-W50,92,80,172,142,gender
手足口病,2001,50,2001-W50,6,8,14,142,gender
突発性発しん,2001,50,2001-W50,37,21,58,142,gender
ヘルパンギーナ,2001,50,2001-W50,4,6,10,142,gender
流行性耳下腺炎,2001,50,2001-W50,64,57,121,142,gender
川崎病,2001,50,2001-W50,1,2,3,142,gender
インフルエンザ,2022,1,2022-W01,2,2,4,404,gender
RSウイルス感染症,2022,1,2022-W01,4,1,5,254,gender
咽頭結膜熱,2022,1,2022-W01,16,7,23,254,gender
Ａ群溶血性レンサ球菌咽頭炎,2022,1,2022-W01,28,27,55,254,gender
感染性胃腸炎,2022,1,2022-W01,629,616,1245,254,gender
水痘,2022,1,2022-W01,16,9,25,254,gender
手足口病,2022,1,2022-W01,26,29,55,254,gender
突発性発しん,2022,1,2022-W01,23,30,53,254,gender
ヘルパンギーナ,2022,1,2022-W01,8,13,21,254,gender
流行性耳下腺炎,2022,1,2022-W01,5,0,5,254,gender
川崎病,2022,1,2022-W01,0,1,1,254,gender
インフルエンザ,2003,23,2003-W23,0,0,0,178,gender
RSウイルス感染症,2003,23,2003-W23,0,0,0,142,gender
咽頭結膜熱,2003,23,2003-W23,31,25,56,142,gender
Ａ群溶血性レンサ球菌咽頭炎,2003,23,2003-W23,76,60,136,142,gender
感染性胃腸炎,2003,23,2003-W23,278,274,552,142,gender
水痘,2003,23,2003-W23,78,49,127,142,gender
手足口病,2003,23,2003-W23,88,67,155,142,gender
突発性発しん,2003,23,2003-W23,43,60,103,142,gender
ヘルパンギーナ,2003,23,2003-W23,29,32,61,142,gender
流行性耳下腺炎,2003,23,2003-W23,15,8,23,142,gender
川崎病,2003,23,2003-W23,2,2,4,142,gender
インフルエンザ,2001,2,2001-W02,29,22,51,178,gender
RSウイルス感染症,2001,2,2001-W02,0,0,0,142,gender
咽頭結膜熱,2001,2,2001-W02,3,6,9,142,gender
Ａ群溶血性レンサ球菌咽頭炎,2001,2,2001-W02,26,22,48,142,gender
感染性胃腸炎,2001,2,2001-W02,442,451,893,142,gender
水痘,2001,2,2001-W02,115,94,209,142,gender
手足口病,2001,2,2001-W02,7,5,12,142,gender
突発性発しん,2001,2,2001-W02,31,32,63,142,gender
ヘルパンギーナ,2001,2,2001-W02,3,3,6,142,gender
流行性耳下腺炎,2001,2,2001-W02,97,81,178,142,gender
川崎病,2001,2,2001-W02,2,0,2,142,gender
インフルエンザ,2021,42,2021-W42,0,0,0,411,gender
RSウイルス感染症,2021,42,2021-W42,7,3,10,260,gender
咽頭結膜熱,2021,42,2021-W42,9,6,15,260,gender
Ａ群溶血性レンサ球菌咽頭炎,2021,42,2021-W42,40,38,78,260,gender
感染性胃腸炎,2021,42,2021-W42,374,305,679,260,gender
水痘,2021,42,2021-W42,6,11,17,260,gender
手足口病,2021,42,2021-W42,51,30,81,260,gender
突発性発しん,2021,42,2021-W42,48,41,89,260,gender
ヘルパンギーナ,2021,42,2021-W42,144,123,267,260,gender
流行性耳下腺炎,2021,42,2021-W42,9,4,13,260,gender
川崎病,2021,42,2021-W42,0,1,1,260,gender
インフルエンザ,2011,17,2011-W17,838,818,1656,412,gender
RSウイルス感染症,2011,17,2011-W17,5,11,16,259,gender
咽頭結膜熱,2011,17,2011-W17,37,38,75,259,gender
Ａ群溶血性レンサ球菌咽頭炎,2011,17,2011-W17,390,322,712,259,gender
感染性胃腸炎,2011,17,2011-W17,1077,995,2072,259,gender
水痘,2011,17,2011-W17,138,115,253,259,gender
手足口病,2011,17,2011-W17,5,9,14,259,gender
突発性発しん,2011,17,2011-W17,75,84,159,259,gender
ヘルパンギーナ,2011,17,2011-W17,4,2,6,259,gender
流行性耳下腺炎,2011,17,2011-W17,45,43,88,259,gender
川崎病,2011,17,2011-W17,5,1,6,259,gender
インフルエンザ,2023,31,2023-W31,248,265,513,413,gender
新型コロナウイルス感染症（COVID-19）,2023,31,2023-W31,2251,2516,4767,413,gender
RSウイルス感染症,2023,31,2023-W31,121,129,250,258,gender
咽頭結膜熱,2023,31,2023-W31,80,61,141,258,gender
Ａ群溶血性レンサ球菌咽頭炎,2023,31,2023-W31,177,125,302,258,gender
感染性胃腸炎,2023,31,2023-W31,465,409,874,258,gender
水痘,2023,31,2023-W31,17,12,29,258,gender
手足口病,2023,31,2023-W31,99,61,160,258,gender
突発性発しん,2023,31,2023-W31,33,37,70,258,gender
ヘルパンギーナ,2023,31,2023-W31,265,263,528,258,gender
流行性耳下腺炎,2023,31,2023-W31,4,3,7,258,gender
川崎病,2023,31,2023-W31,1,1,2,258,gender
インフルエンザ,2017,10,2017-W10,2131,2105,4236,415,gender
RSウイルス感染症,2017,10,2017-W10,16,13,29,261,gender
咽頭結膜熱,2017,10,2017-W10,40,26,66,261,gender
Ａ群溶血性レンサ球菌咽頭炎,2017,10,2017-W10,291,283,574,261,gender
感染性胃腸炎,2017,10,2017-W10,975,923,1898,261,gender
水痘,2017,10,2017-W10,40,33,73,261,gender
手足口病,2017,10,2017-W10,5,4,9,261,gender
突発性発しん,2017,10,2017-W10,61,52,113,261,gender
ヘルパンギーナ,2017,10,2017-W10,1,0,1,261,gender
流行性耳下腺炎,2017,10,2017-W10,43,15,58,261,gender
川崎病,2017,10,2017-W10,3,3,6,261,gender
インフルエンザ,2006,39,2006-W39,0,0,0,178,gender
RSウイルス感染症,2006,39,2006-W39,6,5,11,142,gender
咽頭結膜熱,2006,39,2006-W39,20,7,27,142,gender
Ａ群溶血性レンサ球菌咽頭炎,2006,39,2006-W39,90,54,144,142,gender
感染性胃腸炎,2006,39,2006-W39,224,206,430,142,gender
水痘,2006,39,2006-W39,40,35,75,142,gender
手足口病,2006,39,2006-W39,75,57,132,142,gender
突発性発しん,2006,39,2006-W39,52,42,94,142,gender
ヘルパンギーナ,2006,39,2006-W39,15,11,26,142,gender
流行性耳下腺炎,2006,39,2006-W39,45,34,79,142,gender
川崎病,2006,39,2006-W39,2,1,3,142,gender
インフルエンザ,2018,33,2018-W33,7,5,12,380,gender
RSウイルス感染症,2018,33,2018-W33,185,135,320,230,gender
咽頭結膜熱,2018,33,2018-W33,24,26,50,230,gender
Ａ群溶血性レンサ球菌咽頭炎,2018,33,2018-W33,111,92,203,230,gender
感染性胃腸炎,2018,33,2018-W33,288,271,559,230,gender
水痘,2018,33,2018-W33,15,14,29,230,gender
手足口病,2018,33,2018-W33,92,68,160,230,gender
突発性発しん,2018,33,2018-W33,39,32,71,230,gender
ヘルパンギーナ,2018,33,2018-W33,179,161,340,230,gender
流行性耳下腺炎,2018,33,2018-W33,7,5,12,230,gender
川崎病,2018,33,2018-W33,1,1,2,230,gender
インフルエンザ,2005,24,2005-W24,1,5,6,178,gender
RSウイルス感染症,2005,24,2005-W24,3,2,5,142,gender
咽頭結膜熱,2005,24,2005-W24,52,38,90,142,gender
Ａ群溶血性レンサ球菌咽頭炎,2005,24,2005-W24,128,108,236,142,gender
感染性胃腸炎,2005,24,2005-W24,324,318,642,142,gender
水痘,2005,24,2005-W24,144,112,256,142,gender
手足口病,2005,24,2005-W24,89,44,133,142,gender
突発性発しん,2005,24,2005-W24,55,38,93,142,gender
ヘルパンギーナ,2005,24,2005-W24,171,182,353,142,gender
流行性耳下腺炎,2005,24,2005-W24,111,87,198,142,gender
川崎病,2005,24,2005-W24,1,1,2,142,gender
インフルエンザ,2010,36,2010-W36,13,6,19,286,gender
RSウイルス感染症,2010,36,2010-W36,2,4,6,150,gender
咽頭結膜熱,2010,36,2010-W36,16,19,35,150,gender
Ａ群溶血性レンサ球菌咽頭炎,2010,36,2010-W36,54,57,111,150,gender
感染性胃腸炎,2010,36,2010-W36,336,280,616,150,gender
水痘,2010,36,2010-W36,36,33,69,150,gender
手足口病,2010,36,2010-W36,80,68,148,150,gender
突発性発しん,2010,36,2010-W36,70,55,125,150,gender
ヘルパンギーナ,2010,36,2010-W36,49,40,89,150,gender
流行性耳下腺炎,2010,36,2010-W36,46,42,88,150,gender
川崎病,2010,36,2010-W36,2,0,2,150,gender
インフルエンザ,2012,45,2012-W45,17,22,39,414,gender
RSウイルス感染症,2012,45,2012-W45,98,75,173,259,gender
咽頭結膜熱,2012,45,2012-W45,69,46,115,259,gender
Ａ群溶血性レンサ球菌咽頭炎,2012,45,2012-W45,304,240,544,259,gender
感染性胃腸炎,2012,45,2012-W45,1248,1215,2463,259,gender
水痘,2012,45,2012-W45,132,110,242,259,gender
手足口病,2012,45,2012-W45,67,58,125,259,gender
突発性発しん,2012,45,2012-W45,89,104,193,259,gender
ヘルパンギーナ,2012,45,2012-W45,8,18,26,259,gender
流行性耳下腺炎,2012,45,2012-W45,40,30,70,259,gender
川崎病,2012,45,2012-W45,2,1,3,259,gender
インフルエンザ,2022,10,2022-W10,1,0,1,409,gender
RSウイルス感染症,2022,10,2022-W10,8,2,10,258,gender
咽頭結膜熱,2022,10,2022-W10,7,2,9,258,gender
Ａ群溶血性レンサ球菌咽頭炎,2022,10,2022-W10,20,17,37,258,gender
感染性胃腸炎,2022,10,2022-W10,534,487,1021,258,gender
水痘,2022,10,2022-W10,6,4,10,258,gender
手足口病,2022,10,2022-W10,2,3,5,258,gender
突発性発しん,2022,10,2022-W10,19,32,51,258,gender
ヘルパンギーナ,2022,10,2022-W10,1,1,2,258,gender
流行性耳下腺炎,2022,10,2022-W10,5,6,11,258,gender
川崎病,2022,10,2022-W10,1,1,2,258,gender
インフルエンザ,2016,31,2016-W31,0,5,5,407,gender
RSウイルス感染症,2016,31,2016-W31,51,42,93,259,gender
咽頭結膜熱,2016,31,2016-W31,41,37,78,259,gender
Ａ群溶血性レンサ球菌咽頭炎,2016,31,2016-W31,222,206,428,259,gender
感染性胃腸炎,2016,31,2016-W31,626,516,1142,259,gender
水痘,2016,31,2016-W31,42,44,86,259,gender
手足口病,2016,31,2016-W31,140,123,263,259,gender
突発性発しん,2016,31,2016-W31,64,81,145,259,gender
ヘルパンギーナ,2016,31,2016-W31,721,637,1358,259,gender
流行性耳下腺炎,2016,31,2016-W31,113,123,236,259,gender
川崎病,2016,31,2016-W31,2,1,3,259,gender
インフルエンザ,2007,18,2007-W18,97,87,184,279,gender
RSウイルス感染症,2007,18,2007-W18,2,6,8,145,gender
咽頭結膜熱,2007,18,2007-W18,28,12,40,145,gender
Ａ群溶血性レンサ球菌咽頭炎,2007,18,2007-W18,107,89,196,145,gender
感染性胃腸炎,2007,18,2007-W18,235,206,441,145,gender
水痘,2007,18,2007-W18,71,84,155,145,gender
手足口病,2007,18,2007-W18,5,9,14,145,gender
突発性発しん,2007,18,2007-W18,19,26,45,145,gender
ヘルパンギーナ,2007,18,2007-W18,11,9,20,145,gender
流行性耳下腺炎,2007,18,2007-W18,11,13,24,145,gender
川崎病,2007,18,2007-W18,2,0,2,145,gender
インフルエンザ,2024,17,2024-W17,144,154,298,416,gender
新型コロナウイルス感染症（COVID-19）,2024,17,2024-W17,471,524,995,416,gender
RSウイルス感染症,2024,17,2024-W17,255,228,483,262,gender
咽頭結膜熱,2024,17,2024-W17,49,45,94,262,gender
Ａ群溶血性レンサ球菌咽頭炎,2024,17,2024-W17,576,496,1072,262,gender
感染性胃腸炎,2024,17,2024-W17,706,578,1284,262,gender
水痘,2024,17,2024-W17,26,23,49,262,gender
手足口病,2024,17,2024-W17,12,14,26,262,gender
突発性発しん,2024,17,2024-W17,34,38,72,262,gender
ヘルパンギーナ,2024,17,2024-W17,3,7,10,262,gender
流行性耳下腺炎,2024,17,2024-W17,5,9,14,262,gender
川崎病,2024,17,2024-W17,5,1,6,262,gender
インフルエンザ,2014,42,2014-W42,15,15,30,410,gender
RSウイルス感染症,2014,42,2014-W42,95,87,182,261,gender
咽頭結膜熱,2014,42,2014-W42,36,36,72,261,gender
Ａ群溶血性レンサ球菌咽頭炎,2014,42,2014-W42,196,173,369,261,gender
感染性胃腸炎,2014,42,2014-W42,480,369,849,261,gender
水痘,2014,42,2014-W42,61,59,120,261,gender
手足口病,2014,42,2014-W42,79,74,153,261,gender
突発性発しん,2014,42,2014-W42,87,73,160,261,gender
ヘルパンギーナ,2014,42,2014-W42,29,33,62,261,gender
流行性耳下腺炎,2014,42,2014-W42,27,14,41,261,gender
川崎病,2014,42,2014-W42,1,0,1,261,gender
インフルエンザ,2019,12,2019-W12,203,203,406,412,gender
RSウイルス感染症,2019,12,2019-W12,54,47,101,259,gender
咽頭結膜熱,2019,12,2019-W12,30,19,49,259,gender
Ａ群溶血性レンサ球菌咽頭炎,2019,12,2019-W12,305,265,570,259,gender
感染性胃腸炎,2019,12,2019-W12,838,753,1591,259,gender
水痘,2019,12,2019-W12,60,68,128,259,gender
手足口病,2019,12,2019-W12,11,11,22,259,gender
突発性発しん,2019,12,2019-W12,53,59,112,259,gender
ヘルパンギーナ,2019,12,2019-W12,0,2,2,259,gender
流行性耳下腺炎,2019,12,2019-W12,13,4,17,259,gender
川崎病,2019,12,2019-W12,0,1,1,259,gender
インフルエンザ,2010,8,2010-W08,201,204,405,288,gender
RSウイルス感染症,2010,8,2010-W08,44,39,83,149,gender
咽頭結膜熱,2010,8,2010-W08,18,11,29,149,gender
Ａ群溶血性レンサ球菌咽頭炎,2010,8,2010-W08,166,135,301,149,gender
感染性胃腸炎,2010,8,2010-W08,998,894,1892,149,gender
水痘,2010,8,2010-W08,96,91,187,149,gender
手足口病,2010,8,2010-W08,3,5,8,149,gender
突発性発しん,2010,8,2010-W08,40,35,75,149,gender
ヘルパンギーナ,2010,8,2010-W08,3,6,9,149,gender
流行性耳下腺炎,2010,8,2010-W08,41,55,96,149,gender
川崎病,2010,8,2010-W08,0,2,2,149,gender
インフルエンザ,2015,4,2015-W04,4842,4783,9625,416,gender
RSウイルス感染症,2015,4,2015-W04,78,70,148,263,gender
咽頭結膜熱,2015,4,2015-W04,42,28,70,263,gender
Ａ群溶血性レンサ球菌咽頭炎,2015,4,2015-W04,368,329,697,263,gender
感染性胃腸炎,2015,4,2015-W04,1251,1181,2432,263,gender
水痘,2015,4,2015-W04,71,55,126,263,gender
手足口病,2015,4,2015-W04,15,9,24,263,gender
突発性発しん,2015,4,2015-W04,55,73,128,263,gender
ヘルパンギーナ,2015,4,2015-W04,3,2,5,263,gender
流行性耳下腺炎,2015,4,2015-W04,15,24,39,263,gender
川崎病,2015,4,2015-W04,1,3,4,263,gender
インフルエンザ,2007,26,2007-W26,0,3,3,287,gender
RSウイルス感染症,2007,26,2007-W26,4,1,5,149,gender
咽頭結膜熱,2007,26,2007-W26,57,51,108,149,gender
Ａ群溶血性レンサ球菌咽頭炎,2007,26,2007-W26,155,133,288,149,gender
感染性胃腸炎,2007,26,2007-W26,405,309,714,149,gender
水痘,2007,26,2007-W26,114,99,213,149,gender
手足口病,2007,26,2007-W26,55,52,107,149,gender
突発性発しん,2007,26,2007-W26,67,66,133,149,gender
ヘルパンギーナ,2007,26,2007-W26,109,103,212,149,gender
流行性耳下腺炎,2007,26,2007-W26,42,30,72,149,gender
川崎病,2007,26,2007-W26,0,0,0,149,gender
インフルエンザ,2024,29,2024-W29,69,52,121,419,gender
新型コロナウイルス感染症（COVID-19）,2024,29,2024-W29,1633,1930,3563,419,gender
RSウイルス感染症,2024,29,2024-W29,59,38,97,264,gender
咽頭結膜熱,2024,29,2024-W29,35,27,62,264,gender
Ａ群溶血性レンサ球菌咽頭炎,2024,29,2024-W29,252,200,452,264,gender
感染性胃腸炎,2024,29,2024-W29,420,355,775,264,gender
水痘,2024,29,2024-W29,23,15,38,264,gender
手足口病,2024,29,2024-W29,1995,1684,3679,264,gender
突発性発しん,2024,29,2024-W29,30,32,62,264,gender
ヘルパンギーナ,2024,29,2024-W29,346,298,644,264,gender
流行性耳下腺炎,2024,29,2024-W29,9,5,14,264,gender
川崎病,2024,29,2024-W29,1,1,2,264,gender
インフルエンザ,2006,48,2006-W48,0,1,1,178,gender
RSウイルス感染症,2006,48,2006-W48,27,14,41,142,gender
咽頭結膜熱,2006,48,2006-W48,21,16,37,142,gender
Ａ群溶血性レンサ球菌咽頭炎,2006,48,2006-W48,119,81,200,142,gender
感染性胃腸炎,2006,48,2006-W48,1562,1546,3108,142,gender
水痘,2006,48,2006-W48,69,84,153,142,gender
手足口病,2006,48,2006-W48,39,26,65,142,gender
突発性発しん,2006,48,2006-W48,45,35,80,142,gender
ヘルパンギーナ,2006,48,2006-W48,1,5,6,142,gender
流行性耳下腺炎,2006,48,2006-W48,37,37,74,142,gender
川崎病,2006,48,2006-W48,2,0,2,142,gender
インフルエンザ,2015,12,2015-W12,500,484,984,414,gender
RSウイルス感染症,2015,12,2015-W12,27,19,46,263,gender
咽頭結膜熱,2015,12,2015-W12,22,30,52,263,gender
Ａ群溶血性レンサ球菌咽頭炎,2015,12,2015-W12,433,384,817,263,gender
感染性胃腸炎,2015,12,2015-W12,1101,1022,2123,263,gender
水痘,2015,12,2015-W12,87,67,154,263,gender
手足口病,2015,12,2015-W12,17,11,28,263,gender
突発性発しん,2015,12,2015-W12,74,67,141,263,gender
ヘルパンギーナ,2015,12,2015-W12,1,1,2,263,gender
流行性耳下腺炎,2015,12,2015-W12,30,27,57,263,gender
川崎病,2015,12,2015-W12,4,1,5,263,gender
インフルエンザ,2018,42,2018-W42,30,26,56,415,gender
RSウイルス感染症,2018,42,2018-W42,129,99,228,260,gender
咽頭結膜熱,2018,42,2018-W42,22,30,52,260,gender
Ａ群溶血性レンサ球菌咽頭炎,2018,42,2018-W42,261,239,500,260,gender
感染性胃腸炎,2018,42,2018-W42,641,512,1153,260,gender
水痘,2018,42,2018-W42,43,25,68,260,gender
手足口病,2018,42,2018-W42,197,176,373,260,gender
突発性発しん,2018,42,2018-W42,58,56,114,260,gender
ヘルパンギーナ,2018,42,2018-W42,63,66,129,260,gender
流行性耳下腺炎,2018,42,2018-W42,16,5,21,260,gender
川崎病,2018,42,2018-W42,3,0,3,260,gender
インフルエンザ,2021,33,2021-W33,0,0,0,397,gender
RSウイルス感染症,2021,33,2021-W33,186,164,350,247,gender
咽頭結膜熱,2021,33,2021-W33,14,6,20,247,gender
Ａ群溶血性レンサ球菌咽頭炎,2021,33,2021-W33,31,21,52,247,gender
感染性胃腸炎,2021,33,2021-W33,235,188,423,247,gender
水痘,2021,33,2021-W33,13,7,20,247,gender
手足口病,2021,33,2021-W33,8,9,17,247,gender
突発性発しん,2021,33,2021-W33,42,37,79,247,gender
ヘルパンギーナ,2021,33,2021-W33,17,18,35,247,gender
流行性耳下腺炎,2021,33,2021-W33,13,6,19,247,gender
川崎病,2021,33,2021-W33,0,3,3,247,gender
インフルエンザ,2013,15,2013-W15,130,103,233,413,gender
RSウイルス感染症,2013,15,2013-W15,17,11,28,260,gender
咽頭結膜熱,2013,15,2013-W15,36,32,68,260,gender
Ａ群溶血性レンサ球菌咽頭炎,2013,15,2013-W15,302,254,556,260,gender
感染性胃腸炎,2013,15,2013-W15,1047,938,1985,260,gender
水痘,2013,15,2013-W15,102,102,204,260,gender
手足口病,2013,15,2013-W15,12,17,29,260,gender
突発性発しん,2013,15,2013-W15,90,104,194,260,gender
ヘルパンギーナ,2013,15,2013-W15,7,2,9,260,gender
流行性耳下腺炎,2013,15,2013-W15,38,18,56,260,gender
川崎病,2013,15,2013-W15,1,1,2,260,gender
インフルエンザ,2023,40,2023-W40,3719,3154,6873,418,gender
新型コロナウイルス感染症（COVID-19）,2023,40,2023-W40,735,779,1514,418,gender
RSウイルス感染症,2023,40,2023-W40,7,13,20,263,gender
咽頭結膜熱,2023,40,2023-W40,291,265,556,263,gender
Ａ群溶血性レンサ球菌咽頭炎,2023,40,2023-W40,300,280,580,263,gender
感染性胃腸炎,2023,40,2023-W40,469,353,822,263,gender
水痘,2023,40,2023-W40,18,18,36,263,gender
手足口病,2023,40,2023-W40,302,244,546,263,gender
突発性発しん,2023,40,2023-W40,39,30,69,263,gender
ヘルパンギーナ,2023,40,2023-W40,68,58,126,263,gender
流行性耳下腺炎,2023,40,2023-W40,9,3,12,263,gender
川崎病,2023,40,2023-W40,1,2,3,263,gender
インフルエンザ,2001,21,2001-W21,0,2,2,178,gender
RSウイルス感染症,2001,21,2001-W21,0,0,0,142,gender
咽頭結膜熱,2001,21,2001-W21,4,4,8,142,gender
Ａ群溶血性レンサ球菌咽頭炎,2001,21,2001-W21,44,31,75,142,gender
感染性胃腸炎,2001,21,2001-W21,221,174,395,142,gender
水痘,2001,21,2001-W21,110,95,205,142,gender
手足口病,2001,21,2001-W21,13,19,32,142,gender
突発性発しん,2001,21,2001-W21,42,43,85,142,gender
ヘルパンギーナ,2001,21,2001-W21,15,12,27,142,gender
流行性耳下腺炎,2001,21,2001-W21,60,41,101,142,gender
川崎病,2001,21,2001-W21,0,2,2,142,gender
インフルエンザ,2002,3,2002-W03,87,75,162,178,gender
RSウイルス感染症,2002,3,2002-W03,0,0,0,142,gender
咽頭結膜熱,2002,3,2002-W03,2,1,3,142,gender
Ａ群溶血性レンサ球菌咽頭炎,2002,3,2002-W03,56,44,100,142,gender
感染性胃腸炎,2002,3,2002-W03,559,567,1126,142,gender
水痘,2002,3,2002-W03,78,70,148,142,gender
手足口病,2002,3,2002-W03,4,4,8,142,gender
突発性発しん,2002,3,2002-W03,37,35,72,142,gender
ヘルパンギーナ,2002,3,2002-W03,2,1,3,142,gender
流行性耳下腺炎,2002,3,2002-W03,31,25,56,142,gender
川崎病,2002,3,2002-W03,1,1,2,142,gender
インフルエンザ,2003,52,2003-W52,149,150,299,178,gender
RSウイルス感染症,2003,52,2003-W52,12,8,20,142,gender
咽頭結膜熱,2003,52,2003-W52,13,10,23,142,gender
Ａ群溶血性レンサ球菌咽頭炎,2003,52,2003-W52,71,63,134,142,gender
感染性胃腸炎,2003,52,2003-W52,1018,952,1970,142,gender
水痘,2003,52,2003-W52,96,109,205,142,gender
手足口病,2003,52,2003-W52,5,5,10,142,gender
突発性発しん,2003,52,2003-W52,40,34,74,142,gender
ヘルパンギーナ,2003,52,2003-W52,4,3,7,142,gender
流行性耳下腺炎,2003,52,2003-W52,14,18,32,142,gender
川崎病,2003,52,2003-W52,0,0,0,142,gender
インフルエンザ,2002,33,2002-W33,0,0,0,178,gender
RSウイルス感染症,2002,33,2002-W33,0,0,0,142,gender
咽頭結膜熱,2002,33,2002-W33,11,7,18,142,gender
Ａ群溶血性レンサ球菌咽頭炎,2002,33,2002-W33,4,5,9,142,gender
感染性胃腸炎,2002,33,2002-W33,68,51,119,142,gender
水痘,2002,33,2002-W33,14,17,31,142,gender
手足口病,2002,33,2002-W33,29,36,65,142,gender
突発性発しん,2002,33,2002-W33,20,14,34,142,gender
ヘルパンギーナ,2002,33,2002-W33,40,32,72,142,gender
流行性耳下腺炎,2002,33,2002-W33,29,20,49,142,gender
川崎病,2002,33,2002-W33,0,0,0,142,gender
インフルエンザ,2024,3,2024-W03,3527,3198,6725,414,gender
新型コロナウイルス感染症（COVID-19）,2024,3,2024-W03,1704,1744,3448,414,gender
RSウイルス感染症,2024,3,2024-W03,5,1,6,261,gender
咽頭結膜熱,2024,3,2024-W03,106,80,186,261,gender
Ａ群溶血性レンサ球菌咽頭炎,2024,3,2024-W03,569,485,1054,261,gender
感染性胃腸炎,2024,3,2024-W03,1461,1324,2785,261,gender
水痘,2024,3,2024-W03,26,17,43,261,gender
手足口病,2024,3,2024-W03,9,7,16,261,gender
突発性発しん,2024,3,2024-W03,34,28,62,261,gender
ヘルパンギーナ,2024,3,2024-W03,2,1,3,261,gender
流行性耳下腺炎,2024,3,2024-W03,11,4,15,261,gender
川崎病,2024,3,2024-W03,4,2,6,261,gender
インフルエンザ,2000,40,2000-W40,0,0,0,178,gender
RSウイルス感染症,2000,40,2000-W40,0,0,0,142,gender
咽頭結膜熱,2000,40,2000-W40,2,4,6,142,gender
Ａ群溶血性レンサ球菌咽頭炎,2000,40,2000-W40,28,19,47,142,gender
感染性胃腸炎,2000,40,2000-W40,149,111,260,142,gender
水痘,2000,40,2000-W40,25,20,45,142,gender
手足口病,2000,40,2000-W40,93,95,188,142,gender
突発性発しん,2000,40,2000-W40,31,42,73,142,gender
ヘルパンギーナ,2000,40,2000-W40,15,13,28,142,gender
流行性耳下腺炎,2000,40,2000-W40,49,50,99,142,gender
川崎病,2000,40,2000-W40,0,0,0,142,gender
インフルエンザ,2022,21,2022-W21,0,0,0,409,gender
RSウイルス感染症,2022,21,2022-W21,11,13,24,255,gender
咽頭結膜熱,2022,21,2022-W21,19,23,42,255,gender
Ａ群溶血性レンサ球菌咽頭炎,2022,21,2022-W21,21,20,41,255,gender
感染性胃腸炎,2022,21,2022-W21,851,766,1617,255,gender
水痘,2022,21,2022-W21,9,12,21,255,gender
手足口病,2022,21,2022-W21,35,15,50,255,gender
突発性発しん,2022,21,2022-W21,62,54,116,255,gender
ヘルパンギーナ,2022,21,2022-W21,5,3,8,255,gender
流行性耳下腺炎,2022,21,2022-W21,7,3,10,255,gender
川崎病,2022,21,2022-W21,0,0,0,255,gender
インフルエンザ,2020,52,2020-W52,1,1,2,407,gender
RSウイルス感染症,2020,52,2020-W52,2,3,5,256,gender
咽頭結膜熱,2020,52,2020-W52,33,20,53,256,gender
Ａ群溶血性レンサ球菌咽頭炎,2020,52,2020-W52,65,41,106,256,gender
感染性胃腸炎,2020,52,2020-W52,409,382,791,256,gender
水痘,2020,52,2020-W52,20,11,31,256,gender
手足口病,2020,52,2020-W52,0,3,3,256,gender
突発性発しん,2020,52,2020-W52,65,53,118,256,gender
ヘルパンギーナ,2020,52,2020-W52,3,2,5,256,gender
流行性耳下腺炎,2020,52,2020-W52,7,9,16,256,gender
川崎病,2020,52,2020-W52,0,2,2,256,gender
インフルエンザ,2019,23,2019-W23,51,59,110,415,gender
RSウイルス感染症,2019,23,2019-W23,34,30,64,261,gender
咽頭結膜熱,2019,23,2019-W23,102,65,167,261,gender
Ａ群溶血性レンサ球菌咽頭炎,2019,23,2019-W23,397,303,700,261,gender
感染性胃腸炎,2019,23,2019-W23,945,787,1732,261,gender
水痘,2019,23,2019-W23,99,75,174,261,gender
手足口病,2019,23,2019-W23,143,109,252,261,gender
突発性発しん,2019,23,2019-W23,88,102,190,261,gender
ヘルパンギーナ,2019,23,2019-W23,34,27,61,261,gender
流行性耳下腺炎,2019,23,2019-W23,14,10,24,261,gender
川崎病,2019,23,2019-W23,1,0,1,261,gender
インフルエンザ,2024,26,2024-W26,36,35,71,419,gender
新型コロナウイルス感染症（COVID-19）,2024,26,2024-W26,1119,1220,2339,419,gender
RSウイルス感染症,2024,26,2024-W26,83,75,158,264,gender
咽頭結膜熱,2024,26,2024-W26,68,59,127,264,gender
Ａ群溶血性レンサ球菌咽頭炎,2024,26,2024-W26,456,406,862,264,gender
感染性胃腸炎,2024,26,2024-W26,583,510,1093,264,gender
水痘,2024,26,2024-W26,29,20,49,264,gender
手足口病,2024,26,2024-W26,1424,1185,2609,264,gender
突発性発しん,2024,26,2024-W26,59,41,100,264,gender
ヘルパンギーナ,2024,26,2024-W26,318,314,632,264,gender
流行性耳下腺炎,2024,26,2024-W26,17,12,29,264,gender
川崎病,2024,26,2024-W26,2,1,3,264,gender
インフルエンザ,2007,29,2007-W29,3,1,4,286,gender
RSウイルス感染症,2007,29,2007-W29,3,0,3,149,gender
咽頭結膜熱,2007,29,2007-W29,48,27,75,149,gender
Ａ群溶血性レンサ球菌咽頭炎,2007,29,2007-W29,109,102,211,149,gender
感染性胃腸炎,2007,29,2007-W29,289,268,557,149,gender
水痘,2007,29,2007-W29,55,51,106,149,gender
手足口病,2007,29,2007-W29,202,163,365,149,gender
突発性発しん,2007,29,2007-W29,52,43,95,149,gender
ヘルパンギーナ,2007,29,2007-W29,442,452,894,149,gender
流行性耳下腺炎,2007,29,2007-W29,37,26,63,149,gender
川崎病,2007,29,2007-W29,1,0,1,149,gender
インフルエンザ,2004,34,2004-W34,0,0,0,178,gender
RSウイルス感染症,2004,34,2004-W34,1,1,2,142,gender
咽頭結膜熱,2004,34,2004-W34,24,21,45,142,gender
Ａ群溶血性レンサ球菌咽頭炎,2004,34,2004-W34,8,16,24,142,gender
感染性胃腸炎,2004,34,2004-W34,121,96,217,142,gender
水痘,2004,34,2004-W34,21,14,35,142,gender
手足口病,2004,34,2004-W34,28,27,55,142,gender
突発性発しん,2004,34,2004-W34,33,32,65,142,gender
ヘルパンギーナ,2004,34,2004-W34,39,34,73,142,gender
流行性耳下腺炎,2004,34,2004-W34,32,45,77,142,gender
川崎病,2004,34,2004-W34,1,1,2,142,gender
インフルエンザ,2006,47,2006-W47,1,2,3,178,gender
RSウイルス感染症,2006,47,2006-W47,23,18,41,142,gender
咽頭結膜熱,2006,47,2006-W47,20,6,26,142,gender
Ａ群溶血性レンサ球菌咽頭炎,2006,47,2006-W47,109,110,219,142,gender
感染性胃腸炎,2006,47,2006-W47,1464,1410,2874,142,gender
水痘,2006,47,2006-W47,62,69,131,142,gender
手足口病,2006,47,2006-W47,40,28,68,142,gender
突発性発しん,2006,47,2006-W47,37,28,65,142,gender
ヘルパンギーナ,2006,47,2006-W47,4,1,5,142,gender
流行性耳下腺炎,2006,47,2006-W47,24,28,52,142,gender
川崎病,2006,47,2006-W47,1,2,3,142,gender
インフルエンザ,2009,2,2009-W02,1452,1409,2861,286,gender
RSウイルス感染症,2009,2,2009-W02,7,15,22,148,gender
咽頭結膜熱,2009,2,2009-W02,15,15,30,148,gender
Ａ群溶血性レンサ球菌咽頭炎,2009,2,2009-W02,142,111,253,148,gender
感染性胃腸炎,2009,2,2009-W02,612,594,1206,148,gender
水痘,2009,2,2009-W02,180,161,341,148,gender
手足口病,2009,2,2009-W02,3,7,10,148,gender
突発性発しん,2009,2,2009-W02,35,35,70,148,gender
ヘルパンギーナ,2009,2,2009-W02,0,2,2,148,gender
流行性耳下腺炎,2009,2,2009-W02,68,45,113,148,gender
川崎病,2009,2,2009-W02,2,1,3,148,gender
インフルエンザ,2024,18,2024-W18,80,62,142,411,gender
新型コロナウイルス感染症（COVID-19）,2024,18,2024-W18,294,318,612,411,gender
RSウイルス感染症,2024,18,2024-W18,187,138,325,260,gender
咽頭結膜熱,2024,18,2024-W18,41,24,65,260,gender
Ａ群溶血性レンサ球菌咽頭炎,2024,18,2024-W18,326,272,598,260,gender
感染性胃腸炎,2024,18,2024-W18,377,317,694,260,gender
水痘,2024,18,2024-W18,13,16,29,260,gender
手足口病,2024,18,2024-W18,20,25,45,260,gender
突発性発しん,2024,18,2024-W18,31,28,59,260,gender
ヘルパンギーナ,2024,18,2024-W18,5,1,6,260,gender
流行性耳下腺炎,2024,18,2024-W18,12,7,19,260,gender
川崎病,2024,18,2024-W18,3,2,5,260,gender
インフルエンザ,2008,34,2008-W34,1,1,2,278,gender
RSウイルス感染症,2008,34,2008-W34,15,10,25,144,gender
咽頭結膜熱,2008,34,2008-W34,44,32,76,144,gender
Ａ群溶血性レンサ球菌咽頭炎,2008,34,2008-W34,42,41,83,144,gender
感染性胃腸炎,2008,34,2008-W34,242,184,426,144,gender
水痘,2008,34,2008-W34,13,19,32,144,gender
手足口病,2008,34,2008-W34,70,45,115,144,gender
突発性発しん,2008,34,2008-W34,53,41,94,144,gender
ヘルパンギーナ,2008,34,2008-W34,104,92,196,144,gender
流行性耳下腺炎,2008,34,2008-W34,47,43,90,144,gender
川崎病,2008,34,2008-W34,1,0,1,144,gender
インフルエンザ,2007,17,2007-W17,233,228,461,276,gender
RSウイルス感染症,2007,17,2007-W17,3,3,6,143,gender
咽頭結膜熱,2007,17,2007-W17,30,35,65,143,gender
Ａ群溶血性レンサ球菌咽頭炎,2007,17,2007-W17,183,163,346,143,gender
感染性胃腸炎,2007,17,2007-W17,427,373,800,143,gender
水痘,2007,17,2007-W17,120,109,229,143,gender
手足口病,2007,17,2007-W17,10,7,17,143,gender
突発性発しん,2007,17,2007-W17,62,67,129,143,gender
ヘルパンギーナ,2007,17,2007-W17,3,9,12,143,gender
流行性耳下腺炎,2007,17,2007-W17,23,13,36,143,gender
川崎病,2007,17,2007-W17,1,0,1,143,gender
インフルエンザ,2015,23,2015-W23,13,21,34,414,gender
RSウイルス感染症,2015,23,2015-W23,6,3,9,263,gender
咽頭結膜熱,2015,23,2015-W23,132,97,229,263,gender
Ａ群溶血性レンサ球菌咽頭炎,2015,23,2015-W23,568,475,1043,263,gender
感染性胃腸炎,2015,23,2015-W23,987,849,1836,263,gender
水痘,2015,23,2015-W23,103,71,174,263,gender
手足口病,2015,23,2015-W23,208,143,351,263,gender
突発性発しん,2015,23,2015-W23,83,108,191,263,gender
ヘルパンギーナ,2015,23,2015-W23,46,40,86,263,gender
流行性耳下腺炎,2015,23,2015-W23,55,32,87,263,gender
川崎病,2015,23,2015-W23,4,1,5,263,gender
インフルエンザ,2010,7,2010-W07,249,237,486,288,gender
RSウイルス感染症,2010,7,2010-W07,44,36,80,149,gender
咽頭結膜熱,2010,7,2010-W07,13,8,21,149,gender
Ａ群溶血性レンサ球菌咽頭炎,2010,7,2010-W07,139,109,248,149,gender
感染性胃腸炎,2010,7,2010-W07,886,826,1712,149,gender
水痘,2010,7,2010-W07,138,129,267,149,gender
手足口病,2010,7,2010-W07,8,3,11,149,gender
突発性発しん,2010,7,2010-W07,39,34,73,149,gender
ヘルパンギーナ,2010,7,2010-W07,2,1,3,149,gender
流行性耳下腺炎,2010,7,2010-W07,51,41,92,149,gender
川崎病,2010,7,2010-W07,2,0,2,149,gender
インフルエンザ,2017,50,2017-W50,1826,1930,3756,416,gender
RSウイルス感染症,2017,50,2017-W50,46,42,88,262,gender
咽頭結膜熱,2017,50,2017-W50,110,87,197,262,gender
Ａ群溶血性レンサ球菌咽頭炎,2017,50,2017-W50,572,492,1064,262,gender
感染性胃腸炎,2017,50,2017-W50,1777,1597,3374,262,gender
水痘,2017,50,2017-W50,102,103,205,262,gender
手足口病,2017,50,2017-W50,85,68,153,262,gender
突発性発しん,2017,50,2017-W50,56,74,130,262,gender
ヘルパンギーナ,2017,50,2017-W50,10,4,14,262,gender
流行性耳下腺炎,2017,50,2017-W50,20,11,31,262,gender
川崎病,2017,50,2017-W50,1,3,4,262,gender
インフルエンザ,2013,24,2013-W24,19,16,35,414,gender
RSウイルス感染症,2013,24,2013-W24,10,4,14,262,gender
咽頭結膜熱,2013,24,2013-W24,113,95,208,262,gender
Ａ群溶血性レンサ球菌咽頭炎,2013,24,2013-W24,460,362,822,262,gender
感染性胃腸炎,2013,24,2013-W24,824,696,1520,262,gender
水痘,2013,24,2013-W24,148,114,262,262,gender
手足口病,2013,24,2013-W24,141,119,260,262,gender
突発性発しん,2013,24,2013-W24,102,85,187,262,gender
ヘルパンギーナ,2013,24,2013-W24,43,37,80,262,gender
流行性耳下腺炎,2013,24,2013-W24,36,37,73,262,gender
川崎病,2013,24,2013-W24,1,4,5,262,gender
インフルエンザ,2010,39,2010-W39,15,12,27,286,gender
RSウイルス感染症,2010,39,2010-W39,10,15,25,148,gender
咽頭結膜熱,2010,39,2010-W39,16,11,27,148,gender
Ａ群溶血性レンサ球菌咽頭炎,2010,39,2010-W39,87,73,160,148,gender
感染性胃腸炎,2010,39,2010-W39,276,237,513,148,gender
水痘,2010,39,2010-W39,59,45,104,148,gender
手足口病,2010,39,2010-W39,49,41,90,148,gender
突発性発しん,2010,39,2010-W39,52,44,96,148,gender
ヘルパンギーナ,2010,39,2010-W39,11,9,20,148,gender
流行性耳下腺炎,2010,39,2010-W39,40,34,74,148,gender
川崎病,2010,39,2010-W39,0,0,0,148,gender
インフルエンザ,2001,10,2001-W10,400,431,831,178,gender
RSウイルス感染症,2001,10,2001-W10,0,0,0,142,gender
咽頭結膜熱,2001,10,2001-W10,3,0,3,142,gender
Ａ群溶血性レンサ球菌咽頭炎,2001,10,2001-W10,31,39,70,142,gender
感染性胃腸炎,2001,10,2001-W10,512,481,993,142,gender
水痘,2001,10,2001-W10,105,97,202,142,gender
手足口病,2001,10,2001-W10,5,7,12,142,gender
突発性発しん,2001,10,2001-W10,32,36,68,142,gender
ヘルパンギーナ,2001,10,2001-W10,3,1,4,142,gender
流行性耳下腺炎,2001,10,2001-W10,75,74,149,142,gender
川崎病,2001,10,2001-W10,0,0,0,142,gender
インフルエンザ,2009,15,2009-W15,550,545,1095,289,gender
RSウイルス感染症,2009,15,2009-W15,4,3,7,149,gender
咽頭結膜熱,2009,15,2009-W15,19,20,39,149,gender
Ａ群溶血性レンサ球菌咽頭炎,2009,15,2009-W15,122,103,225,149,gender
感染性胃腸炎,2009,15,2009-W15,492,438,930,149,gender
水痘,2009,15,2009-W15,73,87,160,149,gender
手足口病,2009,15,2009-W15,6,6,12,149,gender
突発性発しん,2009,15,2009-W15,57,64,121,149,gender
ヘルパンギーナ,2009,15,2009-W15,6,1,7,149,gender
流行性耳下腺炎,2009,15,2009-W15,46,34,80,149,gender
川崎病,2009,15,2009-W15,0,1,1,149,gender
インフルエンザ,2004,45,2004-W45,25,24,49,178,gender
RSウイルス感染症,2004,45,2004-W45,5,7,12,142,gender
咽頭結膜熱,2004,45,2004-W45,7,8,15,142,gender
Ａ群溶血性レンサ球菌咽頭炎,2004,45,2004-W45,49,29,78,142,gender
感染性胃腸炎,2004,45,2004-W45,245,177,422,142,gender
水痘,2004,45,2004-W45,80,76,156,142,gender
手足口病,2004,45,2004-W45,67,58,125,142,gender
突発性発しん,2004,45,2004-W45,36,33,69,142,gender
ヘルパンギーナ,2004,45,2004-W45,11,6,17,142,gender
流行性耳下腺炎,2004,45,2004-W45,47,48,95,142,gender
川崎病,2004,45,2004-W45,0,0,0,142,gender
インフルエンザ,2006,36,2006-W36,0,0,0,178,gender
RSウイルス感染症,2006,36,2006-W36,1,1,2,142,gender
咽頭結膜熱,2006,36,2006-W36,46,32,78,142,gender
Ａ群溶血性レンサ球菌咽頭炎,2006,36,2006-W36,29,39,68,142,gender
感染性胃腸炎,2006,36,2006-W36,199,177,376,142,gender
水痘,2006,36,2006-W36,24,19,43,142,gender
手足口病,2006,36,2006-W36,77,65,142,142,gender
突発性発しん,2006,36,2006-W36,52,57,109,142,gender
ヘルパンギーナ,2006,36,2006-W36,36,27,63,142,gender
流行性耳下腺炎,2006,36,2006-W36,36,23,59,142,gender
川崎病,2006,36,2006-W36,0,0,0,142,gender
インフルエンザ,2019,52,2019-W52,4889,4733,9622,415,gender
RSウイルス感染症,2019,52,2019-W52,41,27,68,261,gender
咽頭結膜熱,2019,52,2019-W52,84,70,154,261,gender
Ａ群溶血性レンサ球菌咽頭炎,2019,52,2019-W52,441,422,863,261,gender
感染性胃腸炎,2019,52,2019-W52,1396,1287,2683,261,gender
水痘,2019,52,2019-W52,91,72,163,261,gender
手足口病,2019,52,2019-W52,116,87,203,261,gender
突発性発しん,2019,52,2019-W52,50,54,104,261,gender
ヘルパンギーナ,2019,52,2019-W52,19,12,31,261,gender
流行性耳下腺炎,2019,52,2019-W52,9,5,14,261,gender
川崎病,2019,52,2019-W52,1,3,4,261,gender
インフルエンザ,2022,50,2022-W50,273,189,462,411,gender
RSウイルス感染症,2022,50,2022-W50,39,20,59,261,gender
咽頭結膜熱,2022,50,2022-W50,30,17,47,261,gender
Ａ群溶血性レンサ球菌咽頭炎,2022,50,2022-W50,30,23,53,261,gender
感染性胃腸炎,2022,50,2022-W50,1338,1158,2496,261,gender
水痘,2022,50,2022-W50,16,19,35,261,gender
手足口病,2022,50,2022-W50,21,25,46,261,gender
突発性発しん,2022,50,2022-W50,38,36,74,261,gender
ヘルパンギーナ,2022,50,2022-W50,2,5,7,261,gender
流行性耳下腺炎,2022,50,2022-W50,6,3,9,261,gender
川崎病,2022,50,2022-W50,0,1,1,261,gender
インフルエンザ,2020,23,2020-W23,0,0,0,412,gender
RSウイルス感染症,2020,23,2020-W23,0,0,0,260,gender
咽頭結膜熱,2020,23,2020-W23,2,2,4,260,gender
Ａ群溶血性レンサ球菌咽頭炎,2020,23,2020-W23,52,23,75,260,gender
感染性胃腸炎,2020,23,2020-W23,203,164,367,260,gender
水痘,2020,23,2020-W23,12,6,18,260,gender
手足口病,2020,23,2020-W23,14,11,25,260,gender
突発性発しん,2020,23,2020-W23,55,63,118,260,gender
ヘルパンギーナ,2020,23,2020-W23,1,2,3,260,gender
流行性耳下腺炎,2020,23,2020-W23,9,2,11,260,gender
川崎病,2020,23,2020-W23,1,3,4,260,gender
インフルエンザ,2002,42,2002-W42,0,0,0,178,gender
RSウイルス感染症,2002,42,2002-W42,0,0,0,142,gender
咽頭結膜熱,2002,42,2002-W42,9,5,14,142,gender
Ａ群溶血性レンサ球菌咽頭炎,2002,42,2002-W42,37,27,64,142,gender
感染性胃腸炎,2002,42,2002-W42,168,154,322,142,gender
水痘,2002,42,2002-W42,47,24,71,142,gender
手足口病,2002,42,2002-W42,20,21,41,142,gender
突発性発しん,2002,42,2002-W42,33,42,75,142,gender
ヘルパンギーナ,2002,42,2002-W42,2,7,9,142,gender
流行性耳下腺炎,2002,42,2002-W42,37,29,66,142,gender
川崎病,2002,42,2002-W42,0,0,0,142,gender
インフルエンザ,2004,1,2004-W01,59,64,123,178,gender
RSウイルス感染症,2004,1,2004-W01,1,1,2,142,gender
咽頭結膜熱,2004,1,2004-W01,2,2,4,142,gender
Ａ群溶血性レンサ球菌咽頭炎,2004,1,2004-W01,6,9,15,142,gender
感染性胃腸炎,2004,1,2004-W01,192,173,365,142,gender
水痘,2004,1,2004-W01,43,36,79,142,gender
手足口病,2004,1,2004-W01,1,0,1,142,gender
突発性発しん,2004,1,2004-W01,7,6,13,142,gender
ヘルパンギーナ,2004,1,2004-W01,0,0,0,142,gender
流行性耳下腺炎,2004,1,2004-W01,4,1,5,142,gender
川崎病,2004,1,2004-W01,0,0,0,142,gender
インフルエンザ,2011,18,2011-W18,310,256,566,411,gender
RSウイルス感染症,2011,18,2011-W18,9,2,11,259,gender
咽頭結膜熱,2011,18,2011-W18,35,21,56,259,gender
Ａ群溶血性レンサ球菌咽頭炎,2011,18,2011-W18,202,188,390,259,gender
感染性胃腸炎,2011,18,2011-W18,770,718,1488,259,gender
水痘,2011,18,2011-W18,138,146,284,259,gender
手足口病,2011,18,2011-W18,4,10,14,259,gender
突発性発しん,2011,18,2011-W18,63,46,109,259,gender
ヘルパンギーナ,2011,18,2011-W18,4,4,8,259,gender
流行性耳下腺炎,2011,18,2011-W18,36,29,65,259,gender
川崎病,2011,18,2011-W18,1,1,2,259,gender
インフルエンザ,2000,31,2000-W31,0,0,0,178,gender
RSウイルス感染症,2000,31,2000-W31,0,0,0,142,gender
咽頭結膜熱,2000,31,2000-W31,14,17,31,142,gender
Ａ群溶血性レンサ球菌咽頭炎,2000,31,2000-W31,21,13,34,142,gender
感染性胃腸炎,2000,31,2000-W31,116,90,206,142,gender
水痘,2000,31,2000-W31,46,39,85,142,gender
手足口病,2000,31,2000-W31,229,197,426,142,gender
突発性発しん,2000,31,2000-W31,38,23,61,142,gender
ヘルパンギーナ,2000,31,2000-W31,210,175,385,142,gender
流行性耳下腺炎,2000,31,2000-W31,70,44,114,142,gender
川崎病,2000,31,2000-W31,1,3,4,142,gender
インフルエンザ,2003,12,2003-W12,106,90,196,178,gender
RSウイルス感染症,2003,12,2003-W12,0,0,0,142,gender
咽頭結膜熱,2003,12,2003-W12,3,7,10,142,gender
Ａ群溶血性レンサ球菌咽頭炎,2003,12,2003-W12,44,42,86,142,gender
感染性胃腸炎,2003,12,2003-W12,478,426,904,142,gender
水痘,2003,12,2003-W12,73,57,130,142,gender
手足口病,2003,12,2003-W12,4,2,6,142,gender
突発性発しん,2003,12,2003-W12,30,31,61,142,gender
ヘルパンギーナ,2003,12,2003-W12,2,1,3,142,gender
流行性耳下腺炎,2003,12,2003-W12,11,6,17,142,gender
川崎病,2003,12,2003-W12,0,1,1,142,gender
インフルエンザ,2010,48,2010-W48,115,104,219,288,gender
RSウイルス感染症,2010,48,2010-W48,54,40,94,149,gender
咽頭結膜熱,2010,48,2010-W48,46,38,84,149,gender
Ａ群溶血性レンサ球菌咽頭炎,2010,48,2010-W48,193,159,352,149,gender
感染性胃腸炎,2010,48,2010-W48,1374,1278,2652,149,gender
水痘,2010,48,2010-W48,134,102,236,149,gender
手足口病,2010,48,2010-W48,13,12,25,149,gender
突発性発しん,2010,48,2010-W48,50,38,88,149,gender
ヘルパンギーナ,2010,48,2010-W48,4,2,6,149,gender
流行性耳下腺炎,2010,48,2010-W48,39,32,71,149,gender
川崎病,2010,48,2010-W48,1,0,1,149,gender
インフルエンザ,2011,26,2011-W26,6,3,9,413,gender
RSウイルス感染症,2011,26,2011-W26,13,6,19,261,gender
咽頭結膜熱,2011,26,2011-W26,108,89,197,261,gender
Ａ群溶血性レンサ球菌咽頭炎,2011,26,2011-W26,305,258,563,261,gender
感染性胃腸炎,2011,26,2011-W26,683,565,1248,261,gender
水痘,2011,26,2011-W26,189,195,384,261,gender
手足口病,2011,26,2011-W26,394,269,663,261,gender
突発性発しん,2011,26,2011-W26,119,113,232,261,gender
ヘルパンギーナ,2011,26,2011-W26,207,182,389,261,gender
流行性耳下腺炎,2011,26,2011-W26,53,45,98,261,gender
川崎病,2011,26,2011-W26,4,5,9,261,gender
インフルエンザ,2018,8,2018-W08,3453,3510,6963,414,gender
RSウイルス感染症,2018,8,2018-W08,38,17,55,261,gender
咽頭結膜熱,2018,8,2018-W08,20,20,40,261,gender
Ａ群溶血性レンサ球菌咽頭炎,2018,8,2018-W08,367,310,677,261,gender
感染性胃腸炎,2018,8,2018-W08,662,628,1290,261,gender
水痘,2018,8,2018-W08,26,27,53,261,gender
手足口病,2018,8,2018-W08,3,5,8,261,gender
突発性発しん,2018,8,2018-W08,52,41,93,261,gender
ヘルパンギーナ,2018,8,2018-W08,0,3,3,261,gender
流行性耳下腺炎,2018,8,2018-W08,7,13,20,261,gender
川崎病,2018,8,2018-W08,5,4,9,261,gender
インフルエンザ,2015,52,2015-W52,158,146,304,413,gender
RSウイルス感染症,2015,52,2015-W52,144,133,277,261,gender
咽頭結膜熱,2015,52,2015-W52,74,59,133,261,gender
Ａ群溶血性レンサ球菌咽頭炎,2015,52,2015-W52,481,358,839,261,gender
感染性胃腸炎,2015,52,2015-W52,1715,1666,3381,261,gender
水痘,2015,52,2015-W52,138,97,235,261,gender
手足口病,2015,52,2015-W52,7,6,13,261,gender
突発性発しん,2015,52,2015-W52,52,45,97,261,gender
ヘルパンギーナ,2015,52,2015-W52,4,1,5,261,gender
流行性耳下腺炎,2015,52,2015-W52,83,71,154,261,gender
川崎病,2015,52,2015-W52,4,3,7,261,gender
インフルエンザ,2017,21,2017-W21,55,68,123,412,gender
RSウイルス感染症,2017,21,2017-W21,38,18,56,261,gender
咽頭結膜熱,2017,21,2017-W21,119,93,212,261,gender
Ａ群溶血性レンサ球菌咽頭炎,2017,21,2017-W21,467,380,847,261,gender
感染性胃腸炎,2017,21,2017-W21,1079,943,2022,261,gender
水痘,2017,21,2017-W21,82,75,157,261,gender
手足口病,2017,21,2017-W21,77,66,143,261,gender
突発性発しん,2017,21,2017-W21,93,88,181,261,gender
ヘルパンギーナ,2017,21,2017-W21,18,8,26,261,gender
流行性耳下腺炎,2017,21,2017-W21,25,20,45,261,gender
川崎病,2017,21,2017-W21,3,2,5,261,gender
インフルエンザ,2008,45,2008-W45,16,14,30,286,gender
RSウイルス感染症,2008,45,2008-W45,60,54,114,149,gender
咽頭結膜熱,2008,45,2008-W45,16,17,33,149,gender
Ａ群溶血性レンサ球菌咽頭炎,2008,45,2008-W45,91,94,185,149,gender
感染性胃腸炎,2008,45,2008-W45,399,331,730,149,gender
水痘,2008,45,2008-W45,65,55,120,149,gender
手足口病,2008,45,2008-W45,54,44,98,149,gender
突発性発しん,2008,45,2008-W45,38,45,83,149,gender
ヘルパンギーナ,2008,45,2008-W45,13,7,20,149,gender
流行性耳下腺炎,2008,45,2008-W45,60,42,102,149,gender
川崎病,2008,45,2008-W45,3,0,3,149,gender
インフルエンザ,2005,15,2005-W15,148,131,279,178,gender
RSウイルス感染症,2005,15,2005-W15,3,3,6,142,gender
咽頭結膜熱,2005,15,2005-W15,18,7,25,142,gender
Ａ群溶血性レンサ球菌咽頭炎,2005,15,2005-W15,53,59,112,142,gender
感染性胃腸炎,2005,15,2005-W15,405,357,762,142,gender
水痘,2005,15,2005-W15,76,60,136,142,gender
手足口病,2005,15,2005-W15,4,9,13,142,gender
突発性発しん,2005,15,2005-W15,49,36,85,142,gender
ヘルパンギーナ,2005,15,2005-W15,3,5,8,142,gender
流行性耳下腺炎,2005,15,2005-W15,71,67,138,142,gender
川崎病,2005,15,2005-W15,0,0,0,142,gender
インフルエンザ,2013,6,2013-W06,4401,4403,8804,415,gender
RSウイルス感染症,2013,6,2013-W06,41,38,79,262,gender
咽頭結膜熱,2013,6,2013-W06,31,35,66,262,gender
Ａ群溶血性レンサ球菌咽頭炎,2013,6,2013-W06,337,295,632,262,gender
感染性胃腸炎,2013,6,2013-W06,1066,1052,2118,262,gender
水痘,2013,6,2013-W06,123,107,230,262,gender
手足口病,2013,6,2013-W06,11,11,22,262,gender
突発性発しん,2013,6,2013-W06,67,58,125,262,gender
ヘルパンギーナ,2013,6,2013-W06,1,2,3,262,gender
流行性耳下腺炎,2013,6,2013-W06,16,25,41,262,gender
川崎病,2013,6,2013-W06,3,4,7,262,gender
インフルエンザ,2016,18,2016-W18,90,86,176,412,gender
RSウイルス感染症,2016,18,2016-W18,5,2,7,258,gender
咽頭結膜熱,2016,18,2016-W18,55,43,98,258,gender
Ａ群溶血性レンサ球菌咽頭炎,2016,18,2016-W18,265,267,532,258,gender
感染性胃腸炎,2016,18,2016-W18,558,499,1057,258,gender
水痘,2016,18,2016-W18,45,41,86,258,gender
手足口病,2016,18,2016-W18,8,6,14,258,gender
突発性発しん,2016,18,2016-W18,72,67,139,258,gender
ヘルパンギーナ,2016,18,2016-W18,9,2,11,258,gender
流行性耳下腺炎,2016,18,2016-W18,62,45,107,258,gender
川崎病,2016,18,2016-W18,5,1,6,258,gender
インフルエンザ,2007,31,2007-W31,4,0,4,285,gender
RSウイルス感染症,2007,31,2007-W31,0,0,0,149,gender
咽頭結膜熱,2007,31,2007-W31,41,34,75,149,gender
Ａ群溶血性レンサ球菌咽頭炎,2007,31,2007-W31,72,73,145,149,gender
感染性胃腸炎,2007,31,2007-W31,253,196,449,149,gender
水痘,2007,31,2007-W31,58,52,110,149,gender
手足口病,2007,31,2007-W31,184,141,325,149,gender
突発性発しん,2007,31,2007-W31,37,51,88,149,gender
ヘルパンギーナ,2007,31,2007-W31,411,396,807,149,gender
流行性耳下腺炎,2007,31,2007-W31,22,22,44,149,gender
川崎病,2007,31,2007-W31,1,0,1,149,gender
インフルエンザ,2008,12,2008-W12,190,204,394,288,gender
RSウイルス感染症,2008,12,2008-W12,7,3,10,150,gender
咽頭結膜熱,2008,12,2008-W12,19,15,34,150,gender
Ａ群溶血性レンサ球菌咽頭炎,2008,12,2008-W12,163,150,313,150,gender
感染性胃腸炎,2008,12,2008-W12,919,881,1800,150,gender
水痘,2008,12,2008-W12,93,86,179,150,gender
手足口病,2008,12,2008-W12,2,2,4,150,gender
突発性発しん,2008,12,2008-W12,33,33,66,150,gender
ヘルパンギーナ,2008,12,2008-W12,2,1,3,150,gender
流行性耳下腺炎,2008,12,2008-W12,26,24,50,150,gender
川崎病,2008,12,2008-W12,1,3,4,150,gender
インフルエンザ,2005,42,2005-W42,0,2,2,178,gender
RSウイルス感染症,2005,42,2005-W42,15,8,23,142,gender
咽頭結膜熱,2005,42,2005-W42,14,15,29,142,gender
Ａ群溶血性レンサ球菌咽頭炎,2005,42,2005-W42,58,38,96,142,gender
感染性胃腸炎,2005,42,2005-W42,231,203,434,142,gender
水痘,2005,42,2005-W42,47,35,82,142,gender
手足口病,2005,42,2005-W42,22,20,42,142,gender
突発性発しん,2005,42,2005-W42,41,32,73,142,gender
ヘルパンギーナ,2005,42,2005-W42,9,14,23,142,gender
流行性耳下腺炎,2005,42,2005-W42,86,60,146,142,gender
川崎病,2005,42,2005-W42,2,0,2,142,gender
インフルエンザ,2001,36,2001-W36,0,0,0,178,gender
RSウイルス感染症,2001,36,2001-W36,0,0,0,142,gender
咽頭結膜熱,2001,36,2001-W36,9,10,19,142,gender
Ａ群溶血性レンサ球菌咽頭炎,2001,36,2001-W36,12,20,32,142,gender
感染性胃腸炎,2001,36,2001-W36,92,102,194,142,gender
水痘,2001,36,2001-W36,30,27,57,142,gender
手足口病,2001,36,2001-W36,17,18,35,142,gender
突発性発しん,2001,36,2001-W36,42,40,82,142,gender
ヘルパンギーナ,2001,36,2001-W36,22,18,40,142,gender
流行性耳下腺炎,2001,36,2001-W36,56,40,96,142,gender
川崎病,2001,36,2001-W36,0,1,1,142,gender
インフルエンザ,2014,6,2014-W06,7418,6874,14292,415,gender
RSウイルス感染症,2014,6,2014-W06,45,36,81,263,gender
咽頭結膜熱,2014,6,2014-W06,55,36,91,263,gender
Ａ群溶血性レンサ球菌咽頭炎,2014,6,2014-W06,217,220,437,263,gender
感染性胃腸炎,2014,6,2014-W06,1056,1041,2097,263,gender
水痘,2014,6,2014-W06,105,87,192,263,gender
手足口病,2014,6,2014-W06,8,4,12,263,gender
突発性発しん,2014,6,2014-W06,52,48,100,263,gender
ヘルパンギーナ,2014,6,2014-W06,1,0,1,263,gender
流行性耳下腺炎,2014,6,2014-W06,11,11,22,263,gender
川崎病,2014,6,2014-W06,2,3,5,263,gender
インフルエンザ,2003,45,2003-W45,0,1,1,178,gender
RSウイルス感染症,2003,45,2003-W45,0,0,0,142,gender
咽頭結膜熱,2003,45,2003-W45,6,7,13,142,gender
Ａ群溶血性レンサ球菌咽頭炎,2003,45,2003-W45,43,41,84,142,gender
感染性胃腸炎,2003,45,2003-W45,366,327,693,142,gender
水痘,2003,45,2003-W45,84,83,167,142,gender
手足口病,2003,45,2003-W45,20,14,34,142,gender
突発性発しん,2003,45,2003-W45,31,35,66,142,gender
ヘルパンギーナ,2003,45,2003-W45,5,9,14,142,gender
流行性耳下腺炎,2003,45,2003-W45,15,10,25,142,gender
川崎病,2003,45,2003-W45,0,1,1,142,gender
インフルエンザ,2022,39,2022-W39,3,2,5,410,gender
RSウイルス感染症,2022,39,2022-W39,183,157,340,257,gender
咽頭結膜熱,2022,39,2022-W39,4,5,9,257,gender
Ａ群溶血性レンサ球菌咽頭炎,2022,39,2022-W39,28,27,55,257,gender
感染性胃腸炎,2022,39,2022-W39,317,270,587,257,gender
水痘,2022,39,2022-W39,7,6,13,257,gender
手足口病,2022,39,2022-W39,407,358,765,257,gender
突発性発しん,2022,39,2022-W39,36,27,63,257,gender
ヘルパンギーナ,2022,39,2022-W39,91,88,179,257,gender
流行性耳下腺炎,2022,39,2022-W39,9,5,14,257,gender
川崎病,2022,39,2022-W39,2,1,3,257,gender
インフルエンザ,2021,24,2021-W24,0,0,0,405,gender
RSウイルス感染症,2021,24,2021-W24,455,395,850,259,gender
咽頭結膜熱,2021,24,2021-W24,38,40,78,259,gender
Ａ群溶血性レンサ球菌咽頭炎,2021,24,2021-W24,54,54,108,259,gender
感染性胃腸炎,2021,24,2021-W24,582,524,1106,259,gender
水痘,2021,24,2021-W24,16,19,35,259,gender
手足口病,2021,24,2021-W24,25,15,40,259,gender
突発性発しん,2021,24,2021-W24,68,53,121,259,gender
ヘルパンギーナ,2021,24,2021-W24,7,2,9,259,gender
流行性耳下腺炎,2021,24,2021-W24,13,7,20,259,gender
川崎病,2021,24,2021-W24,4,0,4,259,gender
インフルエンザ,2010,21,2010-W21,7,11,18,286,gender
RSウイルス感染症,2010,21,2010-W21,6,3,9,149,gender
咽頭結膜熱,2010,21,2010-W21,30,18,48,149,gender
Ａ群溶血性レンサ球菌咽頭炎,2010,21,2010-W21,183,129,312,149,gender
感染性胃腸炎,2010,21,2010-W21,543,492,1035,149,gender
水痘,2010,21,2010-W21,155,171,326,149,gender
手足口病,2010,21,2010-W21,57,50,107,149,gender
突発性発しん,2010,21,2010-W21,50,40,90,149,gender
ヘルパンギーナ,2010,21,2010-W21,57,56,113,149,gender
流行性耳下腺炎,2010,21,2010-W21,63,57,120,149,gender
川崎病,2010,21,2010-W21,0,1,1,149,gender
インフルエンザ,2012,52,2012-W52,768,809,1577,410,gender
RSウイルス感染症,2012,52,2012-W52,67,48,115,258,gender
咽頭結膜熱,2012,52,2012-W52,73,60,133,258,gender
Ａ群溶血性レンサ球菌咽頭炎,2012,52,2012-W52,220,208,428,258,gender
感染性胃腸炎,2012,52,2012-W52,1769,1663,3432,258,gender
水痘,2012,52,2012-W52,163,148,311,258,gender
手足口病,2012,52,2012-W52,39,16,55,258,gender
突発性発しん,2012,52,2012-W52,57,59,116,258,gender
ヘルパンギーナ,2012,52,2012-W52,6,3,9,258,gender
流行性耳下腺炎,2012,52,2012-W52,21,22,43,258,gender
川崎病,2012,52,2012-W52,0,3,3,258,gender
インフルエンザ,2002,15,2002-W15,15,18,33,178,gender
RSウイルス感染症,2002,15,2002-W15,0,0,0,142,gender
咽頭結膜熱,2002,15,2002-W15,2,1,3,142,gender
Ａ群溶血性レンサ球菌咽頭炎,2002,15,2002-W15,26,20,46,142,gender
感染性胃腸炎,2002,15,2002-W15,248,248,496,142,gender
水痘,2002,15,2002-W15,60,63,123,142,gender
手足口病,2002,15,2002-W15,11,10,21,142,gender
突発性発しん,2002,15,2002-W15,34,44,78,142,gender
ヘルパンギーナ,2002,15,2002-W15,2,4,6,142,gender
流行性耳下腺炎,2002,15,2002-W15,54,37,91,142,gender
川崎病,2002,15,2002-W15,0,0,0,142,gender
インフルエンザ,2017,48,2017-W48,659,664,1323,418,gender
RSウイルス感染症,2017,48,2017-W48,37,39,76,263,gender
咽頭結膜熱,2017,48,2017-W48,114,89,203,263,gender
Ａ群溶血性レンサ球菌咽頭炎,2017,48,2017-W48,487,448,935,263,gender
感染性胃腸炎,2017,48,2017-W48,1467,1304,2771,263,gender
水痘,2017,48,2017-W48,97,89,186,263,gender
手足口病,2017,48,2017-W48,120,89,209,263,gender
突発性発しん,2017,48,2017-W48,83,65,148,263,gender
ヘルパンギーナ,2017,48,2017-W48,19,12,31,263,gender
流行性耳下腺炎,2017,48,2017-W48,16,14,30,263,gender
川崎病,2017,48,2017-W48,5,1,6,263,gender
インフルエンザ,2003,1,2003-W01,147,144,291,178,gender
RSウイルス感染症,2003,1,2003-W01,0,0,0,142,gender
咽頭結膜熱,2003,1,2003-W01,2,1,3,142,gender
Ａ群溶血性レンサ球菌咽頭炎,2003,1,2003-W01,5,3,8,142,gender
感染性胃腸炎,2003,1,2003-W01,71,74,145,142,gender
水痘,2003,1,2003-W01,38,32,70,142,gender
手足口病,2003,1,2003-W01,0,1,1,142,gender
突発性発しん,2003,1,2003-W01,2,3,5,142,gender
ヘルパンギーナ,2003,1,2003-W01,0,0,0,142,gender
流行性耳下腺炎,2003,1,2003-W01,4,2,6,142,gender
川崎病,2003,1,2003-W01,0,0,0,142,gender
インフルエンザ,2009,42,2009-W42,3328,3153,6481,289,gender
RSウイルス感染症,2009,42,2009-W42,9,3,12,149,gender
咽頭結膜熱,2009,42,2009-W42,4,1,5,149,gender
Ａ群溶血性レンサ球菌咽頭炎,2009,42,2009-W42,48,50,98,149,gender
感染性胃腸炎,2009,42,2009-W42,156,159,315,149,gender
水痘,2009,42,2009-W42,30,17,47,149,gender
手足口病,2009,42,2009-W42,69,50,119,149,gender
突発性発しん,2009,42,2009-W42,44,34,78,149,gender
ヘルパンギーナ,2009,42,2009-W42,15,17,32,149,gender
流行性耳下腺炎,2009,42,2009-W42,51,30,81,149,gender
川崎病,2009,42,2009-W42,1,0,1,149,gender
インフルエンザ,2004,12,2004-W12,44,47,91,178,gender
RSウイルス感染症,2004,12,2004-W12,3,2,5,142,gender
咽頭結膜熱,2004,12,2004-W12,5,7,12,142,gender
Ａ群溶血性レンサ球菌咽頭炎,2004,12,2004-W12,90,87,177,142,gender
感染性胃腸炎,2004,12,2004-W12,562,572,1134,142,gender
水痘,2004,12,2004-W12,84,62,146,142,gender
手足口病,2004,12,2004-W12,1,1,2,142,gender
突発性発しん,2004,12,2004-W12,25,26,51,142,gender
ヘルパンギーナ,2004,12,2004-W12,3,1,4,142,gender
流行性耳下腺炎,2004,12,2004-W12,9,15,24,142,gender
川崎病,2004,12,2004-W12,1,1,2,142,gender
インフルエンザ,2016,26,2016-W26,4,3,7,416,gender
RSウイルス感染症,2016,26,2016-W26,16,16,32,262,gender
咽頭結膜熱,2016,26,2016-W26,126,97,223,262,gender
Ａ群溶血性レンサ球菌咽頭炎,2016,26,2016-W26,456,382,838,262,gender
感染性胃腸炎,2016,26,2016-W26,838,699,1537,262,gender
水痘,2016,26,2016-W26,69,42,111,262,gender
手足口病,2016,26,2016-W26,74,56,130,262,gender
突発性発しん,2016,26,2016-W26,114,98,212,262,gender
ヘルパンギーナ,2016,26,2016-W26,320,288,608,262,gender
流行性耳下腺炎,2016,26,2016-W26,105,83,188,262,gender
川崎病,2016,26,2016-W26,2,1,3,262,gender
インフルエンザ,2020,2,2020-W02,3000,3000,6000,416,gender
RSウイルス感染症,2020,2,2020-W02,24,18,42,261,gender
咽頭結膜熱,2020,2,2020-W02,54,44,98,261,gender
Ａ群溶血性レンサ球菌咽頭炎,2020,2,2020-W02,327,290,617,261,gender
感染性胃腸炎,2020,2,2020-W02,1078,1026,2104,261,gender
水痘,2020,2,2020-W02,124,90,214,261,gender
手足口病,2020,2,2020-W02,25,28,53,261,gender
突発性発しん,2020,2,2020-W02,38,45,83,261,gender
ヘルパンギーナ,2020,2,2020-W02,10,10,20,261,gender
流行性耳下腺炎,2020,2,2020-W02,8,8,16,261,gender
川崎病,2020,2,2020-W02,2,1,3,261,gender
インフルエンザ,2017,7,2017-W07,4535,4742,9277,416,gender
RSウイルス感染症,2017,7,2017-W07,10,18,28,262,gender
咽頭結膜熱,2017,7,2017-W07,43,24,67,262,gender
Ａ群溶血性レンサ球菌咽頭炎,2017,7,2017-W07,310,237,547,262,gender
感染性胃腸炎,2017,7,2017-W07,893,796,1689,262,gender
水痘,2017,7,2017-W07,37,37,74,262,gender
手足口病,2017,7,2017-W07,11,8,19,262,gender
突発性発しん,2017,7,2017-W07,62,59,121,262,gender
ヘルパンギーナ,2017,7,2017-W07,1,0,1,262,gender
流行性耳下腺炎,2017,7,2017-W07,49,29,78,262,gender
川崎病,2017,7,2017-W07,0,3,3,262,gender
インフルエンザ,2000,29,2000-W29,0,0,0,178,gender
RSウイルス感染症,2000,29,2000-W29,0,0,0,142,gender
咽頭結膜熱,2000,29,2000-W29,16,9,25,142,gender
Ａ群溶血性レンサ球菌咽頭炎,2000,29,2000-W29,29,22,51,142,gender
感染性胃腸炎,2000,29,2000-W29,142,113,255,142,gender
水痘,2000,29,2000-W29,38,59,97,142,gender
手足口病,2000,29,2000-W29,318,257,575,142,gender
突発性発しん,2000,29,2000-W29,27,32,59,142,gender
ヘルパンギーナ,2000,29,2000-W29,457,446,903,142,gender
流行性耳下腺炎,2000,29,2000-W29,76,44,120,142,gender
川崎病,2000,29,2000-W29,1,1,2,142,gender
インフルエンザ,2023,26,2023-W26,201,181,382,415,gender
新型コロナウイルス感染症（COVID-19）,2023,26,2023-W26,1396,1447,2843,415,gender
RSウイルス感染症,2023,26,2023-W26,382,304,686,260,gender
咽頭結膜熱,2023,26,2023-W26,65,42,107,260,gender
Ａ群溶血性レンサ球菌咽頭炎,2023,26,2023-W26,246,212,458,260,gender
感染性胃腸炎,2023,26,2023-W26,683,579,1262,260,gender
水痘,2023,26,2023-W26,13,14,27,260,gender
手足口病,2023,26,2023-W26,86,59,145,260,gender
突発性発しん,2023,26,2023-W26,34,33,67,260,gender
ヘルパンギーナ,2023,26,2023-W26,1138,998,2136,260,gender
流行性耳下腺炎,2023,26,2023-W26,5,5,10,260,gender
川崎病,2023,26,2023-W26,2,1,3,260,gender
インフルエンザ,2001,47,2001-W47,3,5,8,178,gender
RSウイルス感染症,2001,47,2001-W47,0,0,0,142,gender
咽頭結膜熱,2001,47,2001-W47,6,9,15,142,gender
Ａ群溶血性レンサ球菌咽頭炎,2001,47,2001-W47,50,30,80,142,gender
感染性胃腸炎,2001,47,2001-W47,375,342,717,142,gender
水痘,2001,47,2001-W47,86,68,154,142,gender
手足口病,2001,47,2001-W47,17,13,30,142,gender
突発性発しん,2001,47,2001-W47,23,30,53,142,gender
ヘルパンギーナ,2001,47,2001-W47,9,6,15,142,gender
流行性耳下腺炎,2001,47,2001-W47,59,49,108,142,gender
川崎病,2001,47,2001-W47,0,0,0,142,gender
インフルエンザ,2003,34,2003-W34,0,0,0,178,gender
RSウイルス感染症,2003,34,2003-W34,0,0,0,142,gender
咽頭結膜熱,2003,34,2003-W34,15,14,29,142,gender
Ａ群溶血性レンサ球菌咽頭炎,2003,34,2003-W34,19,18,37,142,gender
感染性胃腸炎,2003,34,2003-W34,92,90,182,142,gender
水痘,2003,34,2003-W34,49,32,81,142,gender
手足口病,2003,34,2003-W34,109,85,194,142,gender
突発性発しん,2003,34,2003-W34,39,28,67,142,gender
ヘルパンギーナ,2003,34,2003-W34,63,66,129,142,gender
流行性耳下腺炎,2003,34,2003-W34,8,7,15,142,gender
川崎病,2003,34,2003-W34,0,0,0,142,gender
インフルエンザ,2022,48,2022-W48,62,45,107,410,gender
RSウイルス感染症,2022,48,2022-W48,46,34,80,260,gender
咽頭結膜熱,2022,48,2022-W48,25,23,48,260,gender
Ａ群溶血性レンサ球菌咽頭炎,2022,48,2022-W48,34,20,54,260,gender
感染性胃腸炎,2022,48,2022-W48,908,838,1746,260,gender
水痘,2022,48,2022-W48,18,18,36,260,gender
手足口病,2022,48,2022-W48,31,34,65,260,gender
突発性発しん,2022,48,2022-W48,37,37,74,260,gender
ヘルパンギーナ,2022,48,2022-W48,4,4,8,260,gender
流行性耳下腺炎,2022,48,2022-W48,6,4,10,260,gender
川崎病,2022,48,2022-W48,1,1,2,260,gender
インフルエンザ,2019,5,2019-W05,9383,9543,18926,414,gender
RSウイルス感染症,2019,5,2019-W05,22,26,48,261,gender
咽頭結膜熱,2019,5,2019-W05,24,15,39,261,gender
Ａ群溶血性レンサ球菌咽頭炎,2019,5,2019-W05,319,271,590,261,gender
感染性胃腸炎,2019,5,2019-W05,1021,960,1981,261,gender
水痘,2019,5,2019-W05,44,42,86,261,gender
手足口病,2019,5,2019-W05,14,10,24,261,gender
突発性発しん,2019,5,2019-W05,40,40,80,261,gender
ヘルパンギーナ,2019,5,2019-W05,1,1,2,261,gender
流行性耳下腺炎,2019,5,2019-W05,9,10,19,261,gender
川崎病,2019,5,2019-W05,1,1,2,261,gender
インフルエンザ,2007,40,2007-W40,17,15,32,287,gender
RSウイルス感染症,2007,40,2007-W40,13,11,24,149,gender
咽頭結膜熱,2007,40,2007-W40,20,25,45,149,gender
Ａ群溶血性レンサ球菌咽頭炎,2007,40,2007-W40,82,72,154,149,gender
感染性胃腸炎,2007,40,2007-W40,317,248,565,149,gender
水痘,2007,40,2007-W40,26,19,45,149,gender
手足口病,2007,40,2007-W40,50,49,99,149,gender
突発性発しん,2007,40,2007-W40,58,57,115,149,gender
ヘルパンギーナ,2007,40,2007-W40,40,35,75,149,gender
流行性耳下腺炎,2007,40,2007-W40,23,8,31,149,gender
川崎病,2007,40,2007-W40,0,0,0,149,gender
インフルエンザ,2005,33,2005-W33,0,0,0,178,gender
RSウイルス感染症,2005,33,2005-W33,1,1,2,142,gender
咽頭結膜熱,2005,33,2005-W33,40,17,57,142,gender
Ａ群溶血性レンサ球菌咽頭炎,2005,33,2005-W33,12,13,25,142,gender
感染性胃腸炎,2005,33,2005-W33,111,82,193,142,gender
水痘,2005,33,2005-W33,9,20,29,142,gender
手足口病,2005,33,2005-W33,21,22,43,142,gender
突発性発しん,2005,33,2005-W33,22,30,52,142,gender
ヘルパンギーナ,2005,33,2005-W33,55,53,108,142,gender
流行性耳下腺炎,2005,33,2005-W33,65,52,117,142,gender
川崎病,2005,33,2005-W33,1,0,1,142,gender
インフルエンザ,2025,21,2025-W21,70,62,132,419,gender
新型コロナウイルス感染症（COVID-19）,2025,21,2025-W21,114,158,272,419,gender
RSウイルス感染症,2025,21,2025-W21,14,14,28,264,gender
咽頭結膜熱,2025,21,2025-W21,57,43,100,264,gender
Ａ群溶血性レンサ球菌咽頭炎,2025,21,2025-W21,556,439,995,264,gender
感染性胃腸炎,2025,21,2025-W21,1103,924,2027,264,gender
水痘,2025,21,2025-W21,107,91,198,264,gender
手足口病,2025,21,2025-W21,23,17,40,264,gender
突発性発しん,2025,21,2025-W21,49,46,95,264,gender
ヘルパンギーナ,2025,21,2025-W21,10,7,17,264,gender
流行性耳下腺炎,2025,21,2025-W21,11,12,23,264,gender
川崎病,2025,21,2025-W21,4,3,7,264,gender
インフルエンザ,2018,24,2018-W24,17,12,29,416,gender
RSウイルス感染症,2018,24,2018-W24,35,27,62,262,gender
咽頭結膜熱,2018,24,2018-W24,105,102,207,262,gender
Ａ群溶血性レンサ球菌咽頭炎,2018,24,2018-W24,506,370,876,262,gender
感染性胃腸炎,2018,24,2018-W24,912,830,1742,262,gender
水痘,2018,24,2018-W24,60,53,113,262,gender
手足口病,2018,24,2018-W24,45,45,90,262,gender
突発性発しん,2018,24,2018-W24,94,86,180,262,gender
ヘルパンギーナ,2018,24,2018-W24,59,59,118,262,gender
流行性耳下腺炎,2018,24,2018-W24,27,19,46,262,gender
川崎病,2018,24,2018-W24,2,3,5,262,gender
インフルエンザ,2014,24,2014-W24,9,5,14,413,gender
RSウイルス感染症,2014,24,2014-W24,8,8,16,264,gender
咽頭結膜熱,2014,24,2014-W24,142,95,237,264,gender
Ａ群溶血性レンサ球菌咽頭炎,2014,24,2014-W24,466,340,806,264,gender
感染性胃腸炎,2014,24,2014-W24,875,805,1680,264,gender
水痘,2014,24,2014-W24,149,130,279,264,gender
手足口病,2014,24,2014-W24,46,34,80,264,gender
突発性発しん,2014,24,2014-W24,121,116,237,264,gender
ヘルパンギーナ,2014,24,2014-W24,135,93,228,264,gender
流行性耳下腺炎,2014,24,2014-W24,34,38,72,264,gender
川崎病,2014,24,2014-W24,1,1,2,264,gender
インフルエンザ,2017,39,2017-W39,30,49,79,415,gender
RSウイルス感染症,2017,39,2017-W39,202,179,381,261,gender
咽頭結膜熱,2017,39,2017-W39,66,45,111,261,gender
Ａ群溶血性レンサ球菌咽頭炎,2017,39,2017-W39,228,191,419,261,gender
感染性胃腸炎,2017,39,2017-W39,467,389,856,261,gender
水痘,2017,39,2017-W39,41,20,61,261,gender
手足口病,2017,39,2017-W39,587,439,1026,261,gender
突発性発しん,2017,39,2017-W39,67,72,139,261,gender
ヘルパンギーナ,2017,39,2017-W39,132,136,268,261,gender
流行性耳下腺炎,2017,39,2017-W39,22,22,44,261,gender
川崎病,2017,39,2017-W39,2,1,3,261,gender
インフルエンザ,2006,10,2006-W10,339,363,702,178,gender
RSウイルス感染症,2006,10,2006-W10,2,0,2,142,gender
咽頭結膜熱,2006,10,2006-W10,31,20,51,142,gender
Ａ群溶血性レンサ球菌咽頭炎,2006,10,2006-W10,196,160,356,142,gender
感染性胃腸炎,2006,10,2006-W10,570,536,1106,142,gender
水痘,2006,10,2006-W10,114,97,211,142,gender
手足口病,2006,10,2006-W10,2,2,4,142,gender
突発性発しん,2006,10,2006-W10,40,35,75,142,gender
ヘルパンギーナ,2006,10,2006-W10,8,10,18,142,gender
流行性耳下腺炎,2006,10,2006-W10,62,49,111,142,gender
川崎病,2006,10,2006-W10,0,0,0,142,gender
インフルエンザ,2009,33,2009-W33,298,252,550,258,gender
RSウイルス感染症,2009,33,2009-W33,6,9,15,130,gender
咽頭結膜熱,2009,33,2009-W33,7,7,14,130,gender
Ａ群溶血性レンサ球菌咽頭炎,2009,33,2009-W33,28,22,50,130,gender
感染性胃腸炎,2009,33,2009-W33,113,105,218,130,gender
水痘,2009,33,2009-W33,23,21,44,130,gender
手足口病,2009,33,2009-W33,92,84,176,130,gender
突発性発しん,2009,33,2009-W33,42,36,78,130,gender
ヘルパンギーナ,2009,33,2009-W33,99,84,183,130,gender
流行性耳下腺炎,2009,33,2009-W33,37,43,80,130,gender
川崎病,2009,33,2009-W33,0,1,1,130,gender
インフルエンザ,2023,3,2023-W03,1895,1623,3518,414,gender
RSウイルス感染症,2023,3,2023-W03,6,10,16,261,gender
咽頭結膜熱,2023,3,2023-W03,11,8,19,261,gender
Ａ群溶血性レンサ球菌咽頭炎,2023,3,2023-W03,29,35,64,261,gender
感染性胃腸炎,2023,3,2023-W03,1499,1297,2796,261,gender
水痘,2023,3,2023-W03,10,12,22,261,gender
手足口病,2023,3,2023-W03,5,3,8,261,gender
突発性発しん,2023,3,2023-W03,29,31,60,261,gender
ヘルパンギーナ,2023,3,2023-W03,4,4,8,261,gender
流行性耳下腺炎,2023,3,2023-W03,3,3,6,261,gender
川崎病,2023,3,2023-W03,4,3,7,261,gender
インフルエンザ,2000,17,2000-W17,0,0,0,178,gender
RSウイルス感染症,2000,17,2000-W17,0,0,0,142,gender
咽頭結膜熱,2000,17,2000-W17,4,5,9,142,gender
Ａ群溶血性レンサ球菌咽頭炎,2000,17,2000-W17,67,35,102,142,gender
感染性胃腸炎,2000,17,2000-W17,359,355,714,142,gender
水痘,2000,17,2000-W17,76,91,167,142,gender
手足口病,2000,17,2000-W17,6,8,14,142,gender
突発性発しん,2000,17,2000-W17,36,30,66,142,gender
ヘルパンギーナ,2000,17,2000-W17,14,13,27,142,gender
流行性耳下腺炎,2000,17,2000-W17,40,29,69,142,gender
川崎病,2000,17,2000-W17,0,1,1,142,gender
インフルエンザ,2023,18,2023-W18,240,215,455,410,gender
RSウイルス感染症,2023,18,2023-W18,55,43,98,258,gender
咽頭結膜熱,2023,18,2023-W18,29,37,66,258,gender
Ａ群溶血性レンサ球菌咽頭炎,2023,18,2023-W18,96,75,171,258,gender
感染性胃腸炎,2023,18,2023-W18,555,472,1027,258,gender
水痘,2023,18,2023-W18,17,7,24,258,gender
手足口病,2023,18,2023-W18,23,10,33,258,gender
突発性発しん,2023,18,2023-W18,37,41,78,258,gender
ヘルパンギーナ,2023,18,2023-W18,21,22,43,258,gender
流行性耳下腺炎,2023,18,2023-W18,6,5,11,258,gender
川崎病,2023,18,2023-W18,2,1,3,258,gender
インフルエンザ,2010,50,2010-W50,232,219,451,288,gender
RSウイルス感染症,2010,50,2010-W50,65,60,125,149,gender
咽頭結膜熱,2010,50,2010-W50,65,55,120,149,gender
Ａ群溶血性レンサ球菌咽頭炎,2010,50,2010-W50,263,206,469,149,gender
感染性胃腸炎,2010,50,2010-W50,1508,1457,2965,149,gender
水痘,2010,50,2010-W50,163,136,299,149,gender
手足口病,2010,50,2010-W50,15,6,21,149,gender
突発性発しん,2010,50,2010-W50,33,44,77,149,gender
ヘルパンギーナ,2010,50,2010-W50,4,2,6,149,gender
流行性耳下腺炎,2010,50,2010-W50,34,30,64,149,gender
川崎病,2010,50,2010-W50,0,2,2,149,gender
インフルエンザ,2012,23,2012-W23,21,17,38,418,gender
RSウイルス感染症,2012,23,2012-W23,12,10,22,263,gender
咽頭結膜熱,2012,23,2012-W23,89,68,157,263,gender
Ａ群溶血性レンサ球菌咽頭炎,2012,23,2012-W23,434,369,803,263,gender
感染性胃腸炎,2012,23,2012-W23,1248,1075,2323,263,gender
水痘,2012,23,2012-W23,193,160,353,263,gender
手足口病,2012,23,2012-W23,49,41,90,263,gender
突発性発しん,2012,23,2012-W23,127,97,224,263,gender
ヘルパンギーナ,2012,23,2012-W23,53,47,100,263,gender
流行性耳下腺炎,2012,23,2012-W23,34,37,71,263,gender
川崎病,2012,23,2012-W23,1,1,2,263,gender
インフルエンザ,2023,17,2023-W17,314,316,630,413,gender
RSウイルス感染症,2023,17,2023-W17,48,39,87,261,gender
咽頭結膜熱,2023,17,2023-W17,43,40,83,261,gender
Ａ群溶血性レンサ球菌咽頭炎,2023,17,2023-W17,102,96,198,261,gender
感染性胃腸炎,2023,17,2023-W17,761,587,1348,261,gender
水痘,2023,17,2023-W17,19,10,29,261,gender
手足口病,2023,17,2023-W17,24,11,35,261,gender
突発性発しん,2023,17,2023-W17,43,56,99,261,gender
ヘルパンギーナ,2023,17,2023-W17,18,16,34,261,gender
流行性耳下腺炎,2023,17,2023-W17,4,2,6,261,gender
川崎病,2023,17,2023-W17,2,3,5,261,gender
インフルエンザ,2013,42,2013-W42,3,4,7,412,gender
RSウイルス感染症,2013,42,2013-W42,165,106,271,260,gender
咽頭結膜熱,2013,42,2013-W42,35,13,48,260,gender
Ａ群溶血性レンサ球菌咽頭炎,2013,42,2013-W42,108,87,195,260,gender
感染性胃腸炎,2013,42,2013-W42,424,391,815,260,gender
水痘,2013,42,2013-W42,68,72,140,260,gender
手足口病,2013,42,2013-W42,163,133,296,260,gender
突発性発しん,2013,42,2013-W42,71,75,146,260,gender
ヘルパンギーナ,2013,42,2013-W42,34,33,67,260,gender
流行性耳下腺炎,2013,42,2013-W42,23,23,46,260,gender
川崎病,2013,42,2013-W42,1,0,1,260,gender
インフルエンザ,2011,31,2011-W31,4,3,7,408,gender
RSウイルス感染症,2011,31,2011-W31,57,27,84,257,gender
咽頭結膜熱,2011,31,2011-W31,67,53,120,257,gender
Ａ群溶血性レンサ球菌咽頭炎,2011,31,2011-W31,102,97,199,257,gender
感染性胃腸炎,2011,31,2011-W31,422,343,765,257,gender
水痘,2011,31,2011-W31,77,53,130,257,gender
手足口病,2011,31,2011-W31,1592,1254,2846,257,gender
突発性発しん,2011,31,2011-W31,105,96,201,257,gender
ヘルパンギーナ,2011,31,2011-W31,951,821,1772,257,gender
流行性耳下腺炎,2011,31,2011-W31,57,58,115,257,gender
川崎病,2011,31,2011-W31,4,0,4,257,gender
インフルエンザ,2000,18,2000-W18,5,4,9,178,gender
RSウイルス感染症,2000,18,2000-W18,0,0,0,142,gender
咽頭結膜熱,2000,18,2000-W18,3,1,4,142,gender
Ａ群溶血性レンサ球菌咽頭炎,2000,18,2000-W18,27,33,60,142,gender
感染性胃腸炎,2000,18,2000-W18,271,243,514,142,gender
水痘,2000,18,2000-W18,102,68,170,142,gender
手足口病,2000,18,2000-W18,4,6,10,142,gender
突発性発しん,2000,18,2000-W18,17,35,52,142,gender
ヘルパンギーナ,2000,18,2000-W18,13,11,24,142,gender
流行性耳下腺炎,2000,18,2000-W18,24,20,44,142,gender
川崎病,2000,18,2000-W18,0,2,2,142,gender
インフルエンザ,2008,52,2008-W52,742,715,1457,282,gender
RSウイルス感染症,2008,52,2008-W52,23,17,40,148,gender
咽頭結膜熱,2008,52,2008-W52,22,15,37,148,gender
Ａ群溶血性レンサ球菌咽頭炎,2008,52,2008-W52,185,155,340,148,gender
感染性胃腸炎,2008,52,2008-W52,1062,1042,2104,148,gender
水痘,2008,52,2008-W52,148,141,289,148,gender
手足口病,2008,52,2008-W52,11,16,27,148,gender
突発性発しん,2008,52,2008-W52,34,31,65,148,gender
ヘルパンギーナ,2008,52,2008-W52,7,3,10,148,gender
流行性耳下腺炎,2008,52,2008-W52,50,47,97,148,gender
川崎病,2008,52,2008-W52,2,0,2,148,gender
インフルエンザ,2005,3,2005-W03,433,372,805,178,gender
RSウイルス感染症,2005,3,2005-W03,3,3,6,142,gender
咽頭結膜熱,2005,3,2005-W03,15,16,31,142,gender
Ａ群溶血性レンサ球菌咽頭炎,2005,3,2005-W03,63,63,126,142,gender
感染性胃腸炎,2005,3,2005-W03,704,711,1415,142,gender
水痘,2005,3,2005-W03,85,77,162,142,gender
手足口病,2005,3,2005-W03,11,8,19,142,gender
突発性発しん,2005,3,2005-W03,41,49,90,142,gender
ヘルパンギーナ,2005,3,2005-W03,0,2,2,142,gender
流行性耳下腺炎,2005,3,2005-W03,50,40,90,142,gender
川崎病,2005,3,2005-W03,0,0,0,142,gender
インフルエンザ,2015,45,2015-W45,28,49,77,408,gender
RSウイルス感染症,2015,45,2015-W45,198,154,352,259,gender
咽頭結膜熱,2015,45,2015-W45,43,29,72,259,gender
Ａ群溶血性レンサ球菌咽頭炎,2015,45,2015-W45,290,281,571,259,gender
感染性胃腸炎,2015,45,2015-W45,708,689,1397,259,gender
水痘,2015,45,2015-W45,63,60,123,259,gender
手足口病,2015,45,2015-W45,52,46,98,259,gender
突発性発しん,2015,45,2015-W45,66,52,118,259,gender
ヘルパンギーナ,2015,45,2015-W45,13,5,18,259,gender
流行性耳下腺炎,2015,45,2015-W45,82,72,154,259,gender
川崎病,2015,45,2015-W45,5,2,7,259,gender
インフルエンザ,2018,15,2018-W15,156,202,358,416,gender
RSウイルス感染症,2018,15,2018-W15,45,45,90,262,gender
咽頭結膜熱,2018,15,2018-W15,29,29,58,262,gender
Ａ群溶血性レンサ球菌咽頭炎,2018,15,2018-W15,340,280,620,262,gender
感染性胃腸炎,2018,15,2018-W15,712,657,1369,262,gender
水痘,2018,15,2018-W15,37,39,76,262,gender
手足口病,2018,15,2018-W15,8,8,16,262,gender
突発性発しん,2018,15,2018-W15,67,73,140,262,gender
ヘルパンギーナ,2018,15,2018-W15,3,2,5,262,gender
流行性耳下腺炎,2018,15,2018-W15,14,5,19,262,gender
川崎病,2018,15,2018-W15,9,3,12,262,gender
インフルエンザ,2025,10,2025-W10,422,350,772,419,gender
新型コロナウイルス感染症（COVID-19）,2025,10,2025-W10,529,644,1173,419,gender
RSウイルス感染症,2025,10,2025-W10,85,64,149,264,gender
咽頭結膜熱,2025,10,2025-W10,13,25,38,264,gender
Ａ群溶血性レンサ球菌咽頭炎,2025,10,2025-W10,380,283,663,264,gender
感染性胃腸炎,2025,10,2025-W10,1802,1555,3357,264,gender
水痘,2025,10,2025-W10,58,46,104,264,gender
手足口病,2025,10,2025-W10,2,2,4,264,gender
突発性発しん,2025,10,2025-W10,31,24,55,264,gender
ヘルパンギーナ,2025,10,2025-W10,1,2,3,264,gender
流行性耳下腺炎,2025,10,2025-W10,12,7,19,264,gender
川崎病,2025,10,2025-W10,4,0,4,264,gender
インフルエンザ,2017,36,2017-W36,35,36,71,414,gender
RSウイルス感染症,2017,36,2017-W36,410,376,786,259,gender
咽頭結膜熱,2017,36,2017-W36,59,55,114,259,gender
Ａ群溶血性レンサ球菌咽頭炎,2017,36,2017-W36,196,163,359,259,gender
感染性胃腸炎,2017,36,2017-W36,491,416,907,259,gender
水痘,2017,36,2017-W36,27,24,51,259,gender
手足口病,2017,36,2017-W36,851,709,1560,259,gender
突発性発しん,2017,36,2017-W36,77,78,155,259,gender
ヘルパンギーナ,2017,36,2017-W36,171,169,340,259,gender
流行性耳下腺炎,2017,36,2017-W36,34,22,56,259,gender
川崎病,2017,36,2017-W36,5,1,6,259,gender
インフルエンザ,2014,15,2014-W15,644,621,1265,416,gender
RSウイルス感染症,2014,15,2014-W15,16,11,27,262,gender
咽頭結膜熱,2014,15,2014-W15,25,20,45,262,gender
Ａ群溶血性レンサ球菌咽頭炎,2014,15,2014-W15,287,214,501,262,gender
感染性胃腸炎,2014,15,2014-W15,671,624,1295,262,gender
水痘,2014,15,2014-W15,92,72,164,262,gender
手足口病,2014,15,2014-W15,8,12,20,262,gender
突発性発しん,2014,15,2014-W15,79,78,157,262,gender
ヘルパンギーナ,2014,15,2014-W15,3,4,7,262,gender
流行性耳下腺炎,2014,15,2014-W15,28,14,42,262,gender
川崎病,2014,15,2014-W15,4,0,4,262,gender
インフルエンザ,2019,45,2019-W45,234,226,460,415,gender
RSウイルス感染症,2019,45,2019-W45,38,32,70,260,gender
咽頭結膜熱,2019,45,2019-W45,44,35,79,260,gender
Ａ群溶血性レンサ球菌咽頭炎,2019,45,2019-W45,256,233,489,260,gender
感染性胃腸炎,2019,45,2019-W45,559,427,986,260,gender
水痘,2019,45,2019-W45,34,38,72,260,gender
手足口病,2019,45,2019-W45,281,210,491,260,gender
突発性発しん,2019,45,2019-W45,42,53,95,260,gender
ヘルパンギーナ,2019,45,2019-W45,24,27,51,260,gender
流行性耳下腺炎,2019,45,2019-W45,5,7,12,260,gender
川崎病,2019,45,2019-W45,2,3,5,260,gender
インフルエンザ,2024,40,2024-W40,163,172,335,419,gender
新型コロナウイルス感染症（COVID-19）,2024,40,2024-W40,452,573,1025,419,gender
RSウイルス感染症,2024,40,2024-W40,27,23,50,264,gender
咽頭結膜熱,2024,40,2024-W40,28,13,41,264,gender
Ａ群溶血性レンサ球菌咽頭炎,2024,40,2024-W40,221,181,402,264,gender
感染性胃腸炎,2024,40,2024-W40,392,338,730,264,gender
水痘,2024,40,2024-W40,26,9,35,264,gender
手足口病,2024,40,2024-W40,1420,1235,2655,264,gender
突発性発しん,2024,40,2024-W40,39,37,76,264,gender
ヘルパンギーナ,2024,40,2024-W40,50,44,94,264,gender
流行性耳下腺炎,2024,40,2024-W40,4,8,12,264,gender
川崎病,2024,40,2024-W40,2,2,4,264,gender
インフルエンザ,2004,52,2004-W52,62,70,132,178,gender
RSウイルス感染症,2004,52,2004-W52,17,6,23,142,gender
咽頭結膜熱,2004,52,2004-W52,11,24,35,142,gender
Ａ群溶血性レンサ球菌咽頭炎,2004,52,2004-W52,70,51,121,142,gender
感染性胃腸炎,2004,52,2004-W52,1311,1267,2578,142,gender
水痘,2004,52,2004-W52,127,110,237,142,gender
手足口病,2004,52,2004-W52,45,33,78,142,gender
突発性発しん,2004,52,2004-W52,31,37,68,142,gender
ヘルパンギーナ,2004,52,2004-W52,6,1,7,142,gender
流行性耳下腺炎,2004,52,2004-W52,75,56,131,142,gender
川崎病,2004,52,2004-W52,3,1,4,142,gender
インフルエンザ,2006,21,2006-W21,8,3,11,178,gender
RSウイルス感染症,2006,21,2006-W21,6,2,8,142,gender
咽頭結膜熱,2006,21,2006-W21,91,73,164,142,gender
Ａ群溶血性レンサ球菌咽頭炎,2006,21,2006-W21,210,150,360,142,gender
感染性胃腸炎,2006,21,2006-W21,361,340,701,142,gender
水痘,2006,21,2006-W21,152,155,307,142,gender
手足口病,2006,21,2006-W21,26,11,37,142,gender
突発性発しん,2006,21,2006-W21,50,44,94,142,gender
ヘルパンギーナ,2006,21,2006-W21,120,103,223,142,gender
流行性耳下腺炎,2006,21,2006-W21,42,62,104,142,gender
川崎病,2006,21,2006-W21,2,2,4,142,gender
インフルエンザ,2023,29,2023-W29,244,169,413,417,gender
新型コロナウイルス感染症（COVID-19）,2023,29,2023-W29,1854,2044,3898,417,gender
RSウイルス感染症,2023,29,2023-W29,224,173,397,262,gender
咽頭結膜熱,2023,29,2023-W29,57,45,102,262,gender
Ａ群溶血性レンサ球菌咽頭炎,2023,29,2023-W29,151,135,286,262,gender
感染性胃腸炎,2023,29,2023-W29,474,398,872,262,gender
水痘,2023,29,2023-W29,19,20,39,262,gender
手足口病,2023,29,2023-W29,80,71,151,262,gender
突発性発しん,2023,29,2023-W29,25,30,55,262,gender
ヘルパンギーナ,2023,29,2023-W29,508,463,971,262,gender
流行性耳下腺炎,2023,29,2023-W29,7,9,16,262,gender
川崎病,2023,29,2023-W29,2,0,2,262,gender
インフルエンザ,2012,4,2012-W04,7046,6427,13473,418,gender
RSウイルス感染症,2012,4,2012-W04,49,38,87,263,gender
咽頭結膜熱,2012,4,2012-W04,33,21,54,263,gender
Ａ群溶血性レンサ球菌咽頭炎,2012,4,2012-W04,320,292,612,263,gender
感染性胃腸炎,2012,4,2012-W04,1360,1183,2543,263,gender
水痘,2012,4,2012-W04,201,176,377,263,gender
手足口病,2012,4,2012-W04,4,10,14,263,gender
突発性発しん,2012,4,2012-W04,60,66,126,263,gender
ヘルパンギーナ,2012,4,2012-W04,3,3,6,263,gender
流行性耳下腺炎,2012,4,2012-W04,26,24,50,263,gender
川崎病,2012,4,2012-W04,7,0,7,263,gender
インフルエンザ,2017,8,2017-W08,3209,3307,6516,416,gender
RSウイルス感染症,2017,8,2017-W08,16,10,26,262,gender
咽頭結膜熱,2017,8,2017-W08,25,22,47,262,gender
Ａ群溶血性レンサ球菌咽頭炎,2017,8,2017-W08,270,249,519,262,gender
感染性胃腸炎,2017,8,2017-W08,907,837,1744,262,gender
水痘,2017,8,2017-W08,62,53,115,262,gender
手足口病,2017,8,2017-W08,8,11,19,262,gender
突発性発しん,2017,8,2017-W08,60,61,121,262,gender
ヘルパンギーナ,2017,8,2017-W08,2,1,3,262,gender
流行性耳下腺炎,2017,8,2017-W08,35,23,58,262,gender
川崎病,2017,8,2017-W08,1,0,1,262,gender
インフルエンザ,2000,26,2000-W26,0,0,0,178,gender
RSウイルス感染症,2000,26,2000-W26,0,0,0,142,gender
咽頭結膜熱,2000,26,2000-W26,10,3,13,142,gender
Ａ群溶血性レンサ球菌咽頭炎,2000,26,2000-W26,49,41,90,142,gender
感染性胃腸炎,2000,26,2000-W26,171,178,349,142,gender
水痘,2000,26,2000-W26,84,90,174,142,gender
手足口病,2000,26,2000-W26,168,128,296,142,gender
突発性発しん,2000,26,2000-W26,39,49,88,142,gender
ヘルパンギーナ,2000,26,2000-W26,352,253,605,142,gender
流行性耳下腺炎,2000,26,2000-W26,57,59,116,142,gender
川崎病,2000,26,2000-W26,1,1,2,142,gender
インフルエンザ,2022,47,2022-W47,39,33,72,411,gender
RSウイルス感染症,2022,47,2022-W47,50,39,89,261,gender
咽頭結膜熱,2022,47,2022-W47,13,11,24,261,gender
Ａ群溶血性レンサ球菌咽頭炎,2022,47,2022-W47,43,24,67,261,gender
感染性胃腸炎,2022,47,2022-W47,777,654,1431,261,gender
水痘,2022,47,2022-W47,14,21,35,261,gender
手足口病,2022,47,2022-W47,46,44,90,261,gender
突発性発しん,2022,47,2022-W47,38,36,74,261,gender
ヘルパンギーナ,2022,47,2022-W47,11,9,20,261,gender
流行性耳下腺炎,2022,47,2022-W47,8,5,13,261,gender
川崎病,2022,47,2022-W47,2,1,3,261,gender
インフルエンザ,2012,12,2012-W12,2446,2506,4952,417,gender
RSウイルス感染症,2012,12,2012-W12,18,13,31,263,gender
咽頭結膜熱,2012,12,2012-W12,29,30,59,263,gender
Ａ群溶血性レンサ球菌咽頭炎,2012,12,2012-W12,207,179,386,263,gender
感染性胃腸炎,2012,12,2012-W12,1075,945,2020,263,gender
水痘,2012,12,2012-W12,168,183,351,263,gender
手足口病,2012,12,2012-W12,2,7,9,263,gender
突発性発しん,2012,12,2012-W12,57,48,105,263,gender
ヘルパンギーナ,2012,12,2012-W12,2,1,3,263,gender
流行性耳下腺炎,2012,12,2012-W12,22,22,44,263,gender
川崎病,2012,12,2012-W12,1,2,3,263,gender
インフルエンザ,2001,48,2001-W48,5,6,11,178,gender
RSウイルス感染症,2001,48,2001-W48,0,0,0,142,gender
咽頭結膜熱,2001,48,2001-W48,4,5,9,142,gender
Ａ群溶血性レンサ球菌咽頭炎,2001,48,2001-W48,53,42,95,142,gender
感染性胃腸炎,2001,48,2001-W48,603,573,1176,142,gender
水痘,2001,48,2001-W48,69,82,151,142,gender
手足口病,2001,48,2001-W48,17,12,29,142,gender
突発性発しん,2001,48,2001-W48,42,37,79,142,gender
ヘルパンギーナ,2001,48,2001-W48,5,5,10,142,gender
流行性耳下腺炎,2001,48,2001-W48,81,72,153,142,gender
川崎病,2001,48,2001-W48,0,2,2,142,gender
インフルエンザ,2020,34,2020-W34,0,0,0,407,gender
RSウイルス感染症,2020,34,2020-W34,0,0,0,255,gender
咽頭結膜熱,2020,34,2020-W34,11,6,17,255,gender
Ａ群溶血性レンサ球菌咽頭炎,2020,34,2020-W34,43,42,85,255,gender
感染性胃腸炎,2020,34,2020-W34,249,242,491,255,gender
水痘,2020,34,2020-W34,16,10,26,255,gender
手足口病,2020,34,2020-W34,20,21,41,255,gender
突発性発しん,2020,34,2020-W34,85,64,149,255,gender
ヘルパンギーナ,2020,34,2020-W34,10,11,21,255,gender
流行性耳下腺炎,2020,34,2020-W34,7,7,14,255,gender
川崎病,2020,34,2020-W34,0,0,0,255,gender
インフルエンザ,2015,34,2015-W34,3,1,4,387,gender
RSウイルス感染症,2015,34,2015-W34,34,34,68,243,gender
咽頭結膜熱,2015,34,2015-W34,72,48,120,243,gender
Ａ群溶血性レンサ球菌咽頭炎,2015,34,2015-W34,118,118,236,243,gender
感染性胃腸炎,2015,34,2015-W34,402,386,788,243,gender
水痘,2015,34,2015-W34,34,21,55,243,gender
手足口病,2015,34,2015-W34,652,608,1260,243,gender
突発性発しん,2015,34,2015-W34,54,69,123,243,gender
ヘルパンギーナ,2015,34,2015-W34,134,148,282,243,gender
流行性耳下腺炎,2015,34,2015-W34,49,41,90,243,gender
川崎病,2015,34,2015-W34,1,1,2,243,gender
インフルエンザ,2006,2,2006-W02,585,604,1189,178,gender
RSウイルス感染症,2006,2,2006-W02,17,10,27,142,gender
咽頭結膜熱,2006,2,2006-W02,13,18,31,142,gender
Ａ群溶血性レンサ球菌咽頭炎,2006,2,2006-W02,74,92,166,142,gender
感染性胃腸炎,2006,2,2006-W02,562,597,1159,142,gender
水痘,2006,2,2006-W02,99,92,191,142,gender
手足口病,2006,2,2006-W02,3,3,6,142,gender
突発性発しん,2006,2,2006-W02,36,30,66,142,gender
ヘルパンギーナ,2006,2,2006-W02,0,0,0,142,gender
流行性耳下腺炎,2006,2,2006-W02,65,76,141,142,gender
川崎病,2006,2,2006-W02,3,1,4,142,gender
インフルエンザ,2017,47,2017-W47,408,367,775,417,gender
RSウイルス感染症,2017,47,2017-W47,34,35,69,262,gender
咽頭結膜熱,2017,47,2017-W47,93,83,176,262,gender
Ａ群溶血性レンサ球菌咽頭炎,2017,47,2017-W47,430,401,831,262,gender
感染性胃腸炎,2017,47,2017-W47,1120,943,2063,262,gender
水痘,2017,47,2017-W47,86,90,176,262,gender
手足口病,2017,47,2017-W47,158,143,301,262,gender
突発性発しん,2017,47,2017-W47,67,62,129,262,gender
ヘルパンギーナ,2017,47,2017-W47,16,22,38,262,gender
流行性耳下腺炎,2017,47,2017-W47,27,9,36,262,gender
川崎病,2017,47,2017-W47,5,2,7,262,gender
インフルエンザ,2025,1,2025-W01,2230,2244,4474,320,gender
新型コロナウイルス感染症（COVID-19）,2025,1,2025-W01,206,222,428,320,gender
RSウイルス感染症,2025,1,2025-W01,13,4,17,203,gender
咽頭結膜熱,2025,1,2025-W01,7,5,12,203,gender
Ａ群溶血性レンサ球菌咽頭炎,2025,1,2025-W01,49,40,89,203,gender
感染性胃腸炎,2025,1,2025-W01,100,74,174,203,gender
水痘,2025,1,2025-W01,23,9,32,203,gender
手足口病,2025,1,2025-W01,4,7,11,203,gender
突発性発しん,2025,1,2025-W01,5,4,9,203,gender
ヘルパンギーナ,2025,1,2025-W01,0,0,0,203,gender
流行性耳下腺炎,2025,1,2025-W01,2,0,2,203,gender
川崎病,2025,1,2025-W01,3,3,6,203,gender
インフルエンザ,2008,23,2008-W23,15,18,33,287,gender
RSウイルス感染症,2008,23,2008-W23,1,1,2,148,gender
咽頭結膜熱,2008,23,2008-W23,47,30,77,148,gender
Ａ群溶血性レンサ球菌咽頭炎,2008,23,2008-W23,277,217,494,148,gender
感染性胃腸炎,2008,23,2008-W23,539,453,992,148,gender
水痘,2008,23,2008-W23,127,111,238,148,gender
手足口病,2008,23,2008-W23,28,25,53,148,gender
突発性発しん,2008,23,2008-W23,61,53,114,148,gender
ヘルパンギーナ,2008,23,2008-W23,62,38,100,148,gender
流行性耳下腺炎,2008,23,2008-W23,55,39,94,148,gender
川崎病,2008,23,2008-W23,2,2,4,148,gender
インフルエンザ,2016,29,2016-W29,2,2,4,413,gender
RSウイルス感染症,2016,29,2016-W29,19,23,42,262,gender
咽頭結膜熱,2016,29,2016-W29,60,41,101,262,gender
Ａ群溶血性レンサ球菌咽頭炎,2016,29,2016-W29,286,254,540,262,gender
感染性胃腸炎,2016,29,2016-W29,569,476,1045,262,gender
水痘,2016,29,2016-W29,60,45,105,262,gender
手足口病,2016,29,2016-W29,127,103,230,262,gender
突発性発しん,2016,29,2016-W29,73,59,132,262,gender
ヘルパンギーナ,2016,29,2016-W29,681,624,1305,262,gender
流行性耳下腺炎,2016,29,2016-W29,110,106,216,262,gender
川崎病,2016,29,2016-W29,5,2,7,262,gender
インフルエンザ,2013,33,2013-W33,1,1,2,341,gender
RSウイルス感染症,2013,33,2013-W33,48,41,89,202,gender
咽頭結膜熱,2013,33,2013-W33,55,38,93,202,gender
Ａ群溶血性レンサ球菌咽頭炎,2013,33,2013-W33,86,55,141,202,gender
感染性胃腸炎,2013,33,2013-W33,200,146,346,202,gender
水痘,2013,33,2013-W33,48,58,106,202,gender
手足口病,2013,33,2013-W33,696,577,1273,202,gender
突発性発しん,2013,33,2013-W33,42,40,82,202,gender
ヘルパンギーナ,2013,33,2013-W33,142,139,281,202,gender
流行性耳下腺炎,2013,33,2013-W33,13,10,23,202,gender
川崎病,2013,33,2013-W33,0,1,1,202,gender
インフルエンザ,2011,40,2011-W40,4,3,7,409,gender
RSウイルス感染症,2011,40,2011-W40,75,69,144,258,gender
咽頭結膜熱,2011,40,2011-W40,14,17,31,258,gender
Ａ群溶血性レンサ球菌咽頭炎,2011,40,2011-W40,130,127,257,258,gender
感染性胃腸炎,2011,40,2011-W40,502,378,880,258,gender
水痘,2011,40,2011-W40,64,71,135,258,gender
手足口病,2011,40,2011-W40,228,188,416,258,gender
突発性発しん,2011,40,2011-W40,76,80,156,258,gender
ヘルパンギーナ,2011,40,2011-W40,63,70,133,258,gender
流行性耳下腺炎,2011,40,2011-W40,33,28,61,258,gender
川崎病,2011,40,2011-W40,3,1,4,258,gender
インフルエンザ,2021,15,2021-W15,0,0,0,413,gender
RSウイルス感染症,2021,15,2021-W15,42,34,76,260,gender
咽頭結膜熱,2021,15,2021-W15,8,7,15,260,gender
Ａ群溶血性レンサ球菌咽頭炎,2021,15,2021-W15,48,35,83,260,gender
感染性胃腸炎,2021,15,2021-W15,429,397,826,260,gender
水痘,2021,15,2021-W15,9,4,13,260,gender
手足口病,2021,15,2021-W15,0,0,0,260,gender
突発性発しん,2021,15,2021-W15,72,49,121,260,gender
ヘルパンギーナ,2021,15,2021-W15,2,0,2,260,gender
流行性耳下腺炎,2021,15,2021-W15,11,2,13,260,gender
川崎病,2021,15,2021-W15,3,3,6,260,gender
インフルエンザ,2022,36,2022-W36,4,3,7,411,gender
RSウイルス感染症,2022,36,2022-W36,275,241,516,259,gender
咽頭結膜熱,2022,36,2022-W36,3,3,6,259,gender
Ａ群溶血性レンサ球菌咽頭炎,2022,36,2022-W36,19,5,24,259,gender
感染性胃腸炎,2022,36,2022-W36,338,279,617,259,gender
水痘,2022,36,2022-W36,6,7,13,259,gender
手足口病,2022,36,2022-W36,753,623,1376,259,gender
突発性発しん,2022,36,2022-W36,26,30,56,259,gender
ヘルパンギーナ,2022,36,2022-W36,167,162,329,259,gender
流行性耳下腺炎,2022,36,2022-W36,3,3,6,259,gender
川崎病,2022,36,2022-W36,0,0,0,259,gender
インフルエンザ,2010,10,2010-W10,46,49,95,287,gender
RSウイルス感染症,2010,10,2010-W10,44,22,66,149,gender
咽頭結膜熱,2010,10,2010-W10,9,13,22,149,gender
Ａ群溶血性レンサ球菌咽頭炎,2010,10,2010-W10,145,102,247,149,gender
感染性胃腸炎,2010,10,2010-W10,881,809,1690,149,gender
水痘,2010,10,2010-W10,119,106,225,149,gender
手足口病,2010,10,2010-W10,15,7,22,149,gender
突発性発しん,2010,10,2010-W10,52,38,90,149,gender
ヘルパンギーナ,2010,10,2010-W10,2,6,8,149,gender
流行性耳下腺炎,2010,10,2010-W10,52,53,105,149,gender
川崎病,2010,10,2010-W10,3,1,4,149,gender
インフルエンザ,2014,9,2014-W09,6155,5818,11973,416,gender
RSウイルス感染症,2014,9,2014-W09,12,14,26,261,gender
咽頭結膜熱,2014,9,2014-W09,28,19,47,261,gender
Ａ群溶血性レンサ球菌咽頭炎,2014,9,2014-W09,340,291,631,261,gender
感染性胃腸炎,2014,9,2014-W09,812,719,1531,261,gender
水痘,2014,9,2014-W09,121,83,204,261,gender
手足口病,2014,9,2014-W09,4,8,12,261,gender
突発性発しん,2014,9,2014-W09,55,48,103,261,gender
ヘルパンギーナ,2014,9,2014-W09,0,0,0,261,gender
流行性耳下腺炎,2014,9,2014-W09,8,12,20,261,gender
川崎病,2014,9,2014-W09,3,2,5,261,gender
インフルエンザ,2001,39,2001-W39,2,1,3,178,gender
RSウイルス感染症,2001,39,2001-W39,0,0,0,142,gender
咽頭結膜熱,2001,39,2001-W39,5,2,7,142,gender
Ａ群溶血性レンサ球菌咽頭炎,2001,39,2001-W39,12,4,16,142,gender
感染性胃腸炎,2001,39,2001-W39,119,107,226,142,gender
水痘,2001,39,2001-W39,22,17,39,142,gender
手足口病,2001,39,2001-W39,28,17,45,142,gender
突発性発しん,2001,39,2001-W39,38,35,73,142,gender
ヘルパンギーナ,2001,39,2001-W39,13,9,22,142,gender
流行性耳下腺炎,2001,39,2001-W39,44,48,92,142,gender
川崎病,2001,39,2001-W39,1,1,2,142,gender
インフルエンザ,2020,45,2020-W45,1,3,4,410,gender
RSウイルス感染症,2020,45,2020-W45,0,0,0,258,gender
咽頭結膜熱,2020,45,2020-W45,13,7,20,258,gender
Ａ群溶血性レンサ球菌咽頭炎,2020,45,2020-W45,59,49,108,258,gender
感染性胃腸炎,2020,45,2020-W45,317,273,590,258,gender
水痘,2020,45,2020-W45,28,19,47,258,gender
手足口病,2020,45,2020-W45,3,4,7,258,gender
突発性発しん,2020,45,2020-W45,64,52,116,258,gender
ヘルパンギーナ,2020,45,2020-W45,2,8,10,258,gender
流行性耳下腺炎,2020,45,2020-W45,10,4,14,258,gender
川崎病,2020,45,2020-W45,1,2,3,258,gender
インフルエンザ,2011,5,2011-W05,6059,5840,11899,419,gender
RSウイルス感染症,2011,5,2011-W05,52,23,75,264,gender
咽頭結膜熱,2011,5,2011-W05,40,33,73,264,gender
Ａ群溶血性レンサ球菌咽頭炎,2011,5,2011-W05,356,289,645,264,gender
感染性胃腸炎,2011,5,2011-W05,1462,1305,2767,264,gender
水痘,2011,5,2011-W05,159,153,312,264,gender
手足口病,2011,5,2011-W05,18,6,24,264,gender
突発性発しん,2011,5,2011-W05,59,67,126,264,gender
ヘルパンギーナ,2011,5,2011-W05,1,1,2,264,gender
流行性耳下腺炎,2011,5,2011-W05,44,34,78,264,gender
川崎病,2011,5,2011-W05,2,0,2,264,gender
インフルエンザ,2002,24,2002-W24,0,0,0,178,gender
RSウイルス感染症,2002,24,2002-W24,0,0,0,142,gender
咽頭結膜熱,2002,24,2002-W24,10,4,14,142,gender
Ａ群溶血性レンサ球菌咽頭炎,2002,24,2002-W24,68,61,129,142,gender
感染性胃腸炎,2002,24,2002-W24,224,190,414,142,gender
水痘,2002,24,2002-W24,123,106,229,142,gender
手足口病,2002,24,2002-W24,68,50,118,142,gender
突発性発しん,2002,24,2002-W24,52,20,72,142,gender
ヘルパンギーナ,2002,24,2002-W24,128,108,236,142,gender
流行性耳下腺炎,2002,24,2002-W24,52,42,94,142,gender
川崎病,2002,24,2002-W24,0,0,0,142,gender
インフルエンザ,2004,23,2004-W23,0,0,0,178,gender
RSウイルス感染症,2004,23,2004-W23,5,2,7,142,gender
咽頭結膜熱,2004,23,2004-W23,39,32,71,142,gender
Ａ群溶血性レンサ球菌咽頭炎,2004,23,2004-W23,96,91,187,142,gender
感染性胃腸炎,2004,23,2004-W23,262,254,516,142,gender
水痘,2004,23,2004-W23,87,89,176,142,gender
手足口病,2004,23,2004-W23,13,12,25,142,gender
突発性発しん,2004,23,2004-W23,48,43,91,142,gender
ヘルパンギーナ,2004,23,2004-W23,75,70,145,142,gender
流行性耳下腺炎,2004,23,2004-W23,38,29,67,142,gender
川崎病,2004,23,2004-W23,0,2,2,142,gender
インフルエンザ,2006,50,2006-W50,2,0,2,178,gender
RSウイルス感染症,2006,50,2006-W50,64,43,107,142,gender
咽頭結膜熱,2006,50,2006-W50,32,22,54,142,gender
Ａ群溶血性レンサ球菌咽頭炎,2006,50,2006-W50,138,142,280,142,gender
感染性胃腸炎,2006,50,2006-W50,1856,1913,3769,142,gender
水痘,2006,50,2006-W50,147,141,288,142,gender
手足口病,2006,50,2006-W50,23,24,47,142,gender
突発性発しん,2006,50,2006-W50,34,25,59,142,gender
ヘルパンギーナ,2006,50,2006-W50,3,2,5,142,gender
流行性耳下腺炎,2006,50,2006-W50,32,24,56,142,gender
川崎病,2006,50,2006-W50,3,1,4,142,gender
インフルエンザ,2019,34,2019-W34,27,24,51,396,gender
RSウイルス感染症,2019,34,2019-W34,220,220,440,249,gender
咽頭結膜熱,2019,34,2019-W34,36,27,63,249,gender
Ａ群溶血性レンサ球菌咽頭炎,2019,34,2019-W34,153,115,268,249,gender
感染性胃腸炎,2019,34,2019-W34,454,381,835,249,gender
水痘,2019,34,2019-W34,34,29,63,249,gender
手足口病,2019,34,2019-W34,374,329,703,249,gender
突発性発しん,2019,34,2019-W34,63,52,115,249,gender
ヘルパンギーナ,2019,34,2019-W34,212,158,370,249,gender
流行性耳下腺炎,2019,34,2019-W34,15,10,25,249,gender
川崎病,2019,34,2019-W34,1,2,3,249,gender
インフルエンザ,2024,31,2024-W31,49,53,102,418,gender
新型コロナウイルス感染症（COVID-19）,2024,31,2024-W31,1381,1650,3031,418,gender
RSウイルス感染症,2024,31,2024-W31,58,46,104,263,gender
咽頭結膜熱,2024,31,2024-W31,25,23,48,263,gender
Ａ群溶血性レンサ球菌咽頭炎,2024,31,2024-W31,238,175,413,263,gender
感染性胃腸炎,2024,31,2024-W31,397,340,737,263,gender
水痘,2024,31,2024-W31,18,12,30,263,gender
手足口病,2024,31,2024-W31,1466,1324,2790,263,gender
突発性発しん,2024,31,2024-W31,40,39,79,263,gender
ヘルパンギーナ,2024,31,2024-W31,252,224,476,263,gender
流行性耳下腺炎,2024,31,2024-W31,5,2,7,263,gender
川崎病,2024,31,2024-W31,4,2,6,263,gender
インフルエンザ,2016,17,2016-W17,299,282,581,409,gender
RSウイルス感染症,2016,17,2016-W17,9,14,23,256,gender
咽頭結膜熱,2016,17,2016-W17,77,41,118,256,gender
Ａ群溶血性レンサ球菌咽頭炎,2016,17,2016-W17,395,323,718,256,gender
感染性胃腸炎,2016,17,2016-W17,740,663,1403,256,gender
水痘,2016,17,2016-W17,49,38,87,256,gender
手足口病,2016,17,2016-W17,4,7,11,256,gender
突発性発しん,2016,17,2016-W17,87,71,158,256,gender
ヘルパンギーナ,2016,17,2016-W17,2,3,5,256,gender
流行性耳下腺炎,2016,17,2016-W17,70,53,123,256,gender
川崎病,2016,17,2016-W17,1,4,5,256,gender
インフルエンザ,2001,14,2001-W14,121,125,246,178,gender
RSウイルス感染症,2001,14,2001-W14,0,0,0,142,gender
咽頭結膜熱,2001,14,2001-W14,2,0,2,142,gender
Ａ群溶血性レンサ球菌咽頭炎,2001,14,2001-W14,16,26,42,142,gender
感染性胃腸炎,2001,14,2001-W14,233,224,457,142,gender
水痘,2001,14,2001-W14,91,96,187,142,gender
手足口病,2001,14,2001-W14,3,3,6,142,gender
突発性発しん,2001,14,2001-W14,36,31,67,142,gender
ヘルパンギーナ,2001,14,2001-W14,1,3,4,142,gender
流行性耳下腺炎,2001,14,2001-W14,80,70,150,142,gender
川崎病,2001,14,2001-W14,0,2,2,142,gender
インフルエンザ,2013,20,2013-W20,165,143,308,416,gender
RSウイルス感染症,2013,20,2013-W20,9,8,17,261,gender
咽頭結膜熱,2013,20,2013-W20,87,59,146,261,gender
Ａ群溶血性レンサ球菌咽頭炎,2013,20,2013-W20,462,390,852,261,gender
感染性胃腸炎,2013,20,2013-W20,1145,989,2134,261,gender
水痘,2013,20,2013-W20,135,112,247,261,gender
手足口病,2013,20,2013-W20,42,44,86,261,gender
突発性発しん,2013,20,2013-W20,88,92,180,261,gender
ヘルパンギーナ,2013,20,2013-W20,18,15,33,261,gender
流行性耳下腺炎,2013,20,2013-W20,35,22,57,261,gender
川崎病,2013,20,2013-W20,4,2,6,261,gender
インフルエンザ,2010,3,2010-W03,970,938,1908,289,gender
RSウイルス感染症,2010,3,2010-W03,50,39,89,149,gender
咽頭結膜熱,2010,3,2010-W03,3,2,5,149,gender
Ａ群溶血性レンサ球菌咽頭炎,2010,3,2010-W03,126,81,207,149,gender
感染性胃腸炎,2010,3,2010-W03,1261,1255,2516,149,gender
水痘,2010,3,2010-W03,82,76,158,149,gender
手足口病,2010,3,2010-W03,11,8,19,149,gender
突発性発しん,2010,3,2010-W03,53,45,98,149,gender
ヘルパンギーナ,2010,3,2010-W03,0,1,1,149,gender
流行性耳下腺炎,2010,3,2010-W03,35,39,74,149,gender
川崎病,2010,3,2010-W03,2,1,3,149,gender
インフルエンザ,2015,27,2015-W27,5,5,10,412,gender
RSウイルス感染症,2015,27,2015-W27,6,4,10,262,gender
咽頭結膜熱,2015,27,2015-W27,106,77,183,262,gender
Ａ群溶血性レンサ球菌咽頭炎,2015,27,2015-W27,468,365,833,262,gender
感染性胃腸炎,2015,27,2015-W27,814,697,1511,262,gender
水痘,2015,27,2015-W27,67,46,113,262,gender
手足口病,2015,27,2015-W27,840,701,1541,262,gender
突発性発しん,2015,27,2015-W27,91,94,185,262,gender
ヘルパンギーナ,2015,27,2015-W27,192,137,329,262,gender
流行性耳下腺炎,2015,27,2015-W27,54,36,90,262,gender
川崎病,2015,27,2015-W27,0,0,0,262,gender
インフルエンザ,2007,13,2007-W13,1911,1961,3872,281,gender
RSウイルス感染症,2007,13,2007-W13,3,1,4,142,gender
咽頭結膜熱,2007,13,2007-W13,11,13,24,142,gender
Ａ群溶血性レンサ球菌咽頭炎,2007,13,2007-W13,90,81,171,142,gender
感染性胃腸炎,2007,13,2007-W13,400,379,779,142,gender
水痘,2007,13,2007-W13,106,83,189,142,gender
手足口病,2007,13,2007-W13,3,6,9,142,gender
突発性発しん,2007,13,2007-W13,39,33,72,142,gender
ヘルパンギーナ,2007,13,2007-W13,2,3,5,142,gender
流行性耳下腺炎,2007,13,2007-W13,19,20,39,142,gender
川崎病,2007,13,2007-W13,1,0,1,142,gender
インフルエンザ,2008,30,2008-W30,2,2,4,285,gender
RSウイルス感染症,2008,30,2008-W30,1,0,1,148,gender
咽頭結膜熱,2008,30,2008-W30,61,60,121,148,gender
Ａ群溶血性レンサ球菌咽頭炎,2008,30,2008-W30,67,62,129,148,gender
感染性胃腸炎,2008,30,2008-W30,262,243,505,148,gender
水痘,2008,30,2008-W30,56,46,102,148,gender
手足口病,2008,30,2008-W30,156,101,257,148,gender
突発性発しん,2008,30,2008-W30,48,44,92,148,gender
ヘルパンギーナ,2008,30,2008-W30,331,335,666,148,gender
流行性耳下腺炎,2008,30,2008-W30,59,41,100,148,gender
川崎病,2008,30,2008-W30,0,1,1,148,gender
インフルエンザ,2019,19,2019-W19,175,162,337,414,gender
RSウイルス感染症,2019,19,2019-W19,18,14,32,260,gender
咽頭結膜熱,2019,19,2019-W19,48,41,89,260,gender
Ａ群溶血性レンサ球菌咽頭炎,2019,19,2019-W19,293,242,535,260,gender
感染性胃腸炎,2019,19,2019-W19,810,752,1562,260,gender
水痘,2019,19,2019-W19,103,107,210,260,gender
手足口病,2019,19,2019-W19,18,16,34,260,gender
突発性発しん,2019,19,2019-W19,82,61,143,260,gender
ヘルパンギーナ,2019,19,2019-W19,1,7,8,260,gender
流行性耳下腺炎,2019,19,2019-W19,12,9,21,260,gender
川崎病,2019,19,2019-W19,1,0,1,260,gender
インフルエンザ,2014,49,2014-W49,1242,1178,2420,413,gender
RSウイルス感染症,2014,49,2014-W49,195,220,415,262,gender
咽頭結膜熱,2014,49,2014-W49,65,70,135,262,gender
Ａ群溶血性レンサ球菌咽頭炎,2014,49,2014-W49,437,407,844,262,gender
感染性胃腸炎,2014,49,2014-W49,1630,1434,3064,262,gender
水痘,2014,49,2014-W49,123,110,233,262,gender
手足口病,2014,49,2014-W49,49,52,101,262,gender
突発性発しん,2014,49,2014-W49,76,64,140,262,gender
ヘルパンギーナ,2014,49,2014-W49,9,11,20,262,gender
流行性耳下腺炎,2014,49,2014-W49,40,21,61,262,gender
川崎病,2014,49,2014-W49,0,3,3,262,gender
インフルエンザ,2009,6,2009-W06,2524,2397,4921,284,gender
RSウイルス感染症,2009,6,2009-W06,4,3,7,146,gender
咽頭結膜熱,2009,6,2009-W06,17,14,31,146,gender
Ａ群溶血性レンサ球菌咽頭炎,2009,6,2009-W06,179,168,347,146,gender
感染性胃腸炎,2009,6,2009-W06,491,453,944,146,gender
水痘,2009,6,2009-W06,103,89,192,146,gender
手足口病,2009,6,2009-W06,4,1,5,146,gender
突発性発しん,2009,6,2009-W06,39,33,72,146,gender
ヘルパンギーナ,2009,6,2009-W06,1,2,3,146,gender
流行性耳下腺炎,2009,6,2009-W06,26,21,47,146,gender
川崎病,2009,6,2009-W06,0,1,1,146,gender
インフルエンザ,2006,43,2006-W43,0,0,0,178,gender
RSウイルス感染症,2006,43,2006-W43,7,4,11,142,gender
咽頭結膜熱,2006,43,2006-W43,14,12,26,142,gender
Ａ群溶血性レンサ球菌咽頭炎,2006,43,2006-W43,106,89,195,142,gender
感染性胃腸炎,2006,43,2006-W43,407,381,788,142,gender
水痘,2006,43,2006-W43,48,47,95,142,gender
手足口病,2006,43,2006-W43,34,35,69,142,gender
突発性発しん,2006,43,2006-W43,35,50,85,142,gender
ヘルパンギーナ,2006,43,2006-W43,4,6,10,142,gender
流行性耳下腺炎,2006,43,2006-W43,23,32,55,142,gender
川崎病,2006,43,2006-W43,1,0,1,142,gender
インフルエンザ,2004,30,2004-W30,0,0,0,178,gender
RSウイルス感染症,2004,30,2004-W30,2,4,6,142,gender
咽頭結膜熱,2004,30,2004-W30,86,61,147,142,gender
Ａ群溶血性レンサ球菌咽頭炎,2004,30,2004-W30,30,29,59,142,gender
感染性胃腸炎,2004,30,2004-W30,171,135,306,142,gender
水痘,2004,30,2004-W30,39,24,63,142,gender
手足口病,2004,30,2004-W30,94,79,173,142,gender
突発性発しん,2004,30,2004-W30,43,39,82,142,gender
ヘルパンギーナ,2004,30,2004-W30,292,256,548,142,gender
流行性耳下腺炎,2004,30,2004-W30,47,24,71,142,gender
川崎病,2004,30,2004-W30,0,1,1,142,gender
インフルエンザ,2018,49,2018-W49,330,324,654,417,gender
RSウイルス感染症,2018,49,2018-W49,41,23,64,262,gender
咽頭結膜熱,2018,49,2018-W49,65,61,126,262,gender
Ａ群溶血性レンサ球菌咽頭炎,2018,49,2018-W49,512,402,914,262,gender
感染性胃腸炎,2018,49,2018-W49,1646,1505,3151,262,gender
水痘,2018,49,2018-W49,74,72,146,262,gender
手足口病,2018,49,2018-W49,118,96,214,262,gender
突発性発しん,2018,49,2018-W49,65,59,124,262,gender
ヘルパンギーナ,2018,49,2018-W49,12,10,22,262,gender
流行性耳下腺炎,2018,49,2018-W49,15,18,33,262,gender
川崎病,2018,49,2018-W49,4,3,7,262,gender
インフルエンザ,2015,19,2015-W19,46,50,96,415,gender
RSウイルス感染症,2015,19,2015-W19,8,3,11,264,gender
咽頭結膜熱,2015,19,2015-W19,42,46,88,264,gender
Ａ群溶血性レンサ球菌咽頭炎,2015,19,2015-W19,241,202,443,264,gender
感染性胃腸炎,2015,19,2015-W19,524,500,1024,264,gender
水痘,2015,19,2015-W19,70,71,141,264,gender
手足口病,2015,19,2015-W19,33,31,64,264,gender
突発性発しん,2015,19,2015-W19,57,65,122,264,gender
ヘルパンギーナ,2015,19,2015-W19,13,5,18,264,gender
流行性耳下腺炎,2015,19,2015-W19,36,30,66,264,gender
川崎病,2015,19,2015-W19,2,2,4,264,gender
インフルエンザ,2024,22,2024-W22,28,23,51,419,gender
新型コロナウイルス感染症（COVID-19）,2024,22,2024-W22,677,737,1414,419,gender
RSウイルス感染症,2024,22,2024-W22,122,120,242,264,gender
咽頭結膜熱,2024,22,2024-W22,76,68,144,264,gender
Ａ群溶血性レンサ球菌咽頭炎,2024,22,2024-W22,535,457,992,264,gender
感染性胃腸炎,2024,22,2024-W22,691,567,1258,264,gender
水痘,2024,22,2024-W22,31,23,54,264,gender
手足口病,2024,22,2024-W22,238,219,457,264,gender
突発性発しん,2024,22,2024-W22,52,34,86,264,gender
ヘルパンギーナ,2024,22,2024-W22,50,36,86,264,gender
流行性耳下腺炎,2024,22,2024-W22,9,9,18,264,gender
川崎病,2024,22,2024-W22,5,2,7,264,gender
インフルエンザ,2019,27,2019-W27,10,14,24,409,gender
RSウイルス感染症,2019,27,2019-W27,70,52,122,260,gender
咽頭結膜熱,2019,27,2019-W27,95,60,155,260,gender
Ａ群溶血性レンサ球菌咽頭炎,2019,27,2019-W27,363,260,623,260,gender
感染性胃腸炎,2019,27,2019-W27,835,701,1536,260,gender
水痘,2019,27,2019-W27,71,55,126,260,gender
手足口病,2019,27,2019-W27,1373,1155,2528,260,gender
突発性発しん,2019,27,2019-W27,79,66,145,260,gender
ヘルパンギーナ,2019,27,2019-W27,355,364,719,260,gender
流行性耳下腺炎,2019,27,2019-W27,27,16,43,260,gender
川崎病,2019,27,2019-W27,1,0,1,260,gender
インフルエンザ,2007,4,2007-W04,251,247,498,277,gender
RSウイルス感染症,2007,4,2007-W04,30,26,56,140,gender
咽頭結膜熱,2007,4,2007-W04,18,21,39,140,gender
Ａ群溶血性レンサ球菌咽頭炎,2007,4,2007-W04,139,138,277,140,gender
感染性胃腸炎,2007,4,2007-W04,480,447,927,140,gender
水痘,2007,4,2007-W04,98,106,204,140,gender
手足口病,2007,4,2007-W04,5,8,13,140,gender
突発性発しん,2007,4,2007-W04,33,44,77,140,gender
ヘルパンギーナ,2007,4,2007-W04,2,2,4,140,gender
流行性耳下腺炎,2007,4,2007-W04,20,13,33,140,gender
川崎病,2007,4,2007-W04,4,2,6,140,gender
インフルエンザ,2002,8,2002-W08,1243,1221,2464,178,gender
RSウイルス感染症,2002,8,2002-W08,0,0,0,142,gender
咽頭結膜熱,2002,8,2002-W08,3,0,3,142,gender
Ａ群溶血性レンサ球菌咽頭炎,2002,8,2002-W08,55,38,93,142,gender
感染性胃腸炎,2002,8,2002-W08,627,567,1194,142,gender
水痘,2002,8,2002-W08,83,74,157,142,gender
手足口病,2002,8,2002-W08,6,1,7,142,gender
突発性発しん,2002,8,2002-W08,18,29,47,142,gender
ヘルパンギーナ,2002,8,2002-W08,5,3,8,142,gender
流行性耳下腺炎,2002,8,2002-W08,40,25,65,142,gender
川崎病,2002,8,2002-W08,0,0,0,142,gender
インフルエンザ,2022,25,2022-W25,0,0,0,413,gender
RSウイルス感染症,2022,25,2022-W25,65,56,121,259,gender
咽頭結膜熱,2022,25,2022-W25,41,41,82,259,gender
Ａ群溶血性レンサ球菌咽頭炎,2022,25,2022-W25,22,15,37,259,gender
感染性胃腸炎,2022,25,2022-W25,915,795,1710,259,gender
水痘,2022,25,2022-W25,10,12,22,259,gender
手足口病,2022,25,2022-W25,103,81,184,259,gender
突発性発しん,2022,25,2022-W25,65,60,125,259,gender
ヘルパンギーナ,2022,25,2022-W25,28,36,64,259,gender
流行性耳下腺炎,2022,25,2022-W25,6,4,10,259,gender
川崎病,2022,25,2022-W25,0,1,1,259,gender
インフルエンザ,2021,38,2021-W38,1,0,1,410,gender
RSウイルス感染症,2021,38,2021-W38,13,22,35,260,gender
咽頭結膜熱,2021,38,2021-W38,6,7,13,260,gender
Ａ群溶血性レンサ球菌咽頭炎,2021,38,2021-W38,13,23,36,260,gender
感染性胃腸炎,2021,38,2021-W38,264,239,503,260,gender
水痘,2021,38,2021-W38,17,10,27,260,gender
手足口病,2021,38,2021-W38,22,25,47,260,gender
突発性発しん,2021,38,2021-W38,41,56,97,260,gender
ヘルパンギーナ,2021,38,2021-W38,28,21,49,260,gender
流行性耳下腺炎,2021,38,2021-W38,5,5,10,260,gender
川崎病,2021,38,2021-W38,1,1,2,260,gender
インフルエンザ,2000,44,2000-W44,12,5,17,178,gender
RSウイルス感染症,2000,44,2000-W44,0,0,0,142,gender
咽頭結膜熱,2000,44,2000-W44,1,4,5,142,gender
Ａ群溶血性レンサ球菌咽頭炎,2000,44,2000-W44,33,24,57,142,gender
感染性胃腸炎,2000,44,2000-W44,168,169,337,142,gender
水痘,2000,44,2000-W44,40,32,72,142,gender
手足口病,2000,44,2000-W44,68,57,125,142,gender
突発性発しん,2000,44,2000-W44,29,34,63,142,gender
ヘルパンギーナ,2000,44,2000-W44,7,5,12,142,gender
流行性耳下腺炎,2000,44,2000-W44,74,49,123,142,gender
川崎病,2000,44,2000-W44,0,1,1,142,gender
インフルエンザ,2024,7,2024-W07,4800,4109,8909,415,gender
新型コロナウイルス感染症（COVID-19）,2024,7,2024-W07,1336,1529,2865,415,gender
RSウイルス感染症,2024,7,2024-W07,18,9,27,261,gender
咽頭結膜熱,2024,7,2024-W07,49,44,93,261,gender
Ａ群溶血性レンサ球菌咽頭炎,2024,7,2024-W07,489,381,870,261,gender
感染性胃腸炎,2024,7,2024-W07,859,752,1611,261,gender
水痘,2024,7,2024-W07,24,8,32,261,gender
手足口病,2024,7,2024-W07,9,4,13,261,gender
突発性発しん,2024,7,2024-W07,26,31,57,261,gender
ヘルパンギーナ,2024,7,2024-W07,2,2,4,261,gender
流行性耳下腺炎,2024,7,2024-W07,6,4,10,261,gender
川崎病,2024,7,2024-W07,1,1,2,261,gender
インフルエンザ,2002,37,2002-W37,0,0,0,178,gender
RSウイルス感染症,2002,37,2002-W37,0,0,0,142,gender
咽頭結膜熱,2002,37,2002-W37,9,6,15,142,gender
Ａ群溶血性レンサ球菌咽頭炎,2002,37,2002-W37,15,10,25,142,gender
感染性胃腸炎,2002,37,2002-W37,160,132,292,142,gender
水痘,2002,37,2002-W37,22,23,45,142,gender
手足口病,2002,37,2002-W37,34,17,51,142,gender
突発性発しん,2002,37,2002-W37,56,31,87,142,gender
ヘルパンギーナ,2002,37,2002-W37,31,24,55,142,gender
流行性耳下腺炎,2002,37,2002-W37,24,23,47,142,gender
川崎病,2002,37,2002-W37,0,1,1,142,gender
インフルエンザ,2013,2,2013-W02,3099,2823,5922,415,gender
RSウイルス感染症,2013,2,2013-W02,51,39,90,263,gender
咽頭結膜熱,2013,2,2013-W02,54,50,104,263,gender
Ａ群溶血性レンサ球菌咽頭炎,2013,2,2013-W02,241,234,475,263,gender
感染性胃腸炎,2013,2,2013-W02,1275,1150,2425,263,gender
水痘,2013,2,2013-W02,206,200,406,263,gender
手足口病,2013,2,2013-W02,20,20,40,263,gender
突発性発しん,2013,2,2013-W02,54,73,127,263,gender
ヘルパンギーナ,2013,2,2013-W02,2,5,7,263,gender
流行性耳下腺炎,2013,2,2013-W02,26,31,57,263,gender
川崎病,2013,2,2013-W02,5,0,5,263,gender
インフルエンザ,2008,41,2008-W41,11,8,19,285,gender
RSウイルス感染症,2008,41,2008-W41,47,41,88,147,gender
咽頭結膜熱,2008,41,2008-W41,10,14,24,147,gender
Ａ群溶血性レンサ球菌咽頭炎,2008,41,2008-W41,110,98,208,147,gender
感染性胃腸炎,2008,41,2008-W41,295,233,528,147,gender
水痘,2008,41,2008-W41,34,40,74,147,gender
手足口病,2008,41,2008-W41,110,68,178,147,gender
突発性発しん,2008,41,2008-W41,44,56,100,147,gender
ヘルパンギーナ,2008,41,2008-W41,18,19,37,147,gender
流行性耳下腺炎,2008,41,2008-W41,40,38,78,147,gender
川崎病,2008,41,2008-W41,2,2,4,147,gender
インフルエンザ,2005,11,2005-W11,1024,1188,2212,178,gender
RSウイルス感染症,2005,11,2005-W11,2,1,3,142,gender
咽頭結膜熱,2005,11,2005-W11,9,11,20,142,gender
Ａ群溶血性レンサ球菌咽頭炎,2005,11,2005-W11,78,69,147,142,gender
感染性胃腸炎,2005,11,2005-W11,389,394,783,142,gender
水痘,2005,11,2005-W11,53,52,105,142,gender
手足口病,2005,11,2005-W11,4,4,8,142,gender
突発性発しん,2005,11,2005-W11,32,35,67,142,gender
ヘルパンギーナ,2005,11,2005-W11,2,1,3,142,gender
流行性耳下腺炎,2005,11,2005-W11,48,42,90,142,gender
川崎病,2005,11,2005-W11,1,0,1,142,gender
インフルエンザ,2014,38,2014-W38,27,24,51,412,gender
RSウイルス感染症,2014,38,2014-W38,108,91,199,261,gender
咽頭結膜熱,2014,38,2014-W38,59,33,92,261,gender
Ａ群溶血性レンサ球菌咽頭炎,2014,38,2014-W38,146,145,291,261,gender
感染性胃腸炎,2014,38,2014-W38,479,366,845,261,gender
水痘,2014,38,2014-W38,51,55,106,261,gender
手足口病,2014,38,2014-W38,144,85,229,261,gender
突発性発しん,2014,38,2014-W38,68,86,154,261,gender
ヘルパンギーナ,2014,38,2014-W38,111,115,226,261,gender
流行性耳下腺炎,2014,38,2014-W38,31,25,56,261,gender
川崎病,2014,38,2014-W38,2,0,2,261,gender
インフルエンザ,2017,25,2017-W25,10,7,17,413,gender
RSウイルス感染症,2017,25,2017-W25,34,24,58,261,gender
咽頭結膜熱,2017,25,2017-W25,134,138,272,261,gender
Ａ群溶血性レンサ球菌咽頭炎,2017,25,2017-W25,474,384,858,261,gender
感染性胃腸炎,2017,25,2017-W25,940,854,1794,261,gender
水痘,2017,25,2017-W25,62,48,110,261,gender
手足口病,2017,25,2017-W25,237,212,449,261,gender
突発性発しん,2017,25,2017-W25,108,84,192,261,gender
ヘルパンギーナ,2017,25,2017-W25,45,57,102,261,gender
流行性耳下腺炎,2017,25,2017-W25,40,36,76,261,gender
川崎病,2017,25,2017-W25,2,1,3,261,gender
インフルエンザ,2011,22,2011-W22,17,21,38,415,gender
RSウイルス感染症,2011,22,2011-W22,10,6,16,260,gender
咽頭結膜熱,2011,22,2011-W22,90,73,163,260,gender
Ａ群溶血性レンサ球菌咽頭炎,2011,22,2011-W22,476,420,896,260,gender
感染性胃腸炎,2011,22,2011-W22,987,872,1859,260,gender
水痘,2011,22,2011-W22,186,148,334,260,gender
手足口病,2011,22,2011-W22,32,39,71,260,gender
突発性発しん,2011,22,2011-W22,88,81,169,260,gender
ヘルパンギーナ,2011,22,2011-W22,13,16,29,260,gender
流行性耳下腺炎,2011,22,2011-W22,79,62,141,260,gender
川崎病,2011,22,2011-W22,2,4,6,260,gender
インフルエンザ,2013,51,2013-W51,232,225,457,409,gender
RSウイルス感染症,2013,51,2013-W51,86,97,183,257,gender
咽頭結膜熱,2013,51,2013-W51,95,69,164,257,gender
Ａ群溶血性レンサ球菌咽頭炎,2013,51,2013-W51,325,282,607,257,gender
感染性胃腸炎,2013,51,2013-W51,3913,3638,7551,257,gender
水痘,2013,51,2013-W51,213,228,441,257,gender
手足口病,2013,51,2013-W51,22,20,42,257,gender
突発性発しん,2013,51,2013-W51,78,52,130,257,gender
ヘルパンギーナ,2013,51,2013-W51,2,1,3,257,gender
流行性耳下腺炎,2013,51,2013-W51,34,26,60,257,gender
川崎病,2013,51,2013-W51,4,1,5,257,gender
インフルエンザ,2020,19,2020-W19,0,0,0,411,gender
RSウイルス感染症,2020,19,2020-W19,1,0,1,257,gender
咽頭結膜熱,2020,19,2020-W19,3,3,6,257,gender
Ａ群溶血性レンサ球菌咽頭炎,2020,19,2020-W19,34,19,53,257,gender
感染性胃腸炎,2020,19,2020-W19,93,80,173,257,gender
水痘,2020,19,2020-W19,5,4,9,257,gender
手足口病,2020,19,2020-W19,3,4,7,257,gender
突発性発しん,2020,19,2020-W19,35,23,58,257,gender
ヘルパンギーナ,2020,19,2020-W19,0,1,1,257,gender
流行性耳下腺炎,2020,19,2020-W19,4,6,10,257,gender
川崎病,2020,19,2020-W19,2,2,4,257,gender
インフルエンザ,2003,16,2003-W16,3,4,7,178,gender
RSウイルス感染症,2003,16,2003-W16,0,0,0,142,gender
咽頭結膜熱,2003,16,2003-W16,9,7,16,142,gender
Ａ群溶血性レンサ球菌咽頭炎,2003,16,2003-W16,45,39,84,142,gender
感染性胃腸炎,2003,16,2003-W16,344,368,712,142,gender
水痘,2003,16,2003-W16,45,62,107,142,gender
手足口病,2003,16,2003-W16,9,6,15,142,gender
突発性発しん,2003,16,2003-W16,43,34,77,142,gender
ヘルパンギーナ,2003,16,2003-W16,5,5,10,142,gender
流行性耳下腺炎,2003,16,2003-W16,18,10,28,142,gender
川崎病,2003,16,2003-W16,1,0,1,142,gender
インフルエンザ,2021,49,2021-W49,0,0,0,410,gender
RSウイルス感染症,2021,49,2021-W49,1,2,3,258,gender
咽頭結膜熱,2021,49,2021-W49,17,13,30,258,gender
Ａ群溶血性レンサ球菌咽頭炎,2021,49,2021-W49,48,31,79,258,gender
感染性胃腸炎,2021,49,2021-W49,1075,946,2021,258,gender
水痘,2021,49,2021-W49,18,19,37,258,gender
手足口病,2021,49,2021-W49,109,88,197,258,gender
突発性発しん,2021,49,2021-W49,33,52,85,258,gender
ヘルパンギーナ,2021,49,2021-W49,38,48,86,258,gender
流行性耳下腺炎,2021,49,2021-W49,5,1,6,258,gender
川崎病,2021,49,2021-W49,4,1,5,258,gender
インフルエンザ,2000,35,2000-W35,0,0,0,178,gender
RSウイルス感染症,2000,35,2000-W35,0,0,0,142,gender
咽頭結膜熱,2000,35,2000-W35,8,7,15,142,gender
Ａ群溶血性レンサ球菌咽頭炎,2000,35,2000-W35,11,9,20,142,gender
感染性胃腸炎,2000,35,2000-W35,128,94,222,142,gender
水痘,2000,35,2000-W35,28,24,52,142,gender
手足口病,2000,35,2000-W35,95,82,177,142,gender
突発性発しん,2000,35,2000-W35,52,41,93,142,gender
ヘルパンギーナ,2000,35,2000-W35,59,66,125,142,gender
流行性耳下腺炎,2000,35,2000-W35,44,37,81,142,gender
川崎病,2000,35,2000-W35,1,0,1,142,gender
インフルエンザ,2001,9,2001-W09,401,388,789,178,gender
RSウイルス感染症,2001,9,2001-W09,0,0,0,142,gender
咽頭結膜熱,2001,9,2001-W09,2,2,4,142,gender
Ａ群溶血性レンサ球菌咽頭炎,2001,9,2001-W09,44,42,86,142,gender
感染性胃腸炎,2001,9,2001-W09,596,585,1181,142,gender
水痘,2001,9,2001-W09,75,76,151,142,gender
手足口病,2001,9,2001-W09,5,4,9,142,gender
突発性発しん,2001,9,2001-W09,37,36,73,142,gender
ヘルパンギーナ,2001,9,2001-W09,4,4,8,142,gender
流行性耳下腺炎,2001,9,2001-W09,71,71,142,142,gender
川崎病,2001,9,2001-W09,0,1,1,142,gender
インフルエンザ,2004,5,2004-W05,2312,2240,4552,178,gender
RSウイルス感染症,2004,5,2004-W05,4,0,4,142,gender
咽頭結膜熱,2004,5,2004-W05,6,4,10,142,gender
Ａ群溶血性レンサ球菌咽頭炎,2004,5,2004-W05,46,51,97,142,gender
感染性胃腸炎,2004,5,2004-W05,511,493,1004,142,gender
水痘,2004,5,2004-W05,97,63,160,142,gender
手足口病,2004,5,2004-W05,2,0,2,142,gender
突発性発しん,2004,5,2004-W05,40,26,66,142,gender
ヘルパンギーナ,2004,5,2004-W05,0,2,2,142,gender
流行性耳下腺炎,2004,5,2004-W05,21,17,38,142,gender
川崎病,2004,5,2004-W05,0,1,1,142,gender
インフルエンザ,2002,46,2002-W46,2,0,2,178,gender
RSウイルス感染症,2002,46,2002-W46,0,0,0,142,gender
咽頭結膜熱,2002,46,2002-W46,10,4,14,142,gender
Ａ群溶血性レンサ球菌咽頭炎,2002,46,2002-W46,45,31,76,142,gender
感染性胃腸炎,2002,46,2002-W46,522,534,1056,142,gender
水痘,2002,46,2002-W46,59,76,135,142,gender
手足口病,2002,46,2002-W46,21,16,37,142,gender
突発性発しん,2002,46,2002-W46,25,35,60,142,gender
ヘルパンギーナ,2002,46,2002-W46,10,3,13,142,gender
流行性耳下腺炎,2002,46,2002-W46,23,18,41,142,gender
川崎病,2002,46,2002-W46,2,0,2,142,gender
インフルエンザ,2020,27,2020-W27,0,0,0,413,gender
RSウイルス感染症,2020,27,2020-W27,3,0,3,259,gender
咽頭結膜熱,2020,27,2020-W27,3,7,10,259,gender
Ａ群溶血性レンサ球菌咽頭炎,2020,27,2020-W27,78,64,142,259,gender
感染性胃腸炎,2020,27,2020-W27,357,306,663,259,gender
水痘,2020,27,2020-W27,12,14,26,259,gender
手足口病,2020,27,2020-W27,28,30,58,259,gender
突発性発しん,2020,27,2020-W27,87,77,164,259,gender
ヘルパンギーナ,2020,27,2020-W27,8,8,16,259,gender
流行性耳下腺炎,2020,27,2020-W27,9,7,16,259,gender
川崎病,2020,27,2020-W27,5,0,5,259,gender
インフルエンザ,2003,28,2003-W28,0,0,0,178,gender
RSウイルス感染症,2003,28,2003-W28,0,0,0,142,gender
咽頭結膜熱,2003,28,2003-W28,55,35,90,142,gender
Ａ群溶血性レンサ球菌咽頭炎,2003,28,2003-W28,47,35,82,142,gender
感染性胃腸炎,2003,28,2003-W28,181,163,344,142,gender
水痘,2003,28,2003-W28,53,46,99,142,gender
手足口病,2003,28,2003-W28,426,304,730,142,gender
突発性発しん,2003,28,2003-W28,33,42,75,142,gender
ヘルパンギーナ,2003,28,2003-W28,329,290,619,142,gender
流行性耳下腺炎,2003,28,2003-W28,15,11,26,142,gender
川崎病,2003,28,2003-W28,0,1,1,142,gender
インフルエンザ,2006,32,2006-W32,0,1,1,178,gender
RSウイルス感染症,2006,32,2006-W32,0,0,0,142,gender
咽頭結膜熱,2006,32,2006-W32,47,44,91,142,gender
Ａ群溶血性レンサ球菌咽頭炎,2006,32,2006-W32,49,34,83,142,gender
感染性胃腸炎,2006,32,2006-W32,169,155,324,142,gender
水痘,2006,32,2006-W32,33,21,54,142,gender
手足口病,2006,32,2006-W32,70,71,141,142,gender
突発性発しん,2006,32,2006-W32,40,47,87,142,gender
ヘルパンギーナ,2006,32,2006-W32,42,37,79,142,gender
流行性耳下腺炎,2006,32,2006-W32,35,52,87,142,gender
川崎病,2006,32,2006-W32,3,1,4,142,gender
インフルエンザ,2009,11,2009-W11,2085,2034,4119,286,gender
RSウイルス感染症,2009,11,2009-W11,4,1,5,147,gender
咽頭結膜熱,2009,11,2009-W11,17,15,32,147,gender
Ａ群溶血性レンサ球菌咽頭炎,2009,11,2009-W11,180,168,348,147,gender
感染性胃腸炎,2009,11,2009-W11,554,529,1083,147,gender
水痘,2009,11,2009-W11,111,97,208,147,gender
手足口病,2009,11,2009-W11,7,4,11,147,gender
突発性発しん,2009,11,2009-W11,39,32,71,147,gender
ヘルパンギーナ,2009,11,2009-W11,3,3,6,147,gender
流行性耳下腺炎,2009,11,2009-W11,48,41,89,147,gender
川崎病,2009,11,2009-W11,0,0,0,147,gender
インフルエンザ,2004,41,2004-W41,3,2,5,178,gender
RSウイルス感染症,2004,41,2004-W41,0,0,0,142,gender
咽頭結膜熱,2004,41,2004-W41,9,10,19,142,gender
Ａ群溶血性レンサ球菌咽頭炎,2004,41,2004-W41,28,24,52,142,gender
感染性胃腸炎,2004,41,2004-W41,152,127,279,142,gender
水痘,2004,41,2004-W41,24,27,51,142,gender
手足口病,2004,41,2004-W41,48,54,102,142,gender
突発性発しん,2004,41,2004-W41,40,42,82,142,gender
ヘルパンギーナ,2004,41,2004-W41,12,7,19,142,gender
流行性耳下腺炎,2004,41,2004-W41,60,28,88,142,gender
川崎病,2004,41,2004-W41,0,0,0,142,gender
インフルエンザ,2018,38,2018-W38,36,43,79,413,gender
RSウイルス感染症,2018,38,2018-W38,193,169,362,260,gender
咽頭結膜熱,2018,38,2018-W38,31,19,50,260,gender
Ａ群溶血性レンサ球菌咽頭炎,2018,38,2018-W38,186,155,341,260,gender
感染性胃腸炎,2018,38,2018-W38,493,409,902,260,gender
水痘,2018,38,2018-W38,25,29,54,260,gender
手足口病,2018,38,2018-W38,161,160,321,260,gender
突発性発しん,2018,38,2018-W38,63,63,126,260,gender
ヘルパンギーナ,2018,38,2018-W38,77,86,163,260,gender
流行性耳下腺炎,2018,38,2018-W38,14,14,28,260,gender
川崎病,2018,38,2018-W38,2,0,2,260,gender
インフルエンザ,2005,20,2005-W20,30,26,56,178,gender
RSウイルス感染症,2005,20,2005-W20,2,1,3,142,gender
咽頭結膜熱,2005,20,2005-W20,21,20,41,142,gender
Ａ群溶血性レンサ球菌咽頭炎,2005,20,2005-W20,128,104,232,142,gender
感染性胃腸炎,2005,20,2005-W20,430,400,830,142,gender
水痘,2005,20,2005-W20,83,88,171,142,gender
手足口病,2005,20,2005-W20,14,12,26,142,gender
突発性発しん,2005,20,2005-W20,42,52,94,142,gender
ヘルパンギーナ,2005,20,2005-W20,13,19,32,142,gender
流行性耳下腺炎,2005,20,2005-W20,84,61,145,142,gender
川崎病,2005,20,2005-W20,2,0,2,142,gender
インフルエンザ,2018,37,2018-W37,42,45,87,414,gender
RSウイルス感染症,2018,37,2018-W37,281,268,549,259,gender
咽頭結膜熱,2018,37,2018-W37,38,37,75,259,gender
Ａ群溶血性レンサ球菌咽頭炎,2018,37,2018-W37,203,184,387,259,gender
感染性胃腸炎,2018,37,2018-W37,527,482,1009,259,gender
水痘,2018,37,2018-W37,26,15,41,259,gender
手足口病,2018,37,2018-W37,182,166,348,259,gender
突発性発しん,2018,37,2018-W37,71,54,125,259,gender
ヘルパンギーナ,2018,37,2018-W37,144,117,261,259,gender
流行性耳下腺炎,2018,37,2018-W37,22,12,34,259,gender
川崎病,2018,37,2018-W37,4,2,6,259,gender
インフルエンザ,2017,14,2017-W14,1074,1040,2114,413,gender
RSウイルス感染症,2017,14,2017-W14,14,13,27,260,gender
咽頭結膜熱,2017,14,2017-W14,40,20,60,260,gender
Ａ群溶血性レンサ球菌咽頭炎,2017,14,2017-W14,252,204,456,260,gender
感染性胃腸炎,2017,14,2017-W14,969,913,1882,260,gender
水痘,2017,14,2017-W14,42,41,83,260,gender
手足口病,2017,14,2017-W14,8,12,20,260,gender
突発性発しん,2017,14,2017-W14,65,70,135,260,gender
ヘルパンギーナ,2017,14,2017-W14,2,1,3,260,gender
流行性耳下腺炎,2017,14,2017-W14,35,38,73,260,gender
川崎病,2017,14,2017-W14,1,0,1,260,gender
インフルエンザ,2023,35,2023-W35,661,565,1226,415,gender
新型コロナウイルス感染症（COVID-19）,2023,35,2023-W35,3335,3711,7046,415,gender
RSウイルス感染症,2023,35,2023-W35,43,29,72,260,gender
咽頭結膜熱,2023,35,2023-W35,168,137,305,260,gender
Ａ群溶血性レンサ球菌咽頭炎,2023,35,2023-W35,208,141,349,260,gender
感染性胃腸炎,2023,35,2023-W35,515,440,955,260,gender
水痘,2023,35,2023-W35,3,13,16,260,gender
手足口病,2023,35,2023-W35,139,120,259,260,gender
突発性発しん,2023,35,2023-W35,35,36,71,260,gender
ヘルパンギーナ,2023,35,2023-W35,102,100,202,260,gender
流行性耳下腺炎,2023,35,2023-W35,8,5,13,260,gender
川崎病,2023,35,2023-W35,3,4,7,260,gender
インフルエンザ,2002,49,2002-W49,29,23,52,178,gender
RSウイルス感染症,2002,49,2002-W49,0,0,0,142,gender
咽頭結膜熱,2002,49,2002-W49,7,12,19,142,gender
Ａ群溶血性レンサ球菌咽頭炎,2002,49,2002-W49,58,43,101,142,gender
感染性胃腸炎,2002,49,2002-W49,855,820,1675,142,gender
水痘,2002,49,2002-W49,114,96,210,142,gender
手足口病,2002,49,2002-W49,5,7,12,142,gender
突発性発しん,2002,49,2002-W49,42,41,83,142,gender
ヘルパンギーナ,2002,49,2002-W49,4,4,8,142,gender
流行性耳下腺炎,2002,49,2002-W49,32,16,48,142,gender
川崎病,2002,49,2002-W49,0,0,0,142,gender
インフルエンザ,2011,13,2011-W13,1623,1569,3192,412,gender
RSウイルス感染症,2011,13,2011-W13,14,6,20,260,gender
咽頭結膜熱,2011,13,2011-W13,25,29,54,260,gender
Ａ群溶血性レンサ球菌咽頭炎,2011,13,2011-W13,217,187,404,260,gender
感染性胃腸炎,2011,13,2011-W13,718,675,1393,260,gender
水痘,2011,13,2011-W13,133,126,259,260,gender
手足口病,2011,13,2011-W13,6,6,12,260,gender
突発性発しん,2011,13,2011-W13,70,77,147,260,gender
ヘルパンギーナ,2011,13,2011-W13,2,3,5,260,gender
流行性耳下腺炎,2011,13,2011-W13,39,31,70,260,gender
川崎病,2011,13,2011-W13,2,0,2,260,gender
インフルエンザ,2021,46,2021-W46,1,0,1,412,gender
RSウイルス感染症,2021,46,2021-W46,4,1,5,261,gender
咽頭結膜熱,2021,46,2021-W46,21,17,38,261,gender
Ａ群溶血性レンサ球菌咽頭炎,2021,46,2021-W46,52,36,88,261,gender
感染性胃腸炎,2021,46,2021-W46,662,531,1193,261,gender
水痘,2021,46,2021-W46,15,9,24,261,gender
手足口病,2021,46,2021-W46,142,133,275,261,gender
突発性発しん,2021,46,2021-W46,45,40,85,261,gender
ヘルパンギーナ,2021,46,2021-W46,68,68,136,261,gender
流行性耳下腺炎,2021,46,2021-W46,12,4,16,261,gender
川崎病,2021,46,2021-W46,0,1,1,261,gender
インフルエンザ,2001,6,2001-W06,182,138,320,178,gender
RSウイルス感染症,2001,6,2001-W06,0,0,0,142,gender
咽頭結膜熱,2001,6,2001-W06,0,1,1,142,gender
Ａ群溶血性レンサ球菌咽頭炎,2001,6,2001-W06,54,47,101,142,gender
感染性胃腸炎,2001,6,2001-W06,628,630,1258,142,gender
水痘,2001,6,2001-W06,90,80,170,142,gender
手足口病,2001,6,2001-W06,3,3,6,142,gender
突発性発しん,2001,6,2001-W06,25,32,57,142,gender
ヘルパンギーナ,2001,6,2001-W06,2,3,5,142,gender
流行性耳下腺炎,2001,6,2001-W06,58,55,113,142,gender
川崎病,2001,6,2001-W06,0,0,0,142,gender
インフルエンザ,2003,27,2003-W27,0,0,0,178,gender
RSウイルス感染症,2003,27,2003-W27,0,0,0,142,gender
咽頭結膜熱,2003,27,2003-W27,34,19,53,142,gender
Ａ群溶血性レンサ球菌咽頭炎,2003,27,2003-W27,44,42,86,142,gender
感染性胃腸炎,2003,27,2003-W27,162,146,308,142,gender
水痘,2003,27,2003-W27,58,43,101,142,gender
手足口病,2003,27,2003-W27,364,288,652,142,gender
突発性発しん,2003,27,2003-W27,44,50,94,142,gender
ヘルパンギーナ,2003,27,2003-W27,240,205,445,142,gender
流行性耳下腺炎,2003,27,2003-W27,12,11,23,142,gender
川崎病,2003,27,2003-W27,0,0,0,142,gender
インフルエンザ,2022,5,2022-W05,0,0,0,402,gender
RSウイルス感染症,2022,5,2022-W05,5,2,7,250,gender
咽頭結膜熱,2022,5,2022-W05,6,1,7,250,gender
Ａ群溶血性レンサ球菌咽頭炎,2022,5,2022-W05,20,25,45,250,gender
感染性胃腸炎,2022,5,2022-W05,852,765,1617,250,gender
水痘,2022,5,2022-W05,5,7,12,250,gender
手足口病,2022,5,2022-W05,19,21,40,250,gender
突発性発しん,2022,5,2022-W05,31,27,58,250,gender
ヘルパンギーナ,2022,5,2022-W05,1,0,1,250,gender
流行性耳下腺炎,2022,5,2022-W05,5,3,8,250,gender
川崎病,2022,5,2022-W05,0,1,1,250,gender
インフルエンザ,2020,28,2020-W28,0,0,0,412,gender
RSウイルス感染症,2020,28,2020-W28,1,1,2,259,gender
咽頭結膜熱,2020,28,2020-W28,7,10,17,259,gender
Ａ群溶血性レンサ球菌咽頭炎,2020,28,2020-W28,95,83,178,259,gender
感染性胃腸炎,2020,28,2020-W28,379,361,740,259,gender
水痘,2020,28,2020-W28,17,14,31,259,gender
手足口病,2020,28,2020-W28,21,23,44,259,gender
突発性発しん,2020,28,2020-W28,70,88,158,259,gender
ヘルパンギーナ,2020,28,2020-W28,17,11,28,259,gender
流行性耳下腺炎,2020,28,2020-W28,13,8,21,259,gender
川崎病,2020,28,2020-W28,1,0,1,259,gender
インフルエンザ,2018,3,2018-W03,10448,10164,20612,415,gender
RSウイルス感染症,2018,3,2018-W03,27,43,70,262,gender
咽頭結膜熱,2018,3,2018-W03,38,29,67,262,gender
Ａ群溶血性レンサ球菌咽頭炎,2018,3,2018-W03,395,317,712,262,gender
感染性胃腸炎,2018,3,2018-W03,923,921,1844,262,gender
水痘,2018,3,2018-W03,50,31,81,262,gender
手足口病,2018,3,2018-W03,10,12,22,262,gender
突発性発しん,2018,3,2018-W03,58,64,122,262,gender
ヘルパンギーナ,2018,3,2018-W03,1,1,2,262,gender
流行性耳下腺炎,2018,3,2018-W03,5,9,14,262,gender
川崎病,2018,3,2018-W03,1,1,2,262,gender
インフルエンザ,2003,19,2003-W19,0,0,0,178,gender
RSウイルス感染症,2003,19,2003-W19,0,0,0,142,gender
咽頭結膜熱,2003,19,2003-W19,11,10,21,142,gender
Ａ群溶血性レンサ球菌咽頭炎,2003,19,2003-W19,45,42,87,142,gender
感染性胃腸炎,2003,19,2003-W19,251,186,437,142,gender
水痘,2003,19,2003-W19,94,86,180,142,gender
手足口病,2003,19,2003-W19,8,14,22,142,gender
突発性発しん,2003,19,2003-W19,41,40,81,142,gender
ヘルパンギーナ,2003,19,2003-W19,6,5,11,142,gender
流行性耳下腺炎,2003,19,2003-W19,16,14,30,142,gender
川崎病,2003,19,2003-W19,0,1,1,142,gender
インフルエンザ,2012,30,2012-W30,5,1,6,416,gender
RSウイルス感染症,2012,30,2012-W30,30,31,61,263,gender
咽頭結膜熱,2012,30,2012-W30,101,66,167,263,gender
Ａ群溶血性レンサ球菌咽頭炎,2012,30,2012-W30,185,203,388,263,gender
感染性胃腸炎,2012,30,2012-W30,553,499,1052,263,gender
水痘,2012,30,2012-W30,92,83,175,263,gender
手足口病,2012,30,2012-W30,165,168,333,263,gender
突発性発しん,2012,30,2012-W30,108,97,205,263,gender
ヘルパンギーナ,2012,30,2012-W30,1046,964,2010,263,gender
流行性耳下腺炎,2012,30,2012-W30,45,32,77,263,gender
川崎病,2012,30,2012-W30,3,0,3,263,gender
インフルエンザ,2010,43,2010-W43,16,17,33,287,gender
RSウイルス感染症,2010,43,2010-W43,33,37,70,148,gender
咽頭結膜熱,2010,43,2010-W43,14,15,29,148,gender
Ａ群溶血性レンサ球菌咽頭炎,2010,43,2010-W43,85,83,168,148,gender
感染性胃腸炎,2010,43,2010-W43,405,412,817,148,gender
水痘,2010,43,2010-W43,50,41,91,148,gender
手足口病,2010,43,2010-W43,39,29,68,148,gender
突発性発しん,2010,43,2010-W43,39,46,85,148,gender
ヘルパンギーナ,2010,43,2010-W43,6,9,15,148,gender
流行性耳下腺炎,2010,43,2010-W43,32,27,59,148,gender
川崎病,2010,43,2010-W43,2,0,2,148,gender
インフルエンザ,2020,16,2020-W16,0,0,0,410,gender
RSウイルス感染症,2020,16,2020-W16,1,1,2,257,gender
咽頭結膜熱,2020,16,2020-W16,6,5,11,257,gender
Ａ群溶血性レンサ球菌咽頭炎,2020,16,2020-W16,68,68,136,257,gender
感染性胃腸炎,2020,16,2020-W16,138,119,257,257,gender
水痘,2020,16,2020-W16,27,22,49,257,gender
手足口病,2020,16,2020-W16,4,3,7,257,gender
突発性発しん,2020,16,2020-W16,35,36,71,257,gender
ヘルパンギーナ,2020,16,2020-W16,2,1,3,257,gender
流行性耳下腺炎,2020,16,2020-W16,7,4,11,257,gender
川崎病,2020,16,2020-W16,1,4,5,257,gender
インフルエンザ,2014,37,2014-W37,7,9,16,409,gender
RSウイルス感染症,2014,37,2014-W37,94,60,154,260,gender
咽頭結膜熱,2014,37,2014-W37,62,46,108,260,gender
Ａ群溶血性レンサ球菌咽頭炎,2014,37,2014-W37,191,148,339,260,gender
感染性胃腸炎,2014,37,2014-W37,538,405,943,260,gender
水痘,2014,37,2014-W37,54,43,97,260,gender
手足口病,2014,37,2014-W37,176,131,307,260,gender
突発性発しん,2014,37,2014-W37,89,86,175,260,gender
ヘルパンギーナ,2014,37,2014-W37,203,203,406,260,gender
流行性耳下腺炎,2014,37,2014-W37,41,25,66,260,gender
川崎病,2014,37,2014-W37,2,1,3,260,gender
インフルエンザ,2016,1,2016-W01,357,326,683,412,gender
RSウイルス感染症,2016,1,2016-W01,85,69,154,260,gender
咽頭結膜熱,2016,1,2016-W01,53,47,100,260,gender
Ａ群溶血性レンサ球菌咽頭炎,2016,1,2016-W01,262,232,494,260,gender
感染性胃腸炎,2016,1,2016-W01,1052,1090,2142,260,gender
水痘,2016,1,2016-W01,145,110,255,260,gender
手足口病,2016,1,2016-W01,5,6,11,260,gender
突発性発しん,2016,1,2016-W01,38,47,85,260,gender
ヘルパンギーナ,2016,1,2016-W01,1,2,3,260,gender
流行性耳下腺炎,2016,1,2016-W01,107,98,205,260,gender
川崎病,2016,1,2016-W01,4,4,8,260,gender
インフルエンザ,2016,44,2016-W44,120,122,242,415,gender
RSウイルス感染症,2016,44,2016-W44,83,72,155,263,gender
咽頭結膜熱,2016,44,2016-W44,25,28,53,263,gender
Ａ群溶血性レンサ球菌咽頭炎,2016,44,2016-W44,248,240,488,263,gender
感染性胃腸炎,2016,44,2016-W44,1300,1186,2486,263,gender
水痘,2016,44,2016-W44,42,34,76,263,gender
手足口病,2016,44,2016-W44,142,123,265,263,gender
突発性発しん,2016,44,2016-W44,65,58,123,263,gender
ヘルパンギーナ,2016,44,2016-W44,38,19,57,263,gender
流行性耳下腺炎,2016,44,2016-W44,115,101,216,263,gender
川崎病,2016,44,2016-W44,1,0,1,263,gender
インフルエンザ,2009,20,2009-W20,58,69,127,287,gender
RSウイルス感染症,2009,20,2009-W20,4,4,8,148,gender
咽頭結膜熱,2009,20,2009-W20,20,25,45,148,gender
Ａ群溶血性レンサ球菌咽頭炎,2009,20,2009-W20,155,126,281,148,gender
感染性胃腸炎,2009,20,2009-W20,460,407,867,148,gender
水痘,2009,20,2009-W20,104,70,174,148,gender
手足口病,2009,20,2009-W20,9,11,20,148,gender
突発性発しん,2009,20,2009-W20,42,48,90,148,gender
ヘルパンギーナ,2009,20,2009-W20,6,3,9,148,gender
流行性耳下腺炎,2009,20,2009-W20,81,62,143,148,gender
川崎病,2009,20,2009-W20,0,1,1,148,gender
インフルエンザ,2002,7,2002-W07,1057,1067,2124,178,gender
RSウイルス感染症,2002,7,2002-W07,0,0,0,142,gender
咽頭結膜熱,2002,7,2002-W07,0,2,2,142,gender
Ａ群溶血性レンサ球菌咽頭炎,2002,7,2002-W07,27,37,64,142,gender
感染性胃腸炎,2002,7,2002-W07,545,570,1115,142,gender
水痘,2002,7,2002-W07,76,71,147,142,gender
手足口病,2002,7,2002-W07,1,6,7,142,gender
突発性発しん,2002,7,2002-W07,22,34,56,142,gender
ヘルパンギーナ,2002,7,2002-W07,3,3,6,142,gender
流行性耳下腺炎,2002,7,2002-W07,35,37,72,142,gender
川崎病,2002,7,2002-W07,1,0,1,142,gender
インフルエンザ,2001,25,2001-W25,6,6,12,178,gender
RSウイルス感染症,2001,25,2001-W25,0,0,0,142,gender
咽頭結膜熱,2001,25,2001-W25,6,9,15,142,gender
Ａ群溶血性レンサ球菌咽頭炎,2001,25,2001-W25,63,43,106,142,gender
感染性胃腸炎,2001,25,2001-W25,169,149,318,142,gender
水痘,2001,25,2001-W25,71,73,144,142,gender
手足口病,2001,25,2001-W25,54,57,111,142,gender
突発性発しん,2001,25,2001-W25,44,38,82,142,gender
ヘルパンギーナ,2001,25,2001-W25,203,160,363,142,gender
流行性耳下腺炎,2001,25,2001-W25,76,58,134,142,gender
川崎病,2001,25,2001-W25,2,5,7,142,gender
インフルエンザ,2021,4,2021-W04,3,2,5,409,gender
RSウイルス感染症,2021,4,2021-W04,7,5,12,257,gender
咽頭結膜熱,2021,4,2021-W04,13,6,19,257,gender
Ａ群溶血性レンサ球菌咽頭炎,2021,4,2021-W04,40,36,76,257,gender
感染性胃腸炎,2021,4,2021-W04,439,396,835,257,gender
水痘,2021,4,2021-W04,18,16,34,257,gender
手足口病,2021,4,2021-W04,3,4,7,257,gender
突発性発しん,2021,4,2021-W04,34,44,78,257,gender
ヘルパンギーナ,2021,4,2021-W04,0,0,0,257,gender
流行性耳下腺炎,2021,4,2021-W04,3,5,8,257,gender
川崎病,2021,4,2021-W04,2,0,2,257,gender
インフルエンザ,2023,44,2023-W44,3680,3406,7086,417,gender
新型コロナウイルス感染症（COVID-19）,2023,44,2023-W44,279,328,607,417,gender
RSウイルス感染症,2023,44,2023-W44,5,4,9,262,gender
咽頭結膜熱,2023,44,2023-W44,357,359,716,262,gender
Ａ群溶血性レンサ球菌咽頭炎,2023,44,2023-W44,568,526,1094,262,gender
感染性胃腸炎,2023,44,2023-W44,523,444,967,262,gender
水痘,2023,44,2023-W44,21,19,40,262,gender
手足口病,2023,44,2023-W44,69,64,133,262,gender
突発性発しん,2023,44,2023-W44,29,23,52,262,gender
ヘルパンギーナ,2023,44,2023-W44,8,9,17,262,gender
流行性耳下腺炎,2023,44,2023-W44,4,4,8,262,gender
川崎病,2023,44,2023-W44,0,0,0,262,gender
インフルエンザ,2002,38,2002-W38,0,0,0,178,gender
RSウイルス感染症,2002,38,2002-W38,0,0,0,142,gender
咽頭結膜熱,2002,38,2002-W38,5,3,8,142,gender
Ａ群溶血性レンサ球菌咽頭炎,2002,38,2002-W38,21,13,34,142,gender
感染性胃腸炎,2002,38,2002-W38,138,99,237,142,gender
水痘,2002,38,2002-W38,22,24,46,142,gender
手足口病,2002,38,2002-W38,22,21,43,142,gender
突発性発しん,2002,38,2002-W38,46,42,88,142,gender
ヘルパンギーナ,2002,38,2002-W38,16,15,31,142,gender
流行性耳下腺炎,2002,38,2002-W38,30,16,46,142,gender
川崎病,2002,38,2002-W38,0,1,1,142,gender
インフルエンザ,2013,11,2013-W11,515,549,1064,417,gender
RSウイルス感染症,2013,11,2013-W11,24,21,45,263,gender
咽頭結膜熱,2013,11,2013-W11,36,27,63,263,gender
Ａ群溶血性レンサ球菌咽頭炎,2013,11,2013-W11,363,347,710,263,gender
感染性胃腸炎,2013,11,2013-W11,1740,1651,3391,263,gender
水痘,2013,11,2013-W11,102,83,185,263,gender
手足口病,2013,11,2013-W11,11,10,21,263,gender
突発性発しん,2013,11,2013-W11,70,73,143,263,gender
ヘルパンギーナ,2013,11,2013-W11,2,2,4,263,gender
流行性耳下腺炎,2013,11,2013-W11,23,16,39,263,gender
川崎病,2013,11,2013-W11,0,5,5,263,gender
インフルエンザ,2024,8,2024-W08,3739,3225,6964,416,gender
新型コロナウイルス感染症（COVID-19）,2024,8,2024-W08,1029,1175,2204,416,gender
RSウイルス感染症,2024,8,2024-W08,19,12,31,262,gender
咽頭結膜熱,2024,8,2024-W08,37,40,77,262,gender
Ａ群溶血性レンサ球菌咽頭炎,2024,8,2024-W08,458,388,846,262,gender
感染性胃腸炎,2024,8,2024-W08,789,703,1492,262,gender
水痘,2024,8,2024-W08,35,30,65,262,gender
手足口病,2024,8,2024-W08,7,3,10,262,gender
突発性発しん,2024,8,2024-W08,21,20,41,262,gender
ヘルパンギーナ,2024,8,2024-W08,1,0,1,262,gender
流行性耳下腺炎,2024,8,2024-W08,7,1,8,262,gender
川崎病,2024,8,2024-W08,0,1,1,262,gender
インフルエンザ,2021,37,2021-W37,0,0,0,410,gender
RSウイルス感染症,2021,37,2021-W37,42,57,99,260,gender
咽頭結膜熱,2021,37,2021-W37,7,9,16,260,gender
Ａ群溶血性レンサ球菌咽頭炎,2021,37,2021-W37,26,24,50,260,gender
感染性胃腸炎,2021,37,2021-W37,345,320,665,260,gender
水痘,2021,37,2021-W37,19,9,28,260,gender
手足口病,2021,37,2021-W37,15,15,30,260,gender
突発性発しん,2021,37,2021-W37,65,56,121,260,gender
ヘルパンギーナ,2021,37,2021-W37,37,31,68,260,gender
流行性耳下腺炎,2021,37,2021-W37,11,5,16,260,gender
川崎病,2021,37,2021-W37,1,1,2,260,gender
インフルエンザ,2015,16,2015-W16,286,332,618,414,gender
RSウイルス感染症,2015,16,2015-W16,17,20,37,264,gender
咽頭結膜熱,2015,16,2015-W16,24,23,47,264,gender
Ａ群溶血性レンサ球菌咽頭炎,2015,16,2015-W16,492,395,887,264,gender
感染性胃腸炎,2015,16,2015-W16,1153,1055,2208,264,gender
水痘,2015,16,2015-W16,70,65,135,264,gender
手足口病,2015,16,2015-W16,21,17,38,264,gender
突発性発しん,2015,16,2015-W16,83,64,147,264,gender
ヘルパンギーナ,2015,16,2015-W16,4,9,13,264,gender
流行性耳下腺炎,2015,16,2015-W16,29,30,59,264,gender
川崎病,2015,16,2015-W16,0,2,2,264,gender
インフルエンザ,2018,46,2018-W46,120,131,251,416,gender
RSウイルス感染症,2018,46,2018-W46,43,42,85,262,gender
咽頭結膜熱,2018,46,2018-W46,51,48,99,262,gender
Ａ群溶血性レンサ球菌咽頭炎,2018,46,2018-W46,393,320,713,262,gender
感染性胃腸炎,2018,46,2018-W46,1082,976,2058,262,gender
水痘,2018,46,2018-W46,48,41,89,262,gender
手足口病,2018,46,2018-W46,195,179,374,262,gender
突発性発しん,2018,46,2018-W46,67,73,140,262,gender
ヘルパンギーナ,2018,46,2018-W46,19,17,36,262,gender
流行性耳下腺炎,2018,46,2018-W46,10,10,20,262,gender
川崎病,2018,46,2018-W46,6,0,6,262,gender
インフルエンザ,2009,9,2009-W09,1319,1266,2585,288,gender
RSウイルス感染症,2009,9,2009-W09,6,7,13,149,gender
咽頭結膜熱,2009,9,2009-W09,14,16,30,149,gender
Ａ群溶血性レンサ球菌咽頭炎,2009,9,2009-W09,178,139,317,149,gender
感染性胃腸炎,2009,9,2009-W09,545,519,1064,149,gender
水痘,2009,9,2009-W09,101,84,185,149,gender
手足口病,2009,9,2009-W09,5,1,6,149,gender
突発性発しん,2009,9,2009-W09,36,46,82,149,gender
ヘルパンギーナ,2009,9,2009-W09,3,0,3,149,gender
流行性耳下腺炎,2009,9,2009-W09,49,30,79,149,gender
川崎病,2009,9,2009-W09,1,0,1,149,gender
インフルエンザ,2019,28,2019-W28,20,16,36,410,gender
RSウイルス感染症,2019,28,2019-W28,128,81,209,260,gender
咽頭結膜熱,2019,28,2019-W28,63,55,118,260,gender
Ａ群溶血性レンサ球菌咽頭炎,2019,28,2019-W28,291,278,569,260,gender
感染性胃腸炎,2019,28,2019-W28,745,617,1362,260,gender
水痘,2019,28,2019-W28,72,65,137,260,gender
手足口病,2019,28,2019-W28,2120,1739,3859,260,gender
突発性発しん,2019,28,2019-W28,57,48,105,260,gender
ヘルパンギーナ,2019,28,2019-W28,632,547,1179,260,gender
流行性耳下腺炎,2019,28,2019-W28,14,19,33,260,gender
川崎病,2019,28,2019-W28,1,0,1,260,gender
インフルエンザ,2005,51,2005-W51,160,147,307,178,gender
RSウイルス感染症,2005,51,2005-W51,43,44,87,142,gender
咽頭結膜熱,2005,51,2005-W51,41,27,68,142,gender
Ａ群溶血性レンサ球菌咽頭炎,2005,51,2005-W51,125,116,241,142,gender
感染性胃腸炎,2005,51,2005-W51,1298,1323,2621,142,gender
水痘,2005,51,2005-W51,103,107,210,142,gender
手足口病,2005,51,2005-W51,10,7,17,142,gender
突発性発しん,2005,51,2005-W51,41,28,69,142,gender
ヘルパンギーナ,2005,51,2005-W51,3,2,5,142,gender
流行性耳下腺炎,2005,51,2005-W51,84,69,153,142,gender
川崎病,2005,51,2005-W51,0,0,0,142,gender
インフルエンザ,2007,22,2007-W22,6,4,10,283,gender
RSウイルス感染症,2007,22,2007-W22,5,3,8,149,gender
咽頭結膜熱,2007,22,2007-W22,68,53,121,149,gender
Ａ群溶血性レンサ球菌咽頭炎,2007,22,2007-W22,234,165,399,149,gender
感染性胃腸炎,2007,22,2007-W22,500,452,952,149,gender
水痘,2007,22,2007-W22,135,126,261,149,gender
手足口病,2007,22,2007-W22,28,16,44,149,gender
突発性発しん,2007,22,2007-W22,60,60,120,149,gender
ヘルパンギーナ,2007,22,2007-W22,14,21,35,149,gender
流行性耳下腺炎,2007,22,2007-W22,22,22,44,149,gender
川崎病,2007,22,2007-W22,4,3,7,149,gender
インフルエンザ,2015,28,2015-W28,7,1,8,416,gender
RSウイルス感染症,2015,28,2015-W28,6,3,9,263,gender
咽頭結膜熱,2015,28,2015-W28,106,98,204,263,gender
Ａ群溶血性レンサ球菌咽頭炎,2015,28,2015-W28,509,382,891,263,gender
感染性胃腸炎,2015,28,2015-W28,805,688,1493,263,gender
水痘,2015,28,2015-W28,73,66,139,263,gender
手足口病,2015,28,2015-W28,1505,1215,2720,263,gender
突発性発しん,2015,28,2015-W28,88,89,177,263,gender
ヘルパンギーナ,2015,28,2015-W28,390,331,721,263,gender
流行性耳下腺炎,2015,28,2015-W28,49,48,97,263,gender
川崎病,2015,28,2015-W28,6,1,7,263,gender
インフルエンザ,2009,51,2009-W51,1805,1750,3555,290,gender
RSウイルス感染症,2009,51,2009-W51,39,36,75,150,gender
咽頭結膜熱,2009,51,2009-W51,12,8,20,150,gender
Ａ群溶血性レンサ球菌咽頭炎,2009,51,2009-W51,82,86,168,150,gender
感染性胃腸炎,2009,51,2009-W51,751,684,1435,150,gender
水痘,2009,51,2009-W51,128,97,225,150,gender
手足口病,2009,51,2009-W51,20,15,35,150,gender
突発性発しん,2009,51,2009-W51,30,39,69,150,gender
ヘルパンギーナ,2009,51,2009-W51,6,5,11,150,gender
流行性耳下腺炎,2009,51,2009-W51,65,66,131,150,gender
川崎病,2009,51,2009-W51,0,1,1,150,gender
インフルエンザ,2014,46,2014-W46,150,153,303,415,gender
RSウイルス感染症,2014,46,2014-W46,196,159,355,264,gender
咽頭結膜熱,2014,46,2014-W46,72,64,136,264,gender
Ａ群溶血性レンサ球菌咽頭炎,2014,46,2014-W46,362,309,671,264,gender
感染性胃腸炎,2014,46,2014-W46,879,789,1668,264,gender
水痘,2014,46,2014-W46,115,98,213,264,gender
手足口病,2014,46,2014-W46,77,77,154,264,gender
突発性発しん,2014,46,2014-W46,93,89,182,264,gender
ヘルパンギーナ,2014,46,2014-W46,17,12,29,264,gender
流行性耳下腺炎,2014,46,2014-W46,35,26,61,264,gender
川崎病,2014,46,2014-W46,2,1,3,264,gender
インフルエンザ,2019,16,2019-W16,682,657,1339,410,gender
RSウイルス感染症,2019,16,2019-W16,71,65,136,257,gender
咽頭結膜熱,2019,16,2019-W16,31,26,57,257,gender
Ａ群溶血性レンサ球菌咽頭炎,2019,16,2019-W16,379,307,686,257,gender
感染性胃腸炎,2019,16,2019-W16,1265,1196,2461,257,gender
水痘,2019,16,2019-W16,51,37,88,257,gender
手足口病,2019,16,2019-W16,9,7,16,257,gender
突発性発しん,2019,16,2019-W16,79,66,145,257,gender
ヘルパンギーナ,2019,16,2019-W16,4,3,7,257,gender
流行性耳下腺炎,2019,16,2019-W16,12,6,18,257,gender
川崎病,2019,16,2019-W16,2,2,4,257,gender
インフルエンザ,2024,13,2024-W13,2008,1895,3903,415,gender
新型コロナウイルス感染症（COVID-19）,2024,13,2024-W13,698,748,1446,415,gender
RSウイルス感染症,2024,13,2024-W13,106,84,190,262,gender
咽頭結膜熱,2024,13,2024-W13,32,19,51,262,gender
Ａ群溶血性レンサ球菌咽頭炎,2024,13,2024-W13,396,343,739,262,gender
感染性胃腸炎,2024,13,2024-W13,611,498,1109,262,gender
水痘,2024,13,2024-W13,27,22,49,262,gender
手足口病,2024,13,2024-W13,6,10,16,262,gender
突発性発しん,2024,13,2024-W13,30,21,51,262,gender
ヘルパンギーナ,2024,13,2024-W13,2,3,5,262,gender
流行性耳下腺炎,2024,13,2024-W13,6,3,9,262,gender
川崎病,2024,13,2024-W13,0,2,2,262,gender
インフルエンザ,2016,35,2016-W35,5,8,13,410,gender
RSウイルス感染症,2016,35,2016-W35,165,147,312,258,gender
咽頭結膜熱,2016,35,2016-W35,43,34,77,258,gender
Ａ群溶血性レンサ球菌咽頭炎,2016,35,2016-W35,167,145,312,258,gender
感染性胃腸炎,2016,35,2016-W35,587,505,1092,258,gender
水痘,2016,35,2016-W35,30,28,58,258,gender
手足口病,2016,35,2016-W35,137,116,253,258,gender
突発性発しん,2016,35,2016-W35,75,86,161,258,gender
ヘルパンギーナ,2016,35,2016-W35,297,259,556,258,gender
流行性耳下腺炎,2016,35,2016-W35,73,73,146,258,gender
川崎病,2016,35,2016-W35,2,4,6,258,gender
インフルエンザ,2022,14,2022-W14,1,0,1,404,gender
RSウイルス感染症,2022,14,2022-W14,2,1,3,253,gender
咽頭結膜熱,2022,14,2022-W14,4,2,6,253,gender
Ａ群溶血性レンサ球菌咽頭炎,2022,14,2022-W14,11,9,20,253,gender
感染性胃腸炎,2022,14,2022-W14,479,412,891,253,gender
水痘,2022,14,2022-W14,5,6,11,253,gender
手足口病,2022,14,2022-W14,5,4,9,253,gender
突発性発しん,2022,14,2022-W14,44,25,69,253,gender
ヘルパンギーナ,2022,14,2022-W14,2,2,4,253,gender
流行性耳下腺炎,2022,14,2022-W14,5,2,7,253,gender
川崎病,2022,14,2022-W14,0,1,1,253,gender
インフルエンザ,2012,41,2012-W41,11,6,17,409,gender
RSウイルス感染症,2012,41,2012-W41,183,176,359,260,gender
咽頭結膜熱,2012,41,2012-W41,39,33,72,260,gender
Ａ群溶血性レンサ球菌咽頭炎,2012,41,2012-W41,155,145,300,260,gender
感染性胃腸炎,2012,41,2012-W41,413,357,770,260,gender
水痘,2012,41,2012-W41,76,52,128,260,gender
手足口病,2012,41,2012-W41,69,59,128,260,gender
突発性発しん,2012,41,2012-W41,83,89,172,260,gender
ヘルパンギーナ,2012,41,2012-W41,40,39,79,260,gender
流行性耳下腺炎,2012,41,2012-W41,47,29,76,260,gender
川崎病,2012,41,2012-W41,4,2,6,260,gender
インフルエンザ,2010,32,2010-W32,2,2,4,257,gender
RSウイルス感染症,2010,32,2010-W32,5,0,5,132,gender
咽頭結膜熱,2010,32,2010-W32,20,12,32,132,gender
Ａ群溶血性レンサ球菌咽頭炎,2010,32,2010-W32,38,25,63,132,gender
感染性胃腸炎,2010,32,2010-W32,174,162,336,132,gender
水痘,2010,32,2010-W32,26,19,45,132,gender
手足口病,2010,32,2010-W32,133,103,236,132,gender
突発性発しん,2010,32,2010-W32,30,30,60,132,gender
ヘルパンギーナ,2010,32,2010-W32,145,115,260,132,gender
流行性耳下腺炎,2010,32,2010-W32,40,29,69,132,gender
川崎病,2010,32,2010-W32,0,0,0,132,gender
インフルエンザ,2022,26,2022-W26,0,0,0,413,gender
RSウイルス感染症,2022,26,2022-W26,92,90,182,260,gender
咽頭結膜熱,2022,26,2022-W26,51,37,88,260,gender
Ａ群溶血性レンサ球菌咽頭炎,2022,26,2022-W26,29,24,53,260,gender
感染性胃腸炎,2022,26,2022-W26,802,639,1441,260,gender
水痘,2022,26,2022-W26,19,14,33,260,gender
手足口病,2022,26,2022-W26,178,137,315,260,gender
突発性発しん,2022,26,2022-W26,52,61,113,260,gender
ヘルパンギーナ,2022,26,2022-W26,65,66,131,260,gender
流行性耳下腺炎,2022,26,2022-W26,5,5,10,260,gender
川崎病,2022,26,2022-W26,1,0,1,260,gender
インフルエンザ,2007,7,2007-W07,1291,1321,2612,278,gender
RSウイルス感染症,2007,7,2007-W07,12,4,16,141,gender
咽頭結膜熱,2007,7,2007-W07,22,12,34,141,gender
Ａ群溶血性レンサ球菌咽頭炎,2007,7,2007-W07,130,97,227,141,gender
感染性胃腸炎,2007,7,2007-W07,356,322,678,141,gender
水痘,2007,7,2007-W07,103,117,220,141,gender
手足口病,2007,7,2007-W07,6,7,13,141,gender
突発性発しん,2007,7,2007-W07,29,26,55,141,gender
ヘルパンギーナ,2007,7,2007-W07,4,1,5,141,gender
流行性耳下腺炎,2007,7,2007-W07,18,13,31,141,gender
川崎病,2007,7,2007-W07,1,2,3,141,gender
インフルエンザ,2001,29,2001-W29,0,0,0,178,gender
RSウイルス感染症,2001,29,2001-W29,0,0,0,142,gender
咽頭結膜熱,2001,29,2001-W29,30,26,56,142,gender
Ａ群溶血性レンサ球菌咽頭炎,2001,29,2001-W29,20,7,27,142,gender
感染性胃腸炎,2001,29,2001-W29,120,105,225,142,gender
水痘,2001,29,2001-W29,50,41,91,142,gender
手足口病,2001,29,2001-W29,81,70,151,142,gender
突発性発しん,2001,29,2001-W29,23,27,50,142,gender
ヘルパンギーナ,2001,29,2001-W29,473,414,887,142,gender
流行性耳下腺炎,2001,29,2001-W29,81,67,148,142,gender
川崎病,2001,29,2001-W29,0,1,1,142,gender
インフルエンザ,2002,34,2002-W34,0,0,0,178,gender
RSウイルス感染症,2002,34,2002-W34,0,0,0,142,gender
咽頭結膜熱,2002,34,2002-W34,17,9,26,142,gender
Ａ群溶血性レンサ球菌咽頭炎,2002,34,2002-W34,8,11,19,142,gender
感染性胃腸炎,2002,34,2002-W34,116,87,203,142,gender
水痘,2002,34,2002-W34,32,26,58,142,gender
手足口病,2002,34,2002-W34,37,21,58,142,gender
突発性発しん,2002,34,2002-W34,40,25,65,142,gender
ヘルパンギーナ,2002,34,2002-W34,44,30,74,142,gender
流行性耳下腺炎,2002,34,2002-W34,28,26,54,142,gender
川崎病,2002,34,2002-W34,0,0,0,142,gender
インフルエンザ,2023,48,2023-W48,3277,2982,6259,415,gender
新型コロナウイルス感染症（COVID-19）,2023,48,2023-W48,370,414,784,415,gender
RSウイルス感染症,2023,48,2023-W48,3,2,5,261,gender
咽頭結膜熱,2023,48,2023-W48,517,431,948,261,gender
Ａ群溶血性レンサ球菌咽頭炎,2023,48,2023-W48,789,608,1397,261,gender
感染性胃腸炎,2023,48,2023-W48,1017,859,1876,261,gender
水痘,2023,48,2023-W48,29,28,57,261,gender
手足口病,2023,48,2023-W48,65,53,118,261,gender
突発性発しん,2023,48,2023-W48,35,29,64,261,gender
ヘルパンギーナ,2023,48,2023-W48,5,5,10,261,gender
流行性耳下腺炎,2023,48,2023-W48,8,4,12,261,gender
川崎病,2023,48,2023-W48,2,0,2,261,gender
インフルエンザ,2021,8,2021-W08,0,0,0,411,gender
RSウイルス感染症,2021,8,2021-W08,22,11,33,258,gender
咽頭結膜熱,2021,8,2021-W08,8,8,16,258,gender
Ａ群溶血性レンサ球菌咽頭炎,2021,8,2021-W08,40,32,72,258,gender
感染性胃腸炎,2021,8,2021-W08,346,278,624,258,gender
水痘,2021,8,2021-W08,18,5,23,258,gender
手足口病,2021,8,2021-W08,2,2,4,258,gender
突発性発しん,2021,8,2021-W08,56,35,91,258,gender
ヘルパンギーナ,2021,8,2021-W08,1,0,1,258,gender
流行性耳下腺炎,2021,8,2021-W08,2,3,5,258,gender
川崎病,2021,8,2021-W08,3,0,3,258,gender
インフルエンザ,2024,4,2024-W04,4139,3533,7672,414,gender
新型コロナウイルス感染症（COVID-19）,2024,4,2024-W04,2240,2427,4667,414,gender
RSウイルス感染症,2024,4,2024-W04,6,5,11,261,gender
咽頭結膜熱,2024,4,2024-W04,89,77,166,261,gender
Ａ群溶血性レンサ球菌咽頭炎,2024,4,2024-W04,598,475,1073,261,gender
感染性胃腸炎,2024,4,2024-W04,1499,1306,2805,261,gender
水痘,2024,4,2024-W04,24,18,42,261,gender
手足口病,2024,4,2024-W04,5,16,21,261,gender
突発性発しん,2024,4,2024-W04,27,28,55,261,gender
ヘルパンギーナ,2024,4,2024-W04,1,0,1,261,gender
流行性耳下腺炎,2024,4,2024-W04,9,1,10,261,gender
川崎病,2024,4,2024-W04,1,1,2,261,gender
インフルエンザ,2000,47,2000-W47,5,5,10,178,gender
RSウイルス感染症,2000,47,2000-W47,0,0,0,142,gender
咽頭結膜熱,2000,47,2000-W47,4,6,10,142,gender
Ａ群溶血性レンサ球菌咽頭炎,2000,47,2000-W47,34,47,81,142,gender
感染性胃腸炎,2000,47,2000-W47,294,260,554,142,gender
水痘,2000,47,2000-W47,52,60,112,142,gender
手足口病,2000,47,2000-W47,39,37,76,142,gender
突発性発しん,2000,47,2000-W47,41,41,82,142,gender
ヘルパンギーナ,2000,47,2000-W47,4,6,10,142,gender
流行性耳下腺炎,2000,47,2000-W47,85,74,159,142,gender
川崎病,2000,47,2000-W47,0,0,0,142,gender
インフルエンザ,2004,33,2004-W33,0,0,0,178,gender
RSウイルス感染症,2004,33,2004-W33,1,1,2,142,gender
咽頭結膜熱,2004,33,2004-W33,28,18,46,142,gender
Ａ群溶血性レンサ球菌咽頭炎,2004,33,2004-W33,13,5,18,142,gender
感染性胃腸炎,2004,33,2004-W33,124,104,228,142,gender
水痘,2004,33,2004-W33,20,15,35,142,gender
手足口病,2004,33,2004-W33,43,33,76,142,gender
突発性発しん,2004,33,2004-W33,44,34,78,142,gender
ヘルパンギーナ,2004,33,2004-W33,76,72,148,142,gender
流行性耳下腺炎,2004,33,2004-W33,22,25,47,142,gender
川崎病,2004,33,2004-W33,0,0,0,142,gender
インフルエンザ,2006,40,2006-W40,0,0,0,178,gender
RSウイルス感染症,2006,40,2006-W40,3,1,4,142,gender
咽頭結膜熱,2006,40,2006-W40,18,13,31,142,gender
Ａ群溶血性レンサ球菌咽頭炎,2006,40,2006-W40,58,66,124,142,gender
感染性胃腸炎,2006,40,2006-W40,262,220,482,142,gender
水痘,2006,40,2006-W40,20,20,40,142,gender
手足口病,2006,40,2006-W40,59,52,111,142,gender
突発性発しん,2006,40,2006-W40,43,35,78,142,gender
ヘルパンギーナ,2006,40,2006-W40,20,16,36,142,gender
流行性耳下腺炎,2006,40,2006-W40,40,28,68,142,gender
川崎病,2006,40,2006-W40,0,0,0,142,gender
インフルエンザ,2009,5,2009-W05,4364,4218,8582,286,gender
RSウイルス感染症,2009,5,2009-W05,3,2,5,148,gender
咽頭結膜熱,2009,5,2009-W05,9,9,18,148,gender
Ａ群溶血性レンサ球菌咽頭炎,2009,5,2009-W05,148,148,296,148,gender
感染性胃腸炎,2009,5,2009-W05,514,508,1022,148,gender
水痘,2009,5,2009-W05,67,65,132,148,gender
手足口病,2009,5,2009-W05,8,3,11,148,gender
突発性発しん,2009,5,2009-W05,31,37,68,148,gender
ヘルパンギーナ,2009,5,2009-W05,2,3,5,148,gender
流行性耳下腺炎,2009,5,2009-W05,41,20,61,148,gender
川崎病,2009,5,2009-W05,2,0,2,148,gender
インフルエンザ,2019,24,2019-W24,46,41,87,412,gender
RSウイルス感染症,2019,24,2019-W24,39,45,84,259,gender
咽頭結膜熱,2019,24,2019-W24,93,70,163,259,gender
Ａ群溶血性レンサ球菌咽頭炎,2019,24,2019-W24,384,335,719,259,gender
感染性胃腸炎,2019,24,2019-W24,847,760,1607,259,gender
水痘,2019,24,2019-W24,76,57,133,259,gender
手足口病,2019,24,2019-W24,224,204,428,259,gender
突発性発しん,2019,24,2019-W24,85,84,169,259,gender
ヘルパンギーナ,2019,24,2019-W24,68,59,127,259,gender
流行性耳下腺炎,2019,24,2019-W24,21,11,32,259,gender
川崎病,2019,24,2019-W24,1,2,3,259,gender
インフルエンザ,2024,21,2024-W21,35,24,59,419,gender
新型コロナウイルス感染症（COVID-19）,2024,21,2024-W21,591,656,1247,419,gender
RSウイルス感染症,2024,21,2024-W21,172,166,338,264,gender
咽頭結膜熱,2024,21,2024-W21,62,52,114,264,gender
Ａ群溶血性レンサ球菌咽頭炎,2024,21,2024-W21,569,471,1040,264,gender
感染性胃腸炎,2024,21,2024-W21,687,559,1246,264,gender
水痘,2024,21,2024-W21,32,30,62,264,gender
手足口病,2024,21,2024-W21,140,137,277,264,gender
突発性発しん,2024,21,2024-W21,41,42,83,264,gender
ヘルパンギーナ,2024,21,2024-W21,36,28,64,264,gender
流行性耳下腺炎,2024,21,2024-W21,18,13,31,264,gender
川崎病,2024,21,2024-W21,2,1,3,264,gender
インフルエンザ,2015,24,2015-W24,5,3,8,416,gender
RSウイルス感染症,2015,24,2015-W24,12,5,17,263,gender
咽頭結膜熱,2015,24,2015-W24,102,98,200,263,gender
Ａ群溶血性レンサ球菌咽頭炎,2015,24,2015-W24,583,494,1077,263,gender
感染性胃腸炎,2015,24,2015-W24,1025,932,1957,263,gender
水痘,2015,24,2015-W24,63,62,125,263,gender
手足口病,2015,24,2015-W24,280,209,489,263,gender
突発性発しん,2015,24,2015-W24,101,109,210,263,gender
ヘルパンギーナ,2015,24,2015-W24,51,50,101,263,gender
流行性耳下腺炎,2015,24,2015-W24,50,30,80,263,gender
川崎病,2015,24,2015-W24,3,1,4,263,gender
インフルエンザ,2008,33,2008-W33,0,0,0,269,gender
RSウイルス感染症,2008,33,2008-W33,5,5,10,137,gender
咽頭結膜熱,2008,33,2008-W33,33,29,62,137,gender
Ａ群溶血性レンサ球菌咽頭炎,2008,33,2008-W33,34,24,58,137,gender
感染性胃腸炎,2008,33,2008-W33,178,146,324,137,gender
水痘,2008,33,2008-W33,31,22,53,137,gender
手足口病,2008,33,2008-W33,76,66,142,137,gender
突発性発しん,2008,33,2008-W33,35,31,66,137,gender
ヘルパンギーナ,2008,33,2008-W33,113,116,229,137,gender
流行性耳下腺炎,2008,33,2008-W33,31,22,53,137,gender
川崎病,2008,33,2008-W33,1,0,1,137,gender
インフルエンザ,2007,10,2007-W10,3165,3221,6386,281,gender
RSウイルス感染症,2007,10,2007-W10,3,4,7,142,gender
咽頭結膜熱,2007,10,2007-W10,16,14,30,142,gender
Ａ群溶血性レンサ球菌咽頭炎,2007,10,2007-W10,132,154,286,142,gender
感染性胃腸炎,2007,10,2007-W10,454,396,850,142,gender
水痘,2007,10,2007-W10,102,114,216,142,gender
手足口病,2007,10,2007-W10,6,5,11,142,gender
突発性発しん,2007,10,2007-W10,31,34,65,142,gender
ヘルパンギーナ,2007,10,2007-W10,1,1,2,142,gender
流行性耳下腺炎,2007,10,2007-W10,19,18,37,142,gender
川崎病,2007,10,2007-W10,1,0,1,142,gender
インフルエンザ,2016,39,2016-W39,30,33,63,414,gender
RSウイルス感染症,2016,39,2016-W39,369,296,665,260,gender
咽頭結膜熱,2016,39,2016-W39,41,27,68,260,gender
Ａ群溶血性レンサ球菌咽頭炎,2016,39,2016-W39,232,182,414,260,gender
感染性胃腸炎,2016,39,2016-W39,557,532,1089,260,gender
水痘,2016,39,2016-W39,46,39,85,260,gender
手足口病,2016,39,2016-W39,262,199,461,260,gender
突発性発しん,2016,39,2016-W39,72,74,146,260,gender
ヘルパンギーナ,2016,39,2016-W39,169,160,329,260,gender
流行性耳下腺炎,2016,39,2016-W39,117,104,221,260,gender
川崎病,2016,39,2016-W39,2,1,3,260,gender
インフルエンザ,2022,18,2022-W18,1,1,2,410,gender
RSウイルス感染症,2022,18,2022-W18,2,3,5,257,gender
咽頭結膜熱,2022,18,2022-W18,5,6,11,257,gender
Ａ群溶血性レンサ球菌咽頭炎,2022,18,2022-W18,15,9,24,257,gender
感染性胃腸炎,2022,18,2022-W18,434,354,788,257,gender
水痘,2022,18,2022-W18,12,9,21,257,gender
手足口病,2022,18,2022-W18,4,6,10,257,gender
突発性発しん,2022,18,2022-W18,36,27,63,257,gender
ヘルパンギーナ,2022,18,2022-W18,2,0,2,257,gender
流行性耳下腺炎,2022,18,2022-W18,2,3,5,257,gender
川崎病,2022,18,2022-W18,1,0,1,257,gender
インフルエンザ,2001,17,2001-W17,31,29,60,178,gender
RSウイルス感染症,2001,17,2001-W17,0,0,0,142,gender
咽頭結膜熱,2001,17,2001-W17,2,4,6,142,gender
Ａ群溶血性レンサ球菌咽頭炎,2001,17,2001-W17,34,29,63,142,gender
感染性胃腸炎,2001,17,2001-W17,264,249,513,142,gender
水痘,2001,17,2001-W17,94,99,193,142,gender
手足口病,2001,17,2001-W17,5,4,9,142,gender
突発性発しん,2001,17,2001-W17,40,28,68,142,gender
ヘルパンギーナ,2001,17,2001-W17,5,1,6,142,gender
流行性耳下腺炎,2001,17,2001-W17,71,55,126,142,gender
川崎病,2001,17,2001-W17,0,0,0,142,gender
インフルエンザ,2013,23,2013-W23,36,39,75,416,gender
RSウイルス感染症,2013,23,2013-W23,15,7,22,262,gender
咽頭結膜熱,2013,23,2013-W23,120,89,209,262,gender
Ａ群溶血性レンサ球菌咽頭炎,2013,23,2013-W23,419,311,730,262,gender
感染性胃腸炎,2013,23,2013-W23,909,745,1654,262,gender
水痘,2013,23,2013-W23,171,159,330,262,gender
手足口病,2013,23,2013-W23,89,79,168,262,gender
突発性発しん,2013,23,2013-W23,100,96,196,262,gender
ヘルパンギーナ,2013,23,2013-W23,43,26,69,262,gender
流行性耳下腺炎,2013,23,2013-W23,31,25,56,262,gender
川崎病,2013,23,2013-W23,0,2,2,262,gender
インフルエンザ,2011,50,2011-W50,97,93,190,418,gender
RSウイルス感染症,2011,50,2011-W50,78,67,145,264,gender
咽頭結膜熱,2011,50,2011-W50,61,56,117,264,gender
Ａ群溶血性レンサ球菌咽頭炎,2011,50,2011-W50,426,355,781,264,gender
感染性胃腸炎,2011,50,2011-W50,2740,2574,5314,264,gender
水痘,2011,50,2011-W50,380,351,731,264,gender
手足口病,2011,50,2011-W50,41,35,76,264,gender
突発性発しん,2011,50,2011-W50,96,70,166,264,gender
ヘルパンギーナ,2011,50,2011-W50,11,6,17,264,gender
流行性耳下腺炎,2011,50,2011-W50,48,39,87,264,gender
川崎病,2011,50,2011-W50,4,1,5,264,gender
インフルエンザ,2024,50,2024-W50,3796,3460,7256,418,gender
新型コロナウイルス感染症（COVID-19）,2024,50,2024-W50,428,496,924,418,gender
RSウイルス感染症,2024,50,2024-W50,46,28,74,264,gender
咽頭結膜熱,2024,50,2024-W50,43,43,86,264,gender
Ａ群溶血性レンサ球菌咽頭炎,2024,50,2024-W50,407,319,726,264,gender
感染性胃腸炎,2024,50,2024-W50,794,736,1530,264,gender
水痘,2024,50,2024-W50,60,55,115,264,gender
手足口病,2024,50,2024-W50,156,121,277,264,gender
突発性発しん,2024,50,2024-W50,38,28,66,264,gender
ヘルパンギーナ,2024,50,2024-W50,2,0,2,264,gender
流行性耳下腺炎,2024,50,2024-W50,10,5,15,264,gender
川崎病,2024,50,2024-W50,0,0,0,264,gender
インフルエンザ,2009,12,2009-W12,2047,1899,3946,287,gender
RSウイルス感染症,2009,12,2009-W12,5,2,7,149,gender
咽頭結膜熱,2009,12,2009-W12,10,14,24,149,gender
Ａ群溶血性レンサ球菌咽頭炎,2009,12,2009-W12,174,145,319,149,gender
感染性胃腸炎,2009,12,2009-W12,521,451,972,149,gender
水痘,2009,12,2009-W12,85,91,176,149,gender
手足口病,2009,12,2009-W12,8,10,18,149,gender
突発性発しん,2009,12,2009-W12,47,46,93,149,gender
ヘルパンギーナ,2009,12,2009-W12,5,6,11,149,gender
流行性耳下腺炎,2009,12,2009-W12,39,38,77,149,gender
川崎病,2009,12,2009-W12,1,0,1,149,gender
インフルエンザ,2004,42,2004-W42,13,17,30,178,gender
RSウイルス感染症,2004,42,2004-W42,0,0,0,142,gender
咽頭結膜熱,2004,42,2004-W42,6,5,11,142,gender
Ａ群溶血性レンサ球菌咽頭炎,2004,42,2004-W42,25,25,50,142,gender
感染性胃腸炎,2004,42,2004-W42,173,127,300,142,gender
水痘,2004,42,2004-W42,38,29,67,142,gender
手足口病,2004,42,2004-W42,67,52,119,142,gender
突発性発しん,2004,42,2004-W42,26,32,58,142,gender
ヘルパンギーナ,2004,42,2004-W42,7,11,18,142,gender
流行性耳下腺炎,2004,42,2004-W42,43,25,68,142,gender
川崎病,2004,42,2004-W42,0,2,2,142,gender
インフルエンザ,2006,31,2006-W31,0,0,0,178,gender
RSウイルス感染症,2006,31,2006-W31,4,3,7,142,gender
咽頭結膜熱,2006,31,2006-W31,59,47,106,142,gender
Ａ群溶血性レンサ球菌咽頭炎,2006,31,2006-W31,51,52,103,142,gender
感染性胃腸炎,2006,31,2006-W31,175,169,344,142,gender
水痘,2006,31,2006-W31,60,43,103,142,gender
手足口病,2006,31,2006-W31,68,68,136,142,gender
突発性発しん,2006,31,2006-W31,60,55,115,142,gender
ヘルパンギーナ,2006,31,2006-W31,68,68,136,142,gender
流行性耳下腺炎,2006,31,2006-W31,48,50,98,142,gender
川崎病,2006,31,2006-W31,2,4,6,142,gender
インフルエンザ,2017,18,2017-W18,355,369,724,416,gender
RSウイルス感染症,2017,18,2017-W18,20,33,53,262,gender
咽頭結膜熱,2017,18,2017-W18,41,46,87,262,gender
Ａ群溶血性レンサ球菌咽頭炎,2017,18,2017-W18,272,238,510,262,gender
感染性胃腸炎,2017,18,2017-W18,809,723,1532,262,gender
水痘,2017,18,2017-W18,40,42,82,262,gender
手足口病,2017,18,2017-W18,25,23,48,262,gender
突発性発しん,2017,18,2017-W18,64,56,120,262,gender
ヘルパンギーナ,2017,18,2017-W18,6,4,10,262,gender
流行性耳下腺炎,2017,18,2017-W18,19,19,38,262,gender
川崎病,2017,18,2017-W18,1,0,1,262,gender
インフルエンザ,2002,45,2002-W45,3,0,3,178,gender
RSウイルス感染症,2002,45,2002-W45,0,0,0,142,gender
咽頭結膜熱,2002,45,2002-W45,7,7,14,142,gender
Ａ群溶血性レンサ球菌咽頭炎,2002,45,2002-W45,31,22,53,142,gender
感染性胃腸炎,2002,45,2002-W45,324,278,602,142,gender
水痘,2002,45,2002-W45,69,47,116,142,gender
手足口病,2002,45,2002-W45,18,18,36,142,gender
突発性発しん,2002,45,2002-W45,37,26,63,142,gender
ヘルパンギーナ,2002,45,2002-W45,7,5,12,142,gender
流行性耳下腺炎,2002,45,2002-W45,20,16,36,142,gender
川崎病,2002,45,2002-W45,1,0,1,142,gender
インフルエンザ,2023,39,2023-W39,3673,3240,6913,417,gender
新型コロナウイルス感染症（COVID-19）,2023,39,2023-W39,1455,1496,2951,417,gender
RSウイルス感染症,2023,39,2023-W39,10,7,17,262,gender
咽頭結膜熱,2023,39,2023-W39,284,265,549,262,gender
Ａ群溶血性レンサ球菌咽頭炎,2023,39,2023-W39,269,252,521,262,gender
感染性胃腸炎,2023,39,2023-W39,534,400,934,262,gender
水痘,2023,39,2023-W39,19,11,30,262,gender
手足口病,2023,39,2023-W39,264,253,517,262,gender
突発性発しん,2023,39,2023-W39,33,40,73,262,gender
ヘルパンギーナ,2023,39,2023-W39,77,76,153,262,gender
流行性耳下腺炎,2023,39,2023-W39,16,2,18,262,gender
川崎病,2023,39,2023-W39,1,1,2,262,gender
インフルエンザ,2004,6,2004-W06,1911,1861,3772,178,gender
RSウイルス感染症,2004,6,2004-W06,6,4,10,142,gender
咽頭結膜熱,2004,6,2004-W06,15,7,22,142,gender
Ａ群溶血性レンサ球菌咽頭炎,2004,6,2004-W06,61,65,126,142,gender
感染性胃腸炎,2004,6,2004-W06,522,522,1044,142,gender
水痘,2004,6,2004-W06,69,65,134,142,gender
手足口病,2004,6,2004-W06,0,3,3,142,gender
突発性発しん,2004,6,2004-W06,28,26,54,142,gender
ヘルパンギーナ,2004,6,2004-W06,0,0,0,142,gender
流行性耳下腺炎,2004,6,2004-W06,8,15,23,142,gender
川崎病,2004,6,2004-W06,1,0,1,142,gender
インフルエンザ,2000,36,2000-W36,0,0,0,178,gender
RSウイルス感染症,2000,36,2000-W36,0,0,0,142,gender
咽頭結膜熱,2000,36,2000-W36,6,9,15,142,gender
Ａ群溶血性レンサ球菌咽頭炎,2000,36,2000-W36,25,16,41,142,gender
感染性胃腸炎,2000,36,2000-W36,150,138,288,142,gender
水痘,2000,36,2000-W36,25,22,47,142,gender
手足口病,2000,36,2000-W36,109,101,210,142,gender
突発性発しん,2000,36,2000-W36,58,46,104,142,gender
ヘルパンギーナ,2000,36,2000-W36,43,41,84,142,gender
流行性耳下腺炎,2000,36,2000-W36,46,30,76,142,gender
川崎病,2000,36,2000-W36,2,0,2,142,gender
インフルエンザ,2022,9,2022-W09,1,0,1,407,gender
RSウイルス感染症,2022,9,2022-W09,6,3,9,258,gender
咽頭結膜熱,2022,9,2022-W09,3,1,4,258,gender
Ａ群溶血性レンサ球菌咽頭炎,2022,9,2022-W09,6,8,14,258,gender
感染性胃腸炎,2022,9,2022-W09,585,526,1111,258,gender
水痘,2022,9,2022-W09,7,8,15,258,gender
手足口病,2022,9,2022-W09,1,1,2,258,gender
突発性発しん,2022,9,2022-W09,31,19,50,258,gender
ヘルパンギーナ,2022,9,2022-W09,0,1,1,258,gender
流行性耳下腺炎,2022,9,2022-W09,2,1,3,258,gender
川崎病,2022,9,2022-W09,2,0,2,258,gender
インフルエンザ,2020,24,2020-W24,0,0,0,412,gender
RSウイルス感染症,2020,24,2020-W24,0,0,0,258,gender
咽頭結膜熱,2020,24,2020-W24,2,2,4,258,gender
Ａ群溶血性レンサ球菌咽頭炎,2020,24,2020-W24,41,42,83,258,gender
感染性胃腸炎,2020,24,2020-W24,271,218,489,258,gender
水痘,2020,24,2020-W24,12,8,20,258,gender
手足口病,2020,24,2020-W24,17,18,35,258,gender
突発性発しん,2020,24,2020-W24,57,58,115,258,gender
ヘルパンギーナ,2020,24,2020-W24,2,2,4,258,gender
流行性耳下腺炎,2020,24,2020-W24,7,8,15,258,gender
川崎病,2020,24,2020-W24,3,1,4,258,gender
インフルエンザ,2013,52,2013-W52,320,298,618,409,gender
RSウイルス感染症,2013,52,2013-W52,79,69,148,260,gender
咽頭結膜熱,2013,52,2013-W52,86,70,156,260,gender
Ａ群溶血性レンサ球菌咽頭炎,2013,52,2013-W52,276,207,483,260,gender
感染性胃腸炎,2013,52,2013-W52,2782,2647,5429,260,gender
水痘,2013,52,2013-W52,216,207,423,260,gender
手足口病,2013,52,2013-W52,17,14,31,260,gender
突発性発しん,2013,52,2013-W52,60,56,116,260,gender
ヘルパンギーナ,2013,52,2013-W52,6,2,8,260,gender
流行性耳下腺炎,2013,52,2013-W52,25,12,37,260,gender
川崎病,2013,52,2013-W52,4,1,5,260,gender
インフルエンザ,2011,21,2011-W21,57,37,94,412,gender
RSウイルス感染症,2011,21,2011-W21,11,6,17,261,gender
咽頭結膜熱,2011,21,2011-W21,63,63,126,261,gender
Ａ群溶血性レンサ球菌咽頭炎,2011,21,2011-W21,488,380,868,261,gender
感染性胃腸炎,2011,21,2011-W21,937,803,1740,261,gender
水痘,2011,21,2011-W21,235,217,452,261,gender
手足口病,2011,21,2011-W21,23,18,41,261,gender
突発性発しん,2011,21,2011-W21,89,99,188,261,gender
ヘルパンギーナ,2011,21,2011-W21,15,17,32,261,gender
流行性耳下腺炎,2011,21,2011-W21,41,37,78,261,gender
川崎病,2011,21,2011-W21,3,2,5,261,gender
インフルエンザ,2003,15,2003-W15,4,7,11,178,gender
RSウイルス感染症,2003,15,2003-W15,0,0,0,142,gender
咽頭結膜熱,2003,15,2003-W15,3,5,8,142,gender
Ａ群溶血性レンサ球菌咽頭炎,2003,15,2003-W15,40,40,80,142,gender
感染性胃腸炎,2003,15,2003-W15,319,311,630,142,gender
水痘,2003,15,2003-W15,82,72,154,142,gender
手足口病,2003,15,2003-W15,6,14,20,142,gender
突発性発しん,2003,15,2003-W15,38,39,77,142,gender
ヘルパンギーナ,2003,15,2003-W15,1,5,6,142,gender
流行性耳下腺炎,2003,15,2003-W15,22,9,31,142,gender
川崎病,2003,15,2003-W15,1,0,1,142,gender
インフルエンザ,2008,42,2008-W42,5,9,14,285,gender
RSウイルス感染症,2008,42,2008-W42,53,43,96,147,gender
咽頭結膜熱,2008,42,2008-W42,11,7,18,147,gender
Ａ群溶血性レンサ球菌咽頭炎,2008,42,2008-W42,85,70,155,147,gender
感染性胃腸炎,2008,42,2008-W42,268,247,515,147,gender
水痘,2008,42,2008-W42,46,42,88,147,gender
手足口病,2008,42,2008-W42,66,75,141,147,gender
突発性発しん,2008,42,2008-W42,54,42,96,147,gender
ヘルパンギーナ,2008,42,2008-W42,17,12,29,147,gender
流行性耳下腺炎,2008,42,2008-W42,60,44,104,147,gender
川崎病,2008,42,2008-W42,0,0,0,147,gender
インフルエンザ,2005,12,2005-W12,587,591,1178,178,gender
RSウイルス感染症,2005,12,2005-W12,4,3,7,142,gender
咽頭結膜熱,2005,12,2005-W12,9,6,15,142,gender
Ａ群溶血性レンサ球菌咽頭炎,2005,12,2005-W12,63,46,109,142,gender
感染性胃腸炎,2005,12,2005-W12,373,323,696,142,gender
水痘,2005,12,2005-W12,76,73,149,142,gender
手足口病,2005,12,2005-W12,7,5,12,142,gender
突発性発しん,2005,12,2005-W12,33,28,61,142,gender
ヘルパンギーナ,2005,12,2005-W12,1,1,2,142,gender
流行性耳下腺炎,2005,12,2005-W12,48,42,90,142,gender
川崎病,2005,12,2005-W12,1,0,1,142,gender
インフルエンザ,2013,1,2013-W01,552,575,1127,364,gender
RSウイルス感染症,2013,1,2013-W01,23,21,44,219,gender
咽頭結膜熱,2013,1,2013-W01,21,15,36,219,gender
Ａ群溶血性レンサ球菌咽頭炎,2013,1,2013-W01,54,57,111,219,gender
感染性胃腸炎,2013,1,2013-W01,364,365,729,219,gender
水痘,2013,1,2013-W01,120,90,210,219,gender
手足口病,2013,1,2013-W01,7,10,17,219,gender
突発性発しん,2013,1,2013-W01,9,11,20,219,gender
ヘルパンギーナ,2013,1,2013-W01,2,0,2,219,gender
流行性耳下腺炎,2013,1,2013-W01,9,10,19,219,gender
川崎病,2013,1,2013-W01,2,0,2,219,gender
インフルエンザ,2016,48,2016-W48,589,571,1160,417,gender
RSウイルス感染症,2016,48,2016-W48,44,32,76,263,gender
咽頭結膜熱,2016,48,2016-W48,62,46,108,263,gender
Ａ群溶血性レンサ球菌咽頭炎,2016,48,2016-W48,305,271,576,263,gender
感染性胃腸炎,2016,48,2016-W48,3578,3419,6997,263,gender
水痘,2016,48,2016-W48,101,105,206,263,gender
手足口病,2016,48,2016-W48,83,66,149,263,gender
突発性発しん,2016,48,2016-W48,76,71,147,263,gender
ヘルパンギーナ,2016,48,2016-W48,13,16,29,263,gender
流行性耳下腺炎,2016,48,2016-W48,100,79,179,263,gender
川崎病,2016,48,2016-W48,1,1,2,263,gender
インフルエンザ,2017,26,2017-W26,8,9,17,415,gender
RSウイルス感染症,2017,26,2017-W26,41,35,76,262,gender
咽頭結膜熱,2017,26,2017-W26,147,141,288,262,gender
Ａ群溶血性レンサ球菌咽頭炎,2017,26,2017-W26,445,381,826,262,gender
感染性胃腸炎,2017,26,2017-W26,890,743,1633,262,gender
水痘,2017,26,2017-W26,81,51,132,262,gender
手足口病,2017,26,2017-W26,324,296,620,262,gender
突発性発しん,2017,26,2017-W26,89,87,176,262,gender
ヘルパンギーナ,2017,26,2017-W26,76,55,131,262,gender
流行性耳下腺炎,2017,26,2017-W26,38,44,82,262,gender
川崎病,2017,26,2017-W26,2,2,4,262,gender
インフルエンザ,2016,2,2016-W02,830,743,1573,416,gender
RSウイルス感染症,2016,2,2016-W02,50,38,88,262,gender
咽頭結膜熱,2016,2,2016-W02,26,25,51,262,gender
Ａ群溶血性レンサ球菌咽頭炎,2016,2,2016-W02,361,255,616,262,gender
感染性胃腸炎,2016,2,2016-W02,1168,1085,2253,262,gender
水痘,2016,2,2016-W02,85,57,142,262,gender
手足口病,2016,2,2016-W02,11,5,16,262,gender
突発性発しん,2016,2,2016-W02,72,61,133,262,gender
ヘルパンギーナ,2016,2,2016-W02,5,0,5,262,gender
流行性耳下腺炎,2016,2,2016-W02,98,94,192,262,gender
川崎病,2016,2,2016-W02,0,1,1,262,gender
インフルエンザ,2016,47,2016-W47,383,345,728,416,gender
RSウイルス感染症,2016,47,2016-W47,44,41,85,263,gender
咽頭結膜熱,2016,47,2016-W47,61,49,110,263,gender
Ａ群溶血性レンサ球菌咽頭炎,2016,47,2016-W47,288,244,532,263,gender
感染性胃腸炎,2016,47,2016-W47,2685,2469,5154,263,gender
水痘,2016,47,2016-W47,75,63,138,263,gender
手足口病,2016,47,2016-W47,95,59,154,263,gender
突発性発しん,2016,47,2016-W47,58,54,112,263,gender
ヘルパンギーナ,2016,47,2016-W47,16,13,29,263,gender
流行性耳下腺炎,2016,47,2016-W47,82,76,158,263,gender
川崎病,2016,47,2016-W47,0,0,0,263,gender
インフルエンザ,2014,34,2014-W34,1,2,3,398,gender
RSウイルス感染症,2014,34,2014-W34,36,24,60,251,gender
咽頭結膜熱,2014,34,2014-W34,57,36,93,251,gender
Ａ群溶血性レンサ球菌咽頭炎,2014,34,2014-W34,105,71,176,251,gender
感染性胃腸炎,2014,34,2014-W34,393,355,748,251,gender
水痘,2014,34,2014-W34,60,42,102,251,gender
手足口病,2014,34,2014-W34,122,93,215,251,gender
突発性発しん,2014,34,2014-W34,82,83,165,251,gender
ヘルパンギーナ,2014,34,2014-W34,266,264,530,251,gender
流行性耳下腺炎,2014,34,2014-W34,42,43,85,251,gender
川崎病,2014,34,2014-W34,0,1,1,251,gender
インフルエンザ,2017,29,2017-W29,22,16,38,414,gender
RSウイルス感染症,2017,29,2017-W29,123,100,223,261,gender
咽頭結膜熱,2017,29,2017-W29,139,106,245,261,gender
Ａ群溶血性レンサ球菌咽頭炎,2017,29,2017-W29,252,232,484,261,gender
感染性胃腸炎,2017,29,2017-W29,573,507,1080,261,gender
水痘,2017,29,2017-W29,43,31,74,261,gender
手足口病,2017,29,2017-W29,1205,1096,2301,261,gender
突発性発しん,2017,29,2017-W29,72,84,156,261,gender
ヘルパンギーナ,2017,29,2017-W29,250,266,516,261,gender
流行性耳下腺炎,2017,29,2017-W29,46,40,86,261,gender
川崎病,2017,29,2017-W29,1,0,1,261,gender
インフルエンザ,2009,23,2009-W23,27,15,42,288,gender
RSウイルス感染症,2009,23,2009-W23,3,1,4,149,gender
咽頭結膜熱,2009,23,2009-W23,29,22,51,149,gender
Ａ群溶血性レンサ球菌咽頭炎,2009,23,2009-W23,155,124,279,149,gender
感染性胃腸炎,2009,23,2009-W23,396,347,743,149,gender
水痘,2009,23,2009-W23,66,80,146,149,gender
手足口病,2009,23,2009-W23,15,14,29,149,gender
突発性発しん,2009,23,2009-W23,48,52,100,149,gender
ヘルパンギーナ,2009,23,2009-W23,5,6,11,149,gender
流行性耳下腺炎,2009,23,2009-W23,71,57,128,149,gender
川崎病,2009,23,2009-W23,2,0,2,149,gender
インフルエンザ,2020,15,2020-W15,6,8,14,409,gender
RSウイルス感染症,2020,15,2020-W15,6,3,9,259,gender
咽頭結膜熱,2020,15,2020-W15,12,11,23,259,gender
Ａ群溶血性レンサ球菌咽頭炎,2020,15,2020-W15,114,119,233,259,gender
感染性胃腸炎,2020,15,2020-W15,201,210,411,259,gender
水痘,2020,15,2020-W15,18,20,38,259,gender
手足口病,2020,15,2020-W15,6,1,7,259,gender
突発性発しん,2020,15,2020-W15,34,63,97,259,gender
ヘルパンギーナ,2020,15,2020-W15,3,4,7,259,gender
流行性耳下腺炎,2020,15,2020-W15,7,3,10,259,gender
川崎病,2020,15,2020-W15,2,4,6,259,gender
インフルエンザ,2010,40,2010-W40,21,20,41,279,gender
RSウイルス感染症,2010,40,2010-W40,18,24,42,144,gender
咽頭結膜熱,2010,40,2010-W40,13,9,22,144,gender
Ａ群溶血性レンサ球菌咽頭炎,2010,40,2010-W40,81,75,156,144,gender
感染性胃腸炎,2010,40,2010-W40,332,274,606,144,gender
水痘,2010,40,2010-W40,49,28,77,144,gender
手足口病,2010,40,2010-W40,39,33,72,144,gender
突発性発しん,2010,40,2010-W40,49,42,91,144,gender
ヘルパンギーナ,2010,40,2010-W40,12,16,28,144,gender
流行性耳下腺炎,2010,40,2010-W40,47,39,86,144,gender
川崎病,2010,40,2010-W40,1,0,1,144,gender
インフルエンザ,2012,33,2012-W33,3,1,4,362,gender
RSウイルス感染症,2012,33,2012-W33,63,43,106,219,gender
咽頭結膜熱,2012,33,2012-W33,46,34,80,219,gender
Ａ群溶血性レンサ球菌咽頭炎,2012,33,2012-W33,69,71,140,219,gender
感染性胃腸炎,2012,33,2012-W33,282,241,523,219,gender
水痘,2012,33,2012-W33,37,26,63,219,gender
手足口病,2012,33,2012-W33,64,57,121,219,gender
突発性発しん,2012,33,2012-W33,43,48,91,219,gender
ヘルパンギーナ,2012,33,2012-W33,152,126,278,219,gender
流行性耳下腺炎,2012,33,2012-W33,19,20,39,219,gender
川崎病,2012,33,2012-W33,1,0,1,219,gender
インフルエンザ,2001,5,2001-W05,115,82,197,178,gender
RSウイルス感染症,2001,5,2001-W05,0,0,0,142,gender
咽頭結膜熱,2001,5,2001-W05,6,4,10,142,gender
Ａ群溶血性レンサ球菌咽頭炎,2001,5,2001-W05,51,51,102,142,gender
感染性胃腸炎,2001,5,2001-W05,598,569,1167,142,gender
水痘,2001,5,2001-W05,84,77,161,142,gender
手足口病,2001,5,2001-W05,6,5,11,142,gender
突発性発しん,2001,5,2001-W05,28,35,63,142,gender
ヘルパンギーナ,2001,5,2001-W05,2,3,5,142,gender
流行性耳下腺炎,2001,5,2001-W05,76,73,149,142,gender
川崎病,2001,5,2001-W05,1,1,2,142,gender
インフルエンザ,2000,39,2000-W39,0,0,0,178,gender
RSウイルス感染症,2000,39,2000-W39,0,0,0,142,gender
咽頭結膜熱,2000,39,2000-W39,9,6,15,142,gender
Ａ群溶血性レンサ球菌咽頭炎,2000,39,2000-W39,20,13,33,142,gender
感染性胃腸炎,2000,39,2000-W39,122,108,230,142,gender
水痘,2000,39,2000-W39,22,24,46,142,gender
手足口病,2000,39,2000-W39,105,74,179,142,gender
突発性発しん,2000,39,2000-W39,39,33,72,142,gender
ヘルパンギーナ,2000,39,2000-W39,18,25,43,142,gender
流行性耳下腺炎,2000,39,2000-W39,72,62,134,142,gender
川崎病,2000,39,2000-W39,0,0,0,142,gender
インフルエンザ,2021,45,2021-W45,0,0,0,409,gender
RSウイルス感染症,2021,45,2021-W45,15,6,21,257,gender
咽頭結膜熱,2021,45,2021-W45,23,8,31,257,gender
Ａ群溶血性レンサ球菌咽頭炎,2021,45,2021-W45,39,39,78,257,gender
感染性胃腸炎,2021,45,2021-W45,517,436,953,257,gender
水痘,2021,45,2021-W45,10,7,17,257,gender
手足口病,2021,45,2021-W45,92,89,181,257,gender
突発性発しん,2021,45,2021-W45,48,50,98,257,gender
ヘルパンギーナ,2021,45,2021-W45,73,63,136,257,gender
流行性耳下腺炎,2021,45,2021-W45,11,7,18,257,gender
川崎病,2021,45,2021-W45,1,0,1,257,gender
インフルエンザ,2011,10,2011-W10,3343,3387,6730,414,gender
RSウイルス感染症,2011,10,2011-W10,19,10,29,260,gender
咽頭結膜熱,2011,10,2011-W10,52,29,81,260,gender
Ａ群溶血性レンサ球菌咽頭炎,2011,10,2011-W10,349,375,724,260,gender
感染性胃腸炎,2011,10,2011-W10,1371,1255,2626,260,gender
水痘,2011,10,2011-W10,141,171,312,260,gender
手足口病,2011,10,2011-W10,8,5,13,260,gender
突発性発しん,2011,10,2011-W10,77,52,129,260,gender
ヘルパンギーナ,2011,10,2011-W10,1,4,5,260,gender
流行性耳下腺炎,2011,10,2011-W10,34,29,63,260,gender
川崎病,2011,10,2011-W10,3,0,3,260,gender
インフルエンザ,2004,9,2004-W09,264,288,552,178,gender
RSウイルス感染症,2004,9,2004-W09,7,4,11,142,gender
咽頭結膜熱,2004,9,2004-W09,11,3,14,142,gender
Ａ群溶血性レンサ球菌咽頭炎,2004,9,2004-W09,90,63,153,142,gender
感染性胃腸炎,2004,9,2004-W09,591,650,1241,142,gender
水痘,2004,9,2004-W09,91,70,161,142,gender
手足口病,2004,9,2004-W09,0,1,1,142,gender
突発性発しん,2004,9,2004-W09,39,32,71,142,gender
ヘルパンギーナ,2004,9,2004-W09,2,1,3,142,gender
流行性耳下腺炎,2004,9,2004-W09,14,11,25,142,gender
川崎病,2004,9,2004-W09,0,1,1,142,gender
インフルエンザ,2023,36,2023-W36,1360,1121,2481,417,gender
新型コロナウイルス感染症（COVID-19）,2023,36,2023-W36,3284,3540,6824,417,gender
RSウイルス感染症,2023,36,2023-W36,32,23,55,262,gender
咽頭結膜熱,2023,36,2023-W36,173,129,302,262,gender
Ａ群溶血性レンサ球菌咽頭炎,2023,36,2023-W36,241,200,441,262,gender
感染性胃腸炎,2023,36,2023-W36,536,428,964,262,gender
水痘,2023,36,2023-W36,13,16,29,262,gender
手足口病,2023,36,2023-W36,182,156,338,262,gender
突発性発しん,2023,36,2023-W36,39,41,80,262,gender
ヘルパンギーナ,2023,36,2023-W36,84,82,166,262,gender
流行性耳下腺炎,2023,36,2023-W36,8,5,13,262,gender
川崎病,2023,36,2023-W36,4,1,5,262,gender
インフルエンザ,2022,6,2022-W06,0,0,0,408,gender
RSウイルス感染症,2022,6,2022-W06,0,4,4,256,gender
咽頭結膜熱,2022,6,2022-W06,7,5,12,256,gender
Ａ群溶血性レンサ球菌咽頭炎,2022,6,2022-W06,12,9,21,256,gender
感染性胃腸炎,2022,6,2022-W06,656,609,1265,256,gender
水痘,2022,6,2022-W06,2,9,11,256,gender
手足口病,2022,6,2022-W06,11,14,25,256,gender
突発性発しん,2022,6,2022-W06,29,28,57,256,gender
ヘルパンギーナ,2022,6,2022-W06,0,1,1,256,gender
流行性耳下腺炎,2022,6,2022-W06,3,3,6,256,gender
川崎病,2022,6,2022-W06,1,1,2,256,gender
インフルエンザ,2003,24,2003-W24,1,0,1,178,gender
RSウイルス感染症,2003,24,2003-W24,0,0,0,142,gender
咽頭結膜熱,2003,24,2003-W24,31,15,46,142,gender
Ａ群溶血性レンサ球菌咽頭炎,2003,24,2003-W24,85,63,148,142,gender
感染性胃腸炎,2003,24,2003-W24,290,242,532,142,gender
水痘,2003,24,2003-W24,93,83,176,142,gender
手足口病,2003,24,2003-W24,105,81,186,142,gender
突発性発しん,2003,24,2003-W24,36,48,84,142,gender
ヘルパンギーナ,2003,24,2003-W24,53,35,88,142,gender
流行性耳下腺炎,2003,24,2003-W24,23,24,47,142,gender
川崎病,2003,24,2003-W24,0,1,1,142,gender
インフルエンザ,2007,50,2007-W50,1038,1014,2052,289,gender
RSウイルス感染症,2007,50,2007-W50,59,56,115,150,gender
咽頭結膜熱,2007,50,2007-W50,28,19,47,150,gender
Ａ群溶血性レンサ球菌咽頭炎,2007,50,2007-W50,155,124,279,150,gender
感染性胃腸炎,2007,50,2007-W50,1568,1542,3110,150,gender
水痘,2007,50,2007-W50,125,142,267,150,gender
手足口病,2007,50,2007-W50,19,16,35,150,gender
突発性発しん,2007,50,2007-W50,57,38,95,150,gender
ヘルパンギーナ,2007,50,2007-W50,5,8,13,150,gender
流行性耳下腺炎,2007,50,2007-W50,13,9,22,150,gender
川崎病,2007,50,2007-W50,4,0,4,150,gender
インフルエンザ,2005,23,2005-W23,2,4,6,178,gender
RSウイルス感染症,2005,23,2005-W23,2,3,5,142,gender
咽頭結膜熱,2005,23,2005-W23,50,42,92,142,gender
Ａ群溶血性レンサ球菌咽頭炎,2005,23,2005-W23,138,102,240,142,gender
感染性胃腸炎,2005,23,2005-W23,392,353,745,142,gender
水痘,2005,23,2005-W23,133,131,264,142,gender
手足口病,2005,23,2005-W23,53,36,89,142,gender
突発性発しん,2005,23,2005-W23,52,53,105,142,gender
ヘルパンギーナ,2005,23,2005-W23,129,111,240,142,gender
流行性耳下腺炎,2005,23,2005-W23,84,60,144,142,gender
川崎病,2005,23,2005-W23,0,0,0,142,gender
インフルエンザ,2017,17,2017-W17,614,671,1285,414,gender
RSウイルス感染症,2017,17,2017-W17,42,28,70,262,gender
咽頭結膜熱,2017,17,2017-W17,59,43,102,262,gender
Ａ群溶血性レンサ球菌咽頭炎,2017,17,2017-W17,367,304,671,262,gender
感染性胃腸炎,2017,17,2017-W17,1114,1003,2117,262,gender
水痘,2017,17,2017-W17,64,45,109,262,gender
手足口病,2017,17,2017-W17,23,19,42,262,gender
突発性発しん,2017,17,2017-W17,80,83,163,262,gender
ヘルパンギーナ,2017,17,2017-W17,3,2,5,262,gender
流行性耳下腺炎,2017,17,2017-W17,14,28,42,262,gender
川崎病,2017,17,2017-W17,2,1,3,262,gender
インフルエンザ,2018,34,2018-W34,2,2,4,399,gender
RSウイルス感染症,2018,34,2018-W34,182,196,378,248,gender
咽頭結膜熱,2018,34,2018-W34,25,34,59,248,gender
Ａ群溶血性レンサ球菌咽頭炎,2018,34,2018-W34,156,158,314,248,gender
感染性胃腸炎,2018,34,2018-W34,456,376,832,248,gender
水痘,2018,34,2018-W34,26,31,57,248,gender
手足口病,2018,34,2018-W34,106,95,201,248,gender
突発性発しん,2018,34,2018-W34,70,56,126,248,gender
ヘルパンギーナ,2018,34,2018-W34,204,204,408,248,gender
流行性耳下腺炎,2018,34,2018-W34,13,0,13,248,gender
川崎病,2018,34,2018-W34,6,1,7,248,gender
インフルエンザ,2001,18,2001-W18,6,8,14,178,gender
RSウイルス感染症,2001,18,2001-W18,0,0,0,142,gender
咽頭結膜熱,2001,18,2001-W18,3,2,5,142,gender
Ａ群溶血性レンサ球菌咽頭炎,2001,18,2001-W18,19,22,41,142,gender
感染性胃腸炎,2001,18,2001-W18,115,126,241,142,gender
水痘,2001,18,2001-W18,39,45,84,142,gender
手足口病,2001,18,2001-W18,4,3,7,142,gender
突発性発しん,2001,18,2001-W18,12,13,25,142,gender
ヘルパンギーナ,2001,18,2001-W18,3,1,4,142,gender
流行性耳下腺炎,2001,18,2001-W18,31,35,66,142,gender
川崎病,2001,18,2001-W18,0,0,0,142,gender
インフルエンザ,2010,31,2010-W31,7,7,14,282,gender
RSウイルス感染症,2010,31,2010-W31,12,6,18,146,gender
咽頭結膜熱,2010,31,2010-W31,14,16,30,146,gender
Ａ群溶血性レンサ球菌咽頭炎,2010,31,2010-W31,59,47,106,146,gender
感染性胃腸炎,2010,31,2010-W31,217,198,415,146,gender
水痘,2010,31,2010-W31,34,34,68,146,gender
手足口病,2010,31,2010-W31,196,186,382,146,gender
突発性発しん,2010,31,2010-W31,43,50,93,146,gender
ヘルパンギーナ,2010,31,2010-W31,230,240,470,146,gender
流行性耳下腺炎,2010,31,2010-W31,69,58,127,146,gender
川崎病,2010,31,2010-W31,2,1,3,146,gender
インフルエンザ,2012,42,2012-W42,10,9,19,414,gender
RSウイルス感染症,2012,42,2012-W42,162,135,297,259,gender
咽頭結膜熱,2012,42,2012-W42,47,37,84,259,gender
Ａ群溶血性レンサ球菌咽頭炎,2012,42,2012-W42,172,167,339,259,gender
感染性胃腸炎,2012,42,2012-W42,579,494,1073,259,gender
水痘,2012,42,2012-W42,48,55,103,259,gender
手足口病,2012,42,2012-W42,55,48,103,259,gender
突発性発しん,2012,42,2012-W42,90,82,172,259,gender
ヘルパンギーナ,2012,42,2012-W42,25,21,46,259,gender
流行性耳下腺炎,2012,42,2012-W42,29,22,51,259,gender
川崎病,2012,42,2012-W42,0,0,0,259,gender
インフルエンザ,2022,17,2022-W17,0,0,0,400,gender
RSウイルス感染症,2022,17,2022-W17,10,6,16,253,gender
咽頭結膜熱,2022,17,2022-W17,10,5,15,253,gender
Ａ群溶血性レンサ球菌咽頭炎,2022,17,2022-W17,15,11,26,253,gender
感染性胃腸炎,2022,17,2022-W17,631,498,1129,253,gender
水痘,2022,17,2022-W17,5,7,12,253,gender
手足口病,2022,17,2022-W17,15,10,25,253,gender
突発性発しん,2022,17,2022-W17,55,56,111,253,gender
ヘルパンギーナ,2022,17,2022-W17,0,1,1,253,gender
流行性耳下腺炎,2022,17,2022-W17,5,4,9,253,gender
川崎病,2022,17,2022-W17,0,0,0,253,gender
インフルエンザ,2015,3,2015-W03,4183,4015,8198,416,gender
RSウイルス感染症,2015,3,2015-W03,64,54,118,263,gender
咽頭結膜熱,2015,3,2015-W03,30,14,44,263,gender
Ａ群溶血性レンサ球菌咽頭炎,2015,3,2015-W03,279,214,493,263,gender
感染性胃腸炎,2015,3,2015-W03,1125,1099,2224,263,gender
水痘,2015,3,2015-W03,60,44,104,263,gender
手足口病,2015,3,2015-W03,13,13,26,263,gender
突発性発しん,2015,3,2015-W03,49,53,102,263,gender
ヘルパンギーナ,2015,3,2015-W03,1,1,2,263,gender
流行性耳下腺炎,2015,3,2015-W03,30,27,57,263,gender
川崎病,2015,3,2015-W03,4,0,4,263,gender
インフルエンザ,2009,52,2009-W52,1413,1446,2859,287,gender
RSウイルス感染症,2009,52,2009-W52,46,48,94,150,gender
咽頭結膜熱,2009,52,2009-W52,5,11,16,150,gender
Ａ群溶血性レンサ球菌咽頭炎,2009,52,2009-W52,85,89,174,150,gender
感染性胃腸炎,2009,52,2009-W52,836,795,1631,150,gender
水痘,2009,52,2009-W52,91,100,191,150,gender
手足口病,2009,52,2009-W52,24,19,43,150,gender
突発性発しん,2009,52,2009-W52,34,27,61,150,gender
ヘルパンギーナ,2009,52,2009-W52,15,18,33,150,gender
流行性耳下腺炎,2009,52,2009-W52,41,45,86,150,gender
川崎病,2009,52,2009-W52,1,1,2,150,gender
インフルエンザ,2016,36,2016-W36,22,9,31,415,gender
RSウイルス感染症,2016,36,2016-W36,242,207,449,262,gender
咽頭結膜熱,2016,36,2016-W36,46,48,94,262,gender
Ａ群溶血性レンサ球菌咽頭炎,2016,36,2016-W36,178,156,334,262,gender
感染性胃腸炎,2016,36,2016-W36,661,537,1198,262,gender
水痘,2016,36,2016-W36,35,25,60,262,gender
手足口病,2016,36,2016-W36,162,99,261,262,gender
突発性発しん,2016,36,2016-W36,91,84,175,262,gender
ヘルパンギーナ,2016,36,2016-W36,215,199,414,262,gender
流行性耳下腺炎,2016,36,2016-W36,72,76,148,262,gender
川崎病,2016,36,2016-W36,7,0,7,262,gender
インフルエンザ,2024,10,2024-W10,3044,2544,5588,416,gender
新型コロナウイルス感染症（COVID-19）,2024,10,2024-W10,849,918,1767,416,gender
RSウイルス感染症,2024,10,2024-W10,31,34,65,262,gender
咽頭結膜熱,2024,10,2024-W10,43,18,61,262,gender
Ａ群溶血性レンサ球菌咽頭炎,2024,10,2024-W10,484,395,879,262,gender
感染性胃腸炎,2024,10,2024-W10,763,645,1408,262,gender
水痘,2024,10,2024-W10,36,21,57,262,gender
手足口病,2024,10,2024-W10,0,1,1,262,gender
突発性発しん,2024,10,2024-W10,29,29,58,262,gender
ヘルパンギーナ,2024,10,2024-W10,3,0,3,262,gender
流行性耳下腺炎,2024,10,2024-W10,10,2,12,262,gender
川崎病,2024,10,2024-W10,1,0,1,262,gender
インフルエンザ,2014,45,2014-W45,90,74,164,413,gender
RSウイルス感染症,2014,45,2014-W45,142,126,268,262,gender
咽頭結膜熱,2014,45,2014-W45,57,65,122,262,gender
Ａ群溶血性レンサ球菌咽頭炎,2014,45,2014-W45,276,248,524,262,gender
感染性胃腸炎,2014,45,2014-W45,633,562,1195,262,gender
水痘,2014,45,2014-W45,134,95,229,262,gender
手足口病,2014,45,2014-W45,84,73,157,262,gender
突発性発しん,2014,45,2014-W45,87,84,171,262,gender
ヘルパンギーナ,2014,45,2014-W45,23,20,43,262,gender
流行性耳下腺炎,2014,45,2014-W45,37,22,59,262,gender
川崎病,2014,45,2014-W45,3,0,3,262,gender
インフルエンザ,2019,15,2019-W15,289,266,555,412,gender
RSウイルス感染症,2019,15,2019-W15,67,49,116,258,gender
咽頭結膜熱,2019,15,2019-W15,29,16,45,258,gender
Ａ群溶血性レンサ球菌咽頭炎,2019,15,2019-W15,305,251,556,258,gender
感染性胃腸炎,2019,15,2019-W15,989,963,1952,258,gender
水痘,2019,15,2019-W15,48,43,91,258,gender
手足口病,2019,15,2019-W15,8,4,12,258,gender
突発性発しん,2019,15,2019-W15,60,69,129,258,gender
ヘルパンギーナ,2019,15,2019-W15,2,3,5,258,gender
流行性耳下腺炎,2019,15,2019-W15,2,5,7,258,gender
川崎病,2019,15,2019-W15,2,1,3,258,gender
インフルエンザ,2015,15,2015-W15,219,198,417,411,gender
RSウイルス感染症,2015,15,2015-W15,13,18,31,263,gender
咽頭結膜熱,2015,15,2015-W15,28,18,46,263,gender
Ａ群溶血性レンサ球菌咽頭炎,2015,15,2015-W15,326,316,642,263,gender
感染性胃腸炎,2015,15,2015-W15,932,848,1780,263,gender
水痘,2015,15,2015-W15,66,63,129,263,gender
手足口病,2015,15,2015-W15,16,19,35,263,gender
突発性発しん,2015,15,2015-W15,89,78,167,263,gender
ヘルパンギーナ,2015,15,2015-W15,1,0,1,263,gender
流行性耳下腺炎,2015,15,2015-W15,29,32,61,263,gender
川崎病,2015,15,2015-W15,4,1,5,263,gender
インフルエンザ,2018,45,2018-W45,82,104,186,413,gender
RSウイルス感染症,2018,45,2018-W45,64,43,107,263,gender
咽頭結膜熱,2018,45,2018-W45,34,26,60,263,gender
Ａ群溶血性レンサ球菌咽頭炎,2018,45,2018-W45,379,321,700,263,gender
感染性胃腸炎,2018,45,2018-W45,927,864,1791,263,gender
水痘,2018,45,2018-W45,54,67,121,263,gender
手足口病,2018,45,2018-W45,170,131,301,263,gender
突発性発しん,2018,45,2018-W45,73,64,137,263,gender
ヘルパンギーナ,2018,45,2018-W45,15,16,31,263,gender
流行性耳下腺炎,2018,45,2018-W45,10,12,22,263,gender
川崎病,2018,45,2018-W45,2,1,3,263,gender
インフルエンザ,2007,21,2007-W21,18,19,37,284,gender
RSウイルス感染症,2007,21,2007-W21,2,1,3,149,gender
咽頭結膜熱,2007,21,2007-W21,51,48,99,149,gender
Ａ群溶血性レンサ球菌咽頭炎,2007,21,2007-W21,239,176,415,149,gender
感染性胃腸炎,2007,21,2007-W21,508,422,930,149,gender
水痘,2007,21,2007-W21,150,133,283,149,gender
手足口病,2007,21,2007-W21,9,12,21,149,gender
突発性発しん,2007,21,2007-W21,58,45,103,149,gender
ヘルパンギーナ,2007,21,2007-W21,25,18,43,149,gender
流行性耳下腺炎,2007,21,2007-W21,20,17,37,149,gender
川崎病,2007,21,2007-W21,0,3,3,149,gender
インフルエンザ,2005,52,2005-W52,162,159,321,178,gender
RSウイルス感染症,2005,52,2005-W52,11,13,24,142,gender
咽頭結膜熱,2005,52,2005-W52,32,26,58,142,gender
Ａ群溶血性レンサ球菌咽頭炎,2005,52,2005-W52,75,70,145,142,gender
感染性胃腸炎,2005,52,2005-W52,917,877,1794,142,gender
水痘,2005,52,2005-W52,100,74,174,142,gender
手足口病,2005,52,2005-W52,4,0,4,142,gender
突発性発しん,2005,52,2005-W52,19,22,41,142,gender
ヘルパンギーナ,2005,52,2005-W52,6,1,7,142,gender
流行性耳下腺炎,2005,52,2005-W52,51,51,102,142,gender
川崎病,2005,52,2005-W52,1,0,1,142,gender
インフルエンザ,2007,8,2007-W08,2211,2045,4256,280,gender
RSウイルス感染症,2007,8,2007-W08,8,9,17,141,gender
咽頭結膜熱,2007,8,2007-W08,17,18,35,141,gender
Ａ群溶血性レンサ球菌咽頭炎,2007,8,2007-W08,141,127,268,141,gender
感染性胃腸炎,2007,8,2007-W08,424,358,782,141,gender
水痘,2007,8,2007-W08,117,99,216,141,gender
手足口病,2007,8,2007-W08,5,8,13,141,gender
突発性発しん,2007,8,2007-W08,37,32,69,141,gender
ヘルパンギーナ,2007,8,2007-W08,0,1,1,141,gender
流行性耳下腺炎,2007,8,2007-W08,25,18,43,141,gender
川崎病,2007,8,2007-W08,1,3,4,141,gender
インフルエンザ,2001,26,2001-W26,0,0,0,178,gender
RSウイルス感染症,2001,26,2001-W26,0,0,0,142,gender
咽頭結膜熱,2001,26,2001-W26,8,6,14,142,gender
Ａ群溶血性レンサ球菌咽頭炎,2001,26,2001-W26,39,28,67,142,gender
感染性胃腸炎,2001,26,2001-W26,162,148,310,142,gender
水痘,2001,26,2001-W26,79,60,139,142,gender
手足口病,2001,26,2001-W26,82,61,143,142,gender
突発性発しん,2001,26,2001-W26,49,38,87,142,gender
ヘルパンギーナ,2001,26,2001-W26,329,347,676,142,gender
流行性耳下腺炎,2001,26,2001-W26,55,70,125,142,gender
川崎病,2001,26,2001-W26,0,1,1,142,gender
インフルエンザ,2002,4,2002-W04,265,230,495,178,gender
RSウイルス感染症,2002,4,2002-W04,0,0,0,142,gender
咽頭結膜熱,2002,4,2002-W04,1,2,3,142,gender
Ａ群溶血性レンサ球菌咽頭炎,2002,4,2002-W04,66,49,115,142,gender
感染性胃腸炎,2002,4,2002-W04,641,671,1312,142,gender
水痘,2002,4,2002-W04,99,83,182,142,gender
手足口病,2002,4,2002-W04,5,4,9,142,gender
突発性発しん,2002,4,2002-W04,36,32,68,142,gender
ヘルパンギーナ,2002,4,2002-W04,5,3,8,142,gender
流行性耳下腺炎,2002,4,2002-W04,36,37,73,142,gender
川崎病,2002,4,2002-W04,2,0,2,142,gender
インフルエンザ,2022,29,2022-W29,3,3,6,410,gender
RSウイルス感染症,2022,29,2022-W29,221,178,399,257,gender
咽頭結膜熱,2022,29,2022-W29,22,14,36,257,gender
Ａ群溶血性レンサ球菌咽頭炎,2022,29,2022-W29,21,16,37,257,gender
感染性胃腸炎,2022,29,2022-W29,432,363,795,257,gender
水痘,2022,29,2022-W29,14,13,27,257,gender
手足口病,2022,29,2022-W29,415,381,796,257,gender
突発性発しん,2022,29,2022-W29,27,32,59,257,gender
ヘルパンギーナ,2022,29,2022-W29,133,121,254,257,gender
流行性耳下腺炎,2022,29,2022-W29,3,3,6,257,gender
川崎病,2022,29,2022-W29,2,1,3,257,gender
インフルエンザ,2000,48,2000-W48,12,11,23,178,gender
RSウイルス感染症,2000,48,2000-W48,0,0,0,142,gender
咽頭結膜熱,2000,48,2000-W48,5,3,8,142,gender
Ａ群溶血性レンサ球菌咽頭炎,2000,48,2000-W48,49,34,83,142,gender
感染性胃腸炎,2000,48,2000-W48,437,403,840,142,gender
水痘,2000,48,2000-W48,87,83,170,142,gender
手足口病,2000,48,2000-W48,28,31,59,142,gender
突発性発しん,2000,48,2000-W48,29,33,62,142,gender
ヘルパンギーナ,2000,48,2000-W48,5,4,9,142,gender
流行性耳下腺炎,2000,48,2000-W48,78,82,160,142,gender
川崎病,2000,48,2000-W48,0,3,3,142,gender
インフルエンザ,2021,34,2021-W34,0,0,0,407,gender
RSウイルス感染症,2021,34,2021-W34,192,145,337,258,gender
咽頭結膜熱,2021,34,2021-W34,12,8,20,258,gender
Ａ群溶血性レンサ球菌咽頭炎,2021,34,2021-W34,27,16,43,258,gender
感染性胃腸炎,2021,34,2021-W34,265,255,520,258,gender
水痘,2021,34,2021-W34,12,7,19,258,gender
手足口病,2021,34,2021-W34,13,9,22,258,gender
突発性発しん,2021,34,2021-W34,35,42,77,258,gender
ヘルパンギーナ,2021,34,2021-W34,32,25,57,258,gender
流行性耳下腺炎,2021,34,2021-W34,11,3,14,258,gender
川崎病,2021,34,2021-W34,1,2,3,258,gender
インフルエンザ,2013,12,2013-W12,434,436,870,418,gender
RSウイルス感染症,2013,12,2013-W12,26,13,39,264,gender
咽頭結膜熱,2013,12,2013-W12,35,15,50,264,gender
Ａ群溶血性レンサ球菌咽頭炎,2013,12,2013-W12,351,288,639,264,gender
感染性胃腸炎,2013,12,2013-W12,1463,1401,2864,264,gender
水痘,2013,12,2013-W12,111,113,224,264,gender
手足口病,2013,12,2013-W12,12,13,25,264,gender
突発性発しん,2013,12,2013-W12,72,77,149,264,gender
ヘルパンギーナ,2013,12,2013-W12,3,4,7,264,gender
流行性耳下腺炎,2013,12,2013-W12,23,32,55,264,gender
川崎病,2013,12,2013-W12,1,2,3,264,gender
インフルエンザ,2023,47,2023-W47,3569,3231,6800,414,gender
新型コロナウイルス感染症（COVID-19）,2023,47,2023-W47,328,297,625,414,gender
RSウイルス感染症,2023,47,2023-W47,9,1,10,260,gender
咽頭結膜熱,2023,47,2023-W47,475,443,918,260,gender
Ａ群溶血性レンサ球菌咽頭炎,2023,47,2023-W47,648,629,1277,260,gender
感染性胃腸炎,2023,47,2023-W47,788,632,1420,260,gender
水痘,2023,47,2023-W47,19,16,35,260,gender
手足口病,2023,47,2023-W47,74,88,162,260,gender
突発性発しん,2023,47,2023-W47,24,24,48,260,gender
ヘルパンギーナ,2023,47,2023-W47,10,5,15,260,gender
流行性耳下腺炎,2023,47,2023-W47,5,2,7,260,gender
川崎病,2023,47,2023-W47,1,4,5,260,gender
インフルエンザ,2021,7,2021-W07,1,1,2,407,gender
RSウイルス感染症,2021,7,2021-W07,6,10,16,254,gender
咽頭結膜熱,2021,7,2021-W07,10,12,22,254,gender
Ａ群溶血性レンサ球菌咽頭炎,2021,7,2021-W07,43,47,90,254,gender
感染性胃腸炎,2021,7,2021-W07,384,337,721,254,gender
水痘,2021,7,2021-W07,11,6,17,254,gender
手足口病,2021,7,2021-W07,4,2,6,254,gender
突発性発しん,2021,7,2021-W07,52,55,107,254,gender
ヘルパンギーナ,2021,7,2021-W07,3,2,5,254,gender
流行性耳下腺炎,2021,7,2021-W07,5,3,8,254,gender
川崎病,2021,7,2021-W07,3,2,5,254,gender
インフルエンザ,2015,38,2015-W38,15,10,25,399,gender
RSウイルス感染症,2015,38,2015-W38,179,171,350,252,gender
咽頭結膜熱,2015,38,2015-W38,43,20,63,252,gender
Ａ群溶血性レンサ球菌咽頭炎,2015,38,2015-W38,216,182,398,252,gender
感染性胃腸炎,2015,38,2015-W38,515,457,972,252,gender
水痘,2015,38,2015-W38,52,45,97,252,gender
手足口病,2015,38,2015-W38,631,502,1133,252,gender
突発性発しん,2015,38,2015-W38,96,81,177,252,gender
ヘルパンギーナ,2015,38,2015-W38,128,111,239,252,gender
流行性耳下腺炎,2015,38,2015-W38,42,31,73,252,gender
川崎病,2015,38,2015-W38,1,0,1,252,gender
インフルエンザ,2009,41,2009-W41,2918,2487,5405,286,gender
RSウイルス感染症,2009,41,2009-W41,5,9,14,148,gender
咽頭結膜熱,2009,41,2009-W41,5,1,6,148,gender
Ａ群溶血性レンサ球菌咽頭炎,2009,41,2009-W41,59,46,105,148,gender
感染性胃腸炎,2009,41,2009-W41,164,148,312,148,gender
水痘,2009,41,2009-W41,27,23,50,148,gender
手足口病,2009,41,2009-W41,64,42,106,148,gender
突発性発しん,2009,41,2009-W41,50,33,83,148,gender
ヘルパンギーナ,2009,41,2009-W41,18,28,46,148,gender
流行性耳下腺炎,2009,41,2009-W41,44,41,85,148,gender
川崎病,2009,41,2009-W41,1,1,2,148,gender
インフルエンザ,2004,11,2004-W11,78,60,138,178,gender
RSウイルス感染症,2004,11,2004-W11,5,4,9,142,gender
咽頭結膜熱,2004,11,2004-W11,9,7,16,142,gender
Ａ群溶血性レンサ球菌咽頭炎,2004,11,2004-W11,108,101,209,142,gender
感染性胃腸炎,2004,11,2004-W11,714,617,1331,142,gender
水痘,2004,11,2004-W11,67,69,136,142,gender
手足口病,2004,11,2004-W11,2,2,4,142,gender
突発性発しん,2004,11,2004-W11,39,31,70,142,gender
ヘルパンギーナ,2004,11,2004-W11,4,1,5,142,gender
流行性耳下腺炎,2004,11,2004-W11,18,9,27,142,gender
川崎病,2004,11,2004-W11,0,2,2,142,gender
インフルエンザ,2003,2,2003-W02,850,929,1779,178,gender
RSウイルス感染症,2003,2,2003-W02,0,0,0,142,gender
咽頭結膜熱,2003,2,2003-W02,11,13,24,142,gender
Ａ群溶血性レンサ球菌咽頭炎,2003,2,2003-W02,32,19,51,142,gender
感染性胃腸炎,2003,2,2003-W02,373,371,744,142,gender
水痘,2003,2,2003-W02,162,141,303,142,gender
手足口病,2003,2,2003-W02,6,2,8,142,gender
突発性発しん,2003,2,2003-W02,27,22,49,142,gender
ヘルパンギーナ,2003,2,2003-W02,1,2,3,142,gender
流行性耳下腺炎,2003,2,2003-W02,24,21,45,142,gender
川崎病,2003,2,2003-W02,1,0,1,142,gender
インフルエンザ,2020,1,2020-W01,887,900,1787,312,gender
RSウイルス感染症,2020,1,2020-W01,8,5,13,190,gender
咽頭結膜熱,2020,1,2020-W01,9,8,17,190,gender
Ａ群溶血性レンサ球菌咽頭炎,2020,1,2020-W01,45,41,86,190,gender
感染性胃腸炎,2020,1,2020-W01,135,121,256,190,gender
水痘,2020,1,2020-W01,15,26,41,190,gender
手足口病,2020,1,2020-W01,14,13,27,190,gender
突発性発しん,2020,1,2020-W01,3,5,8,190,gender
ヘルパンギーナ,2020,1,2020-W01,1,0,1,190,gender
流行性耳下腺炎,2020,1,2020-W01,4,1,5,190,gender
川崎病,2020,1,2020-W01,0,0,0,190,gender
インフルエンザ,2016,25,2016-W25,3,5,8,411,gender
RSウイルス感染症,2016,25,2016-W25,17,15,32,258,gender
咽頭結膜熱,2016,25,2016-W25,124,88,212,258,gender
Ａ群溶血性レンサ球菌咽頭炎,2016,25,2016-W25,422,358,780,258,gender
感染性胃腸炎,2016,25,2016-W25,857,718,1575,258,gender
水痘,2016,25,2016-W25,64,70,134,258,gender
手足口病,2016,25,2016-W25,80,55,135,258,gender
突発性発しん,2016,25,2016-W25,108,112,220,258,gender
ヘルパンギーナ,2016,25,2016-W25,206,214,420,258,gender
流行性耳下腺炎,2016,25,2016-W25,94,78,172,258,gender
川崎病,2016,25,2016-W25,1,1,2,258,gender
インフルエンザ,2012,51,2012-W51,466,500,966,417,gender
RSウイルス感染症,2012,51,2012-W51,93,88,181,263,gender
咽頭結膜熱,2012,51,2012-W51,83,65,148,263,gender
Ａ群溶血性レンサ球菌咽頭炎,2012,51,2012-W51,366,361,727,263,gender
感染性胃腸炎,2012,51,2012-W51,3084,2905,5989,263,gender
水痘,2012,51,2012-W51,218,189,407,263,gender
手足口病,2012,51,2012-W51,43,42,85,263,gender
突発性発しん,2012,51,2012-W51,70,69,139,263,gender
ヘルパンギーナ,2012,51,2012-W51,10,5,15,263,gender
流行性耳下腺炎,2012,51,2012-W51,18,22,40,263,gender
川崎病,2012,51,2012-W51,1,2,3,263,gender
インフルエンザ,2010,22,2010-W22,14,10,24,287,gender
RSウイルス感染症,2010,22,2010-W22,2,2,4,149,gender
咽頭結膜熱,2010,22,2010-W22,36,18,54,149,gender
Ａ群溶血性レンサ球菌咽頭炎,2010,22,2010-W22,170,165,335,149,gender
感染性胃腸炎,2010,22,2010-W22,593,499,1092,149,gender
水痘,2010,22,2010-W22,146,120,266,149,gender
手足口病,2010,22,2010-W22,67,51,118,149,gender
突発性発しん,2010,22,2010-W22,40,34,74,149,gender
ヘルパンギーナ,2010,22,2010-W22,79,71,150,149,gender
流行性耳下腺炎,2010,22,2010-W22,76,71,147,149,gender
川崎病,2010,22,2010-W22,2,0,2,149,gender
インフルエンザ,2002,16,2002-W16,20,10,30,178,gender
RSウイルス感染症,2002,16,2002-W16,0,0,0,142,gender
咽頭結膜熱,2002,16,2002-W16,1,1,2,142,gender
Ａ群溶血性レンサ球菌咽頭炎,2002,16,2002-W16,53,65,118,142,gender
感染性胃腸炎,2002,16,2002-W16,301,251,552,142,gender
水痘,2002,16,2002-W16,67,67,134,142,gender
手足口病,2002,16,2002-W16,15,7,22,142,gender
突発性発しん,2002,16,2002-W16,61,52,113,142,gender
ヘルパンギーナ,2002,16,2002-W16,7,3,10,142,gender
流行性耳下腺炎,2002,16,2002-W16,49,40,89,142,gender
川崎病,2002,16,2002-W16,0,1,1,142,gender
インフルエンザ,2021,19,2021-W19,0,0,0,403,gender
RSウイルス感染症,2021,19,2021-W19,50,45,95,257,gender
咽頭結膜熱,2021,19,2021-W19,28,21,49,257,gender
Ａ群溶血性レンサ球菌咽頭炎,2021,19,2021-W19,37,40,77,257,gender
感染性胃腸炎,2021,19,2021-W19,603,544,1147,257,gender
水痘,2021,19,2021-W19,17,11,28,257,gender
手足口病,2021,19,2021-W19,8,8,16,257,gender
突発性発しん,2021,19,2021-W19,65,57,122,257,gender
ヘルパンギーナ,2021,19,2021-W19,4,2,6,257,gender
流行性耳下腺炎,2021,19,2021-W19,9,9,18,257,gender
川崎病,2021,19,2021-W19,1,3,4,257,gender
インフルエンザ,2003,46,2003-W46,1,0,1,178,gender
RSウイルス感染症,2003,46,2003-W46,0,0,0,142,gender
咽頭結膜熱,2003,46,2003-W46,8,9,17,142,gender
Ａ群溶血性レンサ球菌咽頭炎,2003,46,2003-W46,59,29,88,142,gender
感染性胃腸炎,2003,46,2003-W46,443,439,882,142,gender
水痘,2003,46,2003-W46,97,58,155,142,gender
手足口病,2003,46,2003-W46,15,11,26,142,gender
突発性発しん,2003,46,2003-W46,23,39,62,142,gender
ヘルパンギーナ,2003,46,2003-W46,7,10,17,142,gender
流行性耳下腺炎,2003,46,2003-W46,16,15,31,142,gender
川崎病,2003,46,2003-W46,0,0,0,142,gender
インフルエンザ,2014,5,2014-W05,8722,8369,17091,415,gender
RSウイルス感染症,2014,5,2014-W05,48,29,77,261,gender
咽頭結膜熱,2014,5,2014-W05,43,35,78,261,gender
Ａ群溶血性レンサ球菌咽頭炎,2014,5,2014-W05,282,268,550,261,gender
感染性胃腸炎,2014,5,2014-W05,1439,1338,2777,261,gender
水痘,2014,5,2014-W05,113,88,201,261,gender
手足口病,2014,5,2014-W05,11,9,20,261,gender
突発性発しん,2014,5,2014-W05,67,54,121,261,gender
ヘルパンギーナ,2014,5,2014-W05,0,0,0,261,gender
流行性耳下腺炎,2014,5,2014-W05,19,17,36,261,gender
川崎病,2014,5,2014-W05,0,3,3,261,gender
インフルエンザ,2011,9,2011-W09,2825,2777,5602,417,gender
RSウイルス感染症,2011,9,2011-W09,20,22,42,262,gender
咽頭結膜熱,2011,9,2011-W09,59,41,100,262,gender
Ａ群溶血性レンサ球菌咽頭炎,2011,9,2011-W09,377,350,727,262,gender
感染性胃腸炎,2011,9,2011-W09,1365,1221,2586,262,gender
水痘,2011,9,2011-W09,159,132,291,262,gender
手足口病,2011,9,2011-W09,9,6,15,262,gender
突発性発しん,2011,9,2011-W09,69,71,140,262,gender
ヘルパンギーナ,2011,9,2011-W09,2,1,3,262,gender
流行性耳下腺炎,2011,9,2011-W09,43,31,74,262,gender
川崎病,2011,9,2011-W09,1,0,1,262,gender
インフルエンザ,2020,49,2020-W49,3,0,3,408,gender
RSウイルス感染症,2020,49,2020-W49,0,0,0,257,gender
咽頭結膜熱,2020,49,2020-W49,25,17,42,257,gender
Ａ群溶血性レンサ球菌咽頭炎,2020,49,2020-W49,67,67,134,257,gender
感染性胃腸炎,2020,49,2020-W49,333,284,617,257,gender
水痘,2020,49,2020-W49,31,17,48,257,gender
手足口病,2020,49,2020-W49,5,3,8,257,gender
突発性発しん,2020,49,2020-W49,48,49,97,257,gender
ヘルパンギーナ,2020,49,2020-W49,9,6,15,257,gender
流行性耳下腺炎,2020,49,2020-W49,9,5,14,257,gender
川崎病,2020,49,2020-W49,1,1,2,257,gender
インフルエンザ,2001,35,2001-W35,0,0,0,178,gender
RSウイルス感染症,2001,35,2001-W35,0,0,0,142,gender
咽頭結膜熱,2001,35,2001-W35,12,6,18,142,gender
Ａ群溶血性レンサ球菌咽頭炎,2001,35,2001-W35,10,12,22,142,gender
感染性胃腸炎,2001,35,2001-W35,91,92,183,142,gender
水痘,2001,35,2001-W35,21,18,39,142,gender
手足口病,2001,35,2001-W35,22,19,41,142,gender
突発性発しん,2001,35,2001-W35,38,40,78,142,gender
ヘルパンギーナ,2001,35,2001-W35,29,27,56,142,gender
流行性耳下腺炎,2001,35,2001-W35,56,45,101,142,gender
川崎病,2001,35,2001-W35,0,0,0,142,gender
インフルエンザ,2002,28,2002-W28,0,0,0,178,gender
RSウイルス感染症,2002,28,2002-W28,0,0,0,142,gender
咽頭結膜熱,2002,28,2002-W28,25,9,34,142,gender
Ａ群溶血性レンサ球菌咽頭炎,2002,28,2002-W28,40,40,80,142,gender
感染性胃腸炎,2002,28,2002-W28,201,141,342,142,gender
水痘,2002,28,2002-W28,85,82,167,142,gender
手足口病,2002,28,2002-W28,202,142,344,142,gender
突発性発しん,2002,28,2002-W28,45,24,69,142,gender
ヘルパンギーナ,2002,28,2002-W28,404,396,800,142,gender
流行性耳下腺炎,2002,28,2002-W28,62,61,123,142,gender
川崎病,2002,28,2002-W28,3,1,4,142,gender
インフルエンザ,2021,27,2021-W27,0,0,0,410,gender
RSウイルス感染症,2021,27,2021-W27,1081,941,2022,258,gender
咽頭結膜熱,2021,27,2021-W27,39,28,67,258,gender
Ａ群溶血性レンサ球菌咽頭炎,2021,27,2021-W27,48,44,92,258,gender
感染性胃腸炎,2021,27,2021-W27,493,395,888,258,gender
水痘,2021,27,2021-W27,6,11,17,258,gender
手足口病,2021,27,2021-W27,18,19,37,258,gender
突発性発しん,2021,27,2021-W27,52,51,103,258,gender
ヘルパンギーナ,2021,27,2021-W27,12,14,26,258,gender
流行性耳下腺炎,2021,27,2021-W27,14,5,19,258,gender
川崎病,2021,27,2021-W27,1,2,3,258,gender
インフルエンザ,2019,38,2019-W38,231,206,437,412,gender
RSウイルス感染症,2019,38,2019-W38,237,228,465,260,gender
咽頭結膜熱,2019,38,2019-W38,42,37,79,260,gender
Ａ群溶血性レンサ球菌咽頭炎,2019,38,2019-W38,193,171,364,260,gender
感染性胃腸炎,2019,38,2019-W38,410,339,749,260,gender
水痘,2019,38,2019-W38,36,31,67,260,gender
手足口病,2019,38,2019-W38,381,274,655,260,gender
突発性発しん,2019,38,2019-W38,58,65,123,260,gender
ヘルパンギーナ,2019,38,2019-W38,153,145,298,260,gender
流行性耳下腺炎,2019,38,2019-W38,13,9,22,260,gender
川崎病,2019,38,2019-W38,3,2,5,260,gender
インフルエンザ,2008,11,2008-W11,373,377,750,289,gender
RSウイルス感染症,2008,11,2008-W11,2,1,3,150,gender
咽頭結膜熱,2008,11,2008-W11,13,19,32,150,gender
Ａ群溶血性レンサ球菌咽頭炎,2008,11,2008-W11,212,170,382,150,gender
感染性胃腸炎,2008,11,2008-W11,1207,1173,2380,150,gender
水痘,2008,11,2008-W11,102,83,185,150,gender
手足口病,2008,11,2008-W11,3,4,7,150,gender
突発性発しん,2008,11,2008-W11,48,43,91,150,gender
ヘルパンギーナ,2008,11,2008-W11,0,0,0,150,gender
流行性耳下腺炎,2008,11,2008-W11,24,23,47,150,gender
川崎病,2008,11,2008-W11,1,1,2,150,gender
インフルエンザ,2005,41,2005-W41,0,1,1,178,gender
RSウイルス感染症,2005,41,2005-W41,3,1,4,142,gender
咽頭結膜熱,2005,41,2005-W41,13,8,21,142,gender
Ａ群溶血性レンサ球菌咽頭炎,2005,41,2005-W41,45,47,92,142,gender
感染性胃腸炎,2005,41,2005-W41,179,171,350,142,gender
水痘,2005,41,2005-W41,48,38,86,142,gender
手足口病,2005,41,2005-W41,20,23,43,142,gender
突発性発しん,2005,41,2005-W41,32,37,69,142,gender
ヘルパンギーナ,2005,41,2005-W41,15,17,32,142,gender
流行性耳下腺炎,2005,41,2005-W41,64,66,130,142,gender
川崎病,2005,41,2005-W41,0,0,0,142,gender
インフルエンザ,2007,32,2007-W32,0,1,1,262,gender
RSウイルス感染症,2007,32,2007-W32,2,1,3,142,gender
咽頭結膜熱,2007,32,2007-W32,41,22,63,142,gender
Ａ群溶血性レンサ球菌咽頭炎,2007,32,2007-W32,62,56,118,142,gender
感染性胃腸炎,2007,32,2007-W32,225,189,414,142,gender
水痘,2007,32,2007-W32,37,30,67,142,gender
手足口病,2007,32,2007-W32,159,129,288,142,gender
突発性発しん,2007,32,2007-W32,36,50,86,142,gender
ヘルパンギーナ,2007,32,2007-W32,288,264,552,142,gender
流行性耳下腺炎,2007,32,2007-W32,23,16,39,142,gender
川崎病,2007,32,2007-W32,3,2,5,142,gender
インフルエンザ,2000,14,2000-W14,5,4,9,178,gender
RSウイルス感染症,2000,14,2000-W14,0,0,0,142,gender
咽頭結膜熱,2000,14,2000-W14,0,1,1,142,gender
Ａ群溶血性レンサ球菌咽頭炎,2000,14,2000-W14,34,25,59,142,gender
感染性胃腸炎,2000,14,2000-W14,415,388,803,142,gender
水痘,2000,14,2000-W14,83,88,171,142,gender
手足口病,2000,14,2000-W14,6,6,12,142,gender
突発性発しん,2000,14,2000-W14,37,34,71,142,gender
ヘルパンギーナ,2000,14,2000-W14,6,4,10,142,gender
流行性耳下腺炎,2000,14,2000-W14,36,38,74,142,gender
川崎病,2000,14,2000-W14,1,1,2,142,gender
インフルエンザ,2012,20,2012-W20,50,41,91,416,gender
RSウイルス感染症,2012,20,2012-W20,14,12,26,261,gender
咽頭結膜熱,2012,20,2012-W20,43,50,93,261,gender
Ａ群溶血性レンサ球菌咽頭炎,2012,20,2012-W20,465,383,848,261,gender
感染性胃腸炎,2012,20,2012-W20,1175,1106,2281,261,gender
水痘,2012,20,2012-W20,112,97,209,261,gender
手足口病,2012,20,2012-W20,14,15,29,261,gender
突発性発しん,2012,20,2012-W20,107,93,200,261,gender
ヘルパンギーナ,2012,20,2012-W20,6,10,16,261,gender
流行性耳下腺炎,2012,20,2012-W20,41,34,75,261,gender
川崎病,2012,20,2012-W20,1,1,2,261,gender
インフルエンザ,2014,27,2014-W27,3,1,4,410,gender
RSウイルス感染症,2014,27,2014-W27,6,3,9,262,gender
咽頭結膜熱,2014,27,2014-W27,97,94,191,262,gender
Ａ群溶血性レンサ球菌咽頭炎,2014,27,2014-W27,354,315,669,262,gender
感染性胃腸炎,2014,27,2014-W27,825,649,1474,262,gender
水痘,2014,27,2014-W27,97,96,193,262,gender
手足口病,2014,27,2014-W27,103,85,188,262,gender
突発性発しん,2014,27,2014-W27,108,104,212,262,gender
ヘルパンギーナ,2014,27,2014-W27,624,595,1219,262,gender
流行性耳下腺炎,2014,27,2014-W27,43,53,96,262,gender
川崎病,2014,27,2014-W27,1,3,4,262,gender
インフルエンザ,2018,19,2018-W19,58,35,93,418,gender
RSウイルス感染症,2018,19,2018-W19,20,13,33,264,gender
咽頭結膜熱,2018,19,2018-W19,59,57,116,264,gender
Ａ群溶血性レンサ球菌咽頭炎,2018,19,2018-W19,480,431,911,264,gender
感染性胃腸炎,2018,19,2018-W19,1011,811,1822,264,gender
水痘,2018,19,2018-W19,68,54,122,264,gender
手足口病,2018,19,2018-W19,15,13,28,264,gender
突発性発しん,2018,19,2018-W19,106,109,215,264,gender
ヘルパンギーナ,2018,19,2018-W19,3,3,6,264,gender
流行性耳下腺炎,2018,19,2018-W19,22,6,28,264,gender
川崎病,2018,19,2018-W19,1,2,3,264,gender
インフルエンザ,2015,49,2015-W49,45,34,79,413,gender
RSウイルス感染症,2015,49,2015-W49,185,165,350,259,gender
咽頭結膜熱,2015,49,2015-W49,72,49,121,259,gender
Ａ群溶血性レンサ球菌咽頭炎,2015,49,2015-W49,465,383,848,259,gender
感染性胃腸炎,2015,49,2015-W49,1590,1527,3117,259,gender
水痘,2015,49,2015-W49,120,93,213,259,gender
手足口病,2015,49,2015-W49,21,21,42,259,gender
突発性発しん,2015,49,2015-W49,90,52,142,259,gender
ヘルパンギーナ,2015,49,2015-W49,9,6,15,259,gender
流行性耳下腺炎,2015,49,2015-W49,71,84,155,259,gender
川崎病,2015,49,2015-W49,6,0,6,259,gender
インフルエンザ,2009,30,2009-W30,40,42,82,287,gender
RSウイルス感染症,2009,30,2009-W30,7,0,7,149,gender
咽頭結膜熱,2009,30,2009-W30,22,13,35,149,gender
Ａ群溶血性レンサ球菌咽頭炎,2009,30,2009-W30,72,47,119,149,gender
感染性胃腸炎,2009,30,2009-W30,213,224,437,149,gender
水痘,2009,30,2009-W30,45,34,79,149,gender
手足口病,2009,30,2009-W30,105,82,187,149,gender
突発性発しん,2009,30,2009-W30,48,46,94,149,gender
ヘルパンギーナ,2009,30,2009-W30,83,84,167,149,gender
流行性耳下腺炎,2009,30,2009-W30,73,71,144,149,gender
川崎病,2009,30,2009-W30,0,2,2,149,gender
インフルエンザ,2006,13,2006-W13,79,85,164,178,gender
RSウイルス感染症,2006,13,2006-W13,4,2,6,142,gender
咽頭結膜熱,2006,13,2006-W13,23,28,51,142,gender
Ａ群溶血性レンサ球菌咽頭炎,2006,13,2006-W13,120,100,220,142,gender
感染性胃腸炎,2006,13,2006-W13,413,399,812,142,gender
水痘,2006,13,2006-W13,94,95,189,142,gender
手足口病,2006,13,2006-W13,0,1,1,142,gender
突発性発しん,2006,13,2006-W13,44,42,86,142,gender
ヘルパンギーナ,2006,13,2006-W13,5,5,10,142,gender
流行性耳下腺炎,2006,13,2006-W13,50,43,93,142,gender
川崎病,2006,13,2006-W13,1,1,2,142,gender
インフルエンザ,2019,49,2019-W49,2125,2168,4293,415,gender
RSウイルス感染症,2019,49,2019-W49,37,21,58,261,gender
咽頭結膜熱,2019,49,2019-W49,75,66,141,261,gender
Ａ群溶血性レンサ球菌咽頭炎,2019,49,2019-W49,509,439,948,261,gender
感染性胃腸炎,2019,49,2019-W49,1015,907,1922,261,gender
水痘,2019,49,2019-W49,84,80,164,261,gender
手足口病,2019,49,2019-W49,199,175,374,261,gender
突発性発しん,2019,49,2019-W49,47,51,98,261,gender
ヘルパンギーナ,2019,49,2019-W49,22,21,43,261,gender
流行性耳下腺炎,2019,49,2019-W49,6,9,15,261,gender
川崎病,2019,49,2019-W49,3,3,6,261,gender
インフルエンザ,2014,19,2014-W19,82,56,138,415,gender
RSウイルス感染症,2014,19,2014-W19,11,3,14,263,gender
咽頭結膜熱,2014,19,2014-W19,53,36,89,263,gender
Ａ群溶血性レンサ球菌咽頭炎,2014,19,2014-W19,273,239,512,263,gender
感染性胃腸炎,2014,19,2014-W19,755,676,1431,263,gender
水痘,2014,19,2014-W19,154,126,280,263,gender
手足口病,2014,19,2014-W19,13,12,25,263,gender
突発性発しん,2014,19,2014-W19,88,80,168,263,gender
ヘルパンギーナ,2014,19,2014-W19,5,5,10,263,gender
流行性耳下腺炎,2014,19,2014-W19,27,15,42,263,gender
川崎病,2014,19,2014-W19,2,1,3,263,gender
インフルエンザ,2005,30,2005-W30,0,1,1,178,gender
RSウイルス感染症,2005,30,2005-W30,5,2,7,142,gender
咽頭結膜熱,2005,30,2005-W30,61,47,108,142,gender
Ａ群溶血性レンサ球菌咽頭炎,2005,30,2005-W30,66,44,110,142,gender
感染性胃腸炎,2005,30,2005-W30,168,152,320,142,gender
水痘,2005,30,2005-W30,58,48,106,142,gender
手足口病,2005,30,2005-W30,102,82,184,142,gender
突発性発しん,2005,30,2005-W30,40,36,76,142,gender
ヘルパンギーナ,2005,30,2005-W30,228,207,435,142,gender
流行性耳下腺炎,2005,30,2005-W30,120,103,223,142,gender
川崎病,2005,30,2005-W30,4,0,4,142,gender
インフルエンザ,2007,43,2007-W43,66,46,112,287,gender
RSウイルス感染症,2007,43,2007-W43,18,11,29,149,gender
咽頭結膜熱,2007,43,2007-W43,9,11,20,149,gender
Ａ群溶血性レンサ球菌咽頭炎,2007,43,2007-W43,109,94,203,149,gender
感染性胃腸炎,2007,43,2007-W43,305,267,572,149,gender
水痘,2007,43,2007-W43,38,36,74,149,gender
手足口病,2007,43,2007-W43,42,38,80,149,gender
突発性発しん,2007,43,2007-W43,57,43,100,149,gender
ヘルパンギーナ,2007,43,2007-W43,23,11,34,149,gender
流行性耳下腺炎,2007,43,2007-W43,9,16,25,149,gender
川崎病,2007,43,2007-W43,0,0,0,149,gender
インフルエンザ,2019,6,2019-W06,5048,5373,10421,414,gender
RSウイルス感染症,2019,6,2019-W06,23,18,41,261,gender
咽頭結膜熱,2019,6,2019-W06,28,17,45,261,gender
Ａ群溶血性レンサ球菌咽頭炎,2019,6,2019-W06,301,279,580,261,gender
感染性胃腸炎,2019,6,2019-W06,915,904,1819,261,gender
水痘,2019,6,2019-W06,49,58,107,261,gender
手足口病,2019,6,2019-W06,23,14,37,261,gender
突発性発しん,2019,6,2019-W06,40,36,76,261,gender
ヘルパンギーナ,2019,6,2019-W06,1,5,6,261,gender
流行性耳下腺炎,2019,6,2019-W06,8,5,13,261,gender
川崎病,2019,6,2019-W06,1,2,3,261,gender
インフルエンザ,2018,27,2018-W27,7,21,28,417,gender
RSウイルス感染症,2018,27,2018-W27,49,41,90,263,gender
咽頭結膜熱,2018,27,2018-W27,102,68,170,263,gender
Ａ群溶血性レンサ球菌咽頭炎,2018,27,2018-W27,374,314,688,263,gender
感染性胃腸炎,2018,27,2018-W27,760,707,1467,263,gender
水痘,2018,27,2018-W27,44,54,98,263,gender
手足口病,2018,27,2018-W27,134,106,240,263,gender
突発性発しん,2018,27,2018-W27,98,82,180,263,gender
ヘルパンギーナ,2018,27,2018-W27,257,243,500,263,gender
流行性耳下腺炎,2018,27,2018-W27,13,20,33,263,gender
川崎病,2018,27,2018-W27,2,2,4,263,gender
インフルエンザ,2025,22,2025-W22,55,47,102,419,gender
新型コロナウイルス感染症（COVID-19）,2025,22,2025-W22,154,197,351,419,gender
RSウイルス感染症,2025,22,2025-W22,24,18,42,264,gender
咽頭結膜熱,2025,22,2025-W22,71,71,142,264,gender
Ａ群溶血性レンサ球菌咽頭炎,2025,22,2025-W22,607,474,1081,264,gender
感染性胃腸炎,2025,22,2025-W22,924,805,1729,264,gender
水痘,2025,22,2025-W22,140,141,281,264,gender
手足口病,2025,22,2025-W22,18,13,31,264,gender
突発性発しん,2025,22,2025-W22,60,38,98,264,gender
ヘルパンギーナ,2025,22,2025-W22,7,12,19,264,gender
流行性耳下腺炎,2025,22,2025-W22,14,12,26,264,gender
川崎病,2025,22,2025-W22,5,1,6,264,gender
インフルエンザ,2023,25,2023-W25,223,189,412,414,gender
新型コロナウイルス感染症（COVID-19）,2023,25,2023-W25,1252,1326,2578,414,gender
RSウイルス感染症,2023,25,2023-W25,358,342,700,260,gender
咽頭結膜熱,2023,25,2023-W25,63,48,111,260,gender
Ａ群溶血性レンサ球菌咽頭炎,2023,25,2023-W25,247,202,449,260,gender
感染性胃腸炎,2023,25,2023-W25,835,675,1510,260,gender
水痘,2023,25,2023-W25,22,26,48,260,gender
手足口病,2023,25,2023-W25,113,75,188,260,gender
突発性発しん,2023,25,2023-W25,25,32,57,260,gender
ヘルパンギーナ,2023,25,2023-W25,1047,968,2015,260,gender
流行性耳下腺炎,2023,25,2023-W25,11,9,20,260,gender
川崎病,2023,25,2023-W25,1,2,3,260,gender
インフルエンザ,2012,8,2012-W08,6953,7010,13963,419,gender
RSウイルス感染症,2012,8,2012-W08,26,25,51,264,gender
咽頭結膜熱,2012,8,2012-W08,27,25,52,264,gender
Ａ群溶血性レンサ球菌咽頭炎,2012,8,2012-W08,266,232,498,264,gender
感染性胃腸炎,2012,8,2012-W08,1090,976,2066,264,gender
水痘,2012,8,2012-W08,181,143,324,264,gender
手足口病,2012,8,2012-W08,3,2,5,264,gender
突発性発しん,2012,8,2012-W08,80,60,140,264,gender
ヘルパンギーナ,2012,8,2012-W08,3,2,5,264,gender
流行性耳下腺炎,2012,8,2012-W08,25,18,43,264,gender
川崎病,2012,8,2012-W08,2,3,5,264,gender
インフルエンザ,2017,4,2017-W04,8091,7983,16074,415,gender
RSウイルス感染症,2017,4,2017-W04,15,9,24,261,gender
咽頭結膜熱,2017,4,2017-W04,29,31,60,261,gender
Ａ群溶血性レンサ球菌咽頭炎,2017,4,2017-W04,271,216,487,261,gender
感染性胃腸炎,2017,4,2017-W04,819,789,1608,261,gender
水痘,2017,4,2017-W04,52,33,85,261,gender
手足口病,2017,4,2017-W04,8,6,14,261,gender
突発性発しん,2017,4,2017-W04,60,52,112,261,gender
ヘルパンギーナ,2017,4,2017-W04,2,0,2,261,gender
流行性耳下腺炎,2017,4,2017-W04,43,25,68,261,gender
川崎病,2017,4,2017-W04,3,1,4,261,gender
インフルエンザ,2003,37,2003-W37,0,0,0,178,gender
RSウイルス感染症,2003,37,2003-W37,0,0,0,142,gender
咽頭結膜熱,2003,37,2003-W37,8,11,19,142,gender
Ａ群溶血性レンサ球菌咽頭炎,2003,37,2003-W37,13,19,32,142,gender
感染性胃腸炎,2003,37,2003-W37,170,120,290,142,gender
水痘,2003,37,2003-W37,30,21,51,142,gender
手足口病,2003,37,2003-W37,54,51,105,142,gender
突発性発しん,2003,37,2003-W37,46,44,90,142,gender
ヘルパンギーナ,2003,37,2003-W37,62,54,116,142,gender
流行性耳下腺炎,2003,37,2003-W37,7,9,16,142,gender
川崎病,2003,37,2003-W37,0,1,1,142,gender
インフルエンザ,2020,38,2020-W38,0,0,0,404,gender
RSウイルス感染症,2020,38,2020-W38,0,0,0,253,gender
咽頭結膜熱,2020,38,2020-W38,8,9,17,253,gender
Ａ群溶血性レンサ球菌咽頭炎,2020,38,2020-W38,67,46,113,253,gender
感染性胃腸炎,2020,38,2020-W38,296,265,561,253,gender
水痘,2020,38,2020-W38,30,12,42,253,gender
手足口病,2020,38,2020-W38,17,12,29,253,gender
突発性発しん,2020,38,2020-W38,69,75,144,253,gender
ヘルパンギーナ,2020,38,2020-W38,14,13,27,253,gender
流行性耳下腺炎,2020,38,2020-W38,11,6,17,253,gender
川崎病,2020,38,2020-W38,1,1,2,253,gender
インフルエンザ,2001,44,2001-W44,2,1,3,178,gender
RSウイルス感染症,2001,44,2001-W44,0,0,0,142,gender
咽頭結膜熱,2001,44,2001-W44,7,3,10,142,gender
Ａ群溶血性レンサ球菌咽頭炎,2001,44,2001-W44,27,30,57,142,gender
感染性胃腸炎,2001,44,2001-W44,183,209,392,142,gender
水痘,2001,44,2001-W44,36,27,63,142,gender
手足口病,2001,44,2001-W44,23,14,37,142,gender
突発性発しん,2001,44,2001-W44,38,33,71,142,gender
ヘルパンギーナ,2001,44,2001-W44,6,2,8,142,gender
流行性耳下腺炎,2001,44,2001-W44,36,48,84,142,gender
川崎病,2001,44,2001-W44,0,0,0,142,gender
インフルエンザ,2000,25,2000-W25,0,0,0,178,gender
RSウイルス感染症,2000,25,2000-W25,0,0,0,142,gender
咽頭結膜熱,2000,25,2000-W25,8,3,11,142,gender
Ａ群溶血性レンサ球菌咽頭炎,2000,25,2000-W25,48,39,87,142,gender
感染性胃腸炎,2000,25,2000-W25,222,188,410,142,gender
水痘,2000,25,2000-W25,85,77,162,142,gender
手足口病,2000,25,2000-W25,133,117,250,142,gender
突発性発しん,2000,25,2000-W25,52,40,92,142,gender
ヘルパンギーナ,2000,25,2000-W25,198,203,401,142,gender
流行性耳下腺炎,2000,25,2000-W25,62,49,111,142,gender
川崎病,2000,25,2000-W25,0,2,2,142,gender
インフルエンザ,2012,7,2012-W07,8660,8540,17200,418,gender
RSウイルス感染症,2012,7,2012-W07,38,25,63,263,gender
咽頭結膜熱,2012,7,2012-W07,33,17,50,263,gender
Ａ群溶血性レンサ球菌咽頭炎,2012,7,2012-W07,291,231,522,263,gender
感染性胃腸炎,2012,7,2012-W07,1139,950,2089,263,gender
水痘,2012,7,2012-W07,152,149,301,263,gender
手足口病,2012,7,2012-W07,8,1,9,263,gender
突発性発しん,2012,7,2012-W07,65,68,133,263,gender
ヘルパンギーナ,2012,7,2012-W07,0,1,1,263,gender
流行性耳下腺炎,2012,7,2012-W07,35,31,66,263,gender
川崎病,2012,7,2012-W07,2,1,3,263,gender
インフルエンザ,2020,37,2020-W37,0,0,0,412,gender
RSウイルス感染症,2020,37,2020-W37,3,0,3,259,gender
咽頭結膜熱,2020,37,2020-W37,10,17,27,259,gender
Ａ群溶血性レンサ球菌咽頭炎,2020,37,2020-W37,60,47,107,259,gender
感染性胃腸炎,2020,37,2020-W37,321,267,588,259,gender
水痘,2020,37,2020-W37,11,4,15,259,gender
手足口病,2020,37,2020-W37,15,13,28,259,gender
突発性発しん,2020,37,2020-W37,79,71,150,259,gender
ヘルパンギーナ,2020,37,2020-W37,14,19,33,259,gender
流行性耳下腺炎,2020,37,2020-W37,10,5,15,259,gender
川崎病,2020,37,2020-W37,2,1,3,259,gender
インフルエンザ,2012,11,2012-W11,3333,3308,6641,415,gender
RSウイルス感染症,2012,11,2012-W11,25,20,45,261,gender
咽頭結膜熱,2012,11,2012-W11,33,16,49,261,gender
Ａ群溶血性レンサ球菌咽頭炎,2012,11,2012-W11,294,231,525,261,gender
感染性胃腸炎,2012,11,2012-W11,1113,1035,2148,261,gender
水痘,2012,11,2012-W11,157,124,281,261,gender
手足口病,2012,11,2012-W11,2,0,2,261,gender
突発性発しん,2012,11,2012-W11,60,61,121,261,gender
ヘルパンギーナ,2012,11,2012-W11,1,1,2,261,gender
流行性耳下腺炎,2012,11,2012-W11,23,17,40,261,gender
川崎病,2012,11,2012-W11,5,3,8,261,gender
インフルエンザ,2022,44,2022-W44,17,14,31,410,gender
RSウイルス感染症,2022,44,2022-W44,84,94,178,259,gender
咽頭結膜熱,2022,44,2022-W44,11,11,22,259,gender
Ａ群溶血性レンサ球菌咽頭炎,2022,44,2022-W44,28,16,44,259,gender
感染性胃腸炎,2022,44,2022-W44,502,422,924,259,gender
水痘,2022,44,2022-W44,10,12,22,259,gender
手足口病,2022,44,2022-W44,99,71,170,259,gender
突発性発しん,2022,44,2022-W44,37,39,76,259,gender
ヘルパンギーナ,2022,44,2022-W44,20,16,36,259,gender
流行性耳下腺炎,2022,44,2022-W44,9,8,17,259,gender
川崎病,2022,44,2022-W44,1,2,3,259,gender
インフルエンザ,2003,38,2003-W38,0,0,0,178,gender
RSウイルス感染症,2003,38,2003-W38,0,0,0,142,gender
咽頭結膜熱,2003,38,2003-W38,10,7,17,142,gender
Ａ群溶血性レンサ球菌咽頭炎,2003,38,2003-W38,21,19,40,142,gender
感染性胃腸炎,2003,38,2003-W38,154,135,289,142,gender
水痘,2003,38,2003-W38,28,19,47,142,gender
手足口病,2003,38,2003-W38,64,45,109,142,gender
突発性発しん,2003,38,2003-W38,45,38,83,142,gender
ヘルパンギーナ,2003,38,2003-W38,54,48,102,142,gender
流行性耳下腺炎,2003,38,2003-W38,16,7,23,142,gender
川崎病,2003,38,2003-W38,0,2,2,142,gender
インフルエンザ,2019,9,2019-W09,722,712,1434,413,gender
RSウイルス感染症,2019,9,2019-W09,42,31,73,259,gender
咽頭結膜熱,2019,9,2019-W09,24,19,43,259,gender
Ａ群溶血性レンサ球菌咽頭炎,2019,9,2019-W09,347,303,650,259,gender
感染性胃腸炎,2019,9,2019-W09,973,882,1855,259,gender
水痘,2019,9,2019-W09,52,49,101,259,gender
手足口病,2019,9,2019-W09,9,8,17,259,gender
突発性発しん,2019,9,2019-W09,59,44,103,259,gender
ヘルパンギーナ,2019,9,2019-W09,0,3,3,259,gender
流行性耳下腺炎,2019,9,2019-W09,7,5,12,259,gender
川崎病,2019,9,2019-W09,0,3,3,259,gender
インフルエンザ,2024,43,2024-W43,172,135,307,418,gender
新型コロナウイルス感染症（COVID-19）,2024,43,2024-W43,236,255,491,418,gender
RSウイルス感染症,2024,43,2024-W43,28,24,52,263,gender
咽頭結膜熱,2024,43,2024-W43,30,9,39,263,gender
Ａ群溶血性レンサ球菌咽頭炎,2024,43,2024-W43,278,221,499,263,gender
感染性胃腸炎,2024,43,2024-W43,375,348,723,263,gender
水痘,2024,43,2024-W43,31,31,62,263,gender
手足口病,2024,43,2024-W43,1276,1097,2373,263,gender
突発性発しん,2024,43,2024-W43,29,29,58,263,gender
ヘルパンギーナ,2024,43,2024-W43,43,27,70,263,gender
流行性耳下腺炎,2024,43,2024-W43,4,2,6,263,gender
川崎病,2024,43,2024-W43,0,0,0,263,gender
インフルエンザ,2014,16,2014-W16,602,587,1189,418,gender
RSウイルス感染症,2014,16,2014-W16,11,12,23,263,gender
咽頭結膜熱,2014,16,2014-W16,28,28,56,263,gender
Ａ群溶血性レンサ球菌咽頭炎,2014,16,2014-W16,311,275,586,263,gender
感染性胃腸炎,2014,16,2014-W16,995,928,1923,263,gender
水痘,2014,16,2014-W16,76,82,158,263,gender
手足口病,2014,16,2014-W16,2,5,7,263,gender
突発性発しん,2014,16,2014-W16,94,93,187,263,gender
ヘルパンギーナ,2014,16,2014-W16,3,1,4,263,gender
流行性耳下腺炎,2014,16,2014-W16,22,16,38,263,gender
川崎病,2014,16,2014-W16,3,5,8,263,gender
インフルエンザ,2019,46,2019-W46,400,428,828,413,gender
RSウイルス感染症,2019,46,2019-W46,29,33,62,260,gender
咽頭結膜熱,2019,46,2019-W46,58,43,101,260,gender
Ａ群溶血性レンサ球菌咽頭炎,2019,46,2019-W46,395,328,723,260,gender
感染性胃腸炎,2019,46,2019-W46,703,609,1312,260,gender
水痘,2019,46,2019-W46,71,53,124,260,gender
手足口病,2019,46,2019-W46,218,199,417,260,gender
突発性発しん,2019,46,2019-W46,64,82,146,260,gender
ヘルパンギーナ,2019,46,2019-W46,15,28,43,260,gender
流行性耳下腺炎,2019,46,2019-W46,6,10,16,260,gender
川崎病,2019,46,2019-W46,1,0,1,260,gender
インフルエンザ,2006,22,2006-W22,1,5,6,178,gender
RSウイルス感染症,2006,22,2006-W22,1,1,2,142,gender
咽頭結膜熱,2006,22,2006-W22,75,72,147,142,gender
Ａ群溶血性レンサ球菌咽頭炎,2006,22,2006-W22,156,133,289,142,gender
感染性胃腸炎,2006,22,2006-W22,338,275,613,142,gender
水痘,2006,22,2006-W22,106,107,213,142,gender
手足口病,2006,22,2006-W22,22,13,35,142,gender
突発性発しん,2006,22,2006-W22,55,45,100,142,gender
ヘルパンギーナ,2006,22,2006-W22,204,151,355,142,gender
流行性耳下腺炎,2006,22,2006-W22,58,54,112,142,gender
川崎病,2006,22,2006-W22,5,2,7,142,gender
インフルエンザ,2004,51,2004-W51,55,54,109,178,gender
RSウイルス感染症,2004,51,2004-W51,14,11,25,142,gender
咽頭結膜熱,2004,51,2004-W51,15,18,33,142,gender
Ａ群溶血性レンサ球菌咽頭炎,2004,51,2004-W51,75,56,131,142,gender
感染性胃腸炎,2004,51,2004-W51,1272,1272,2544,142,gender
水痘,2004,51,2004-W51,122,109,231,142,gender
手足口病,2004,51,2004-W51,50,46,96,142,gender
突発性発しん,2004,51,2004-W51,39,24,63,142,gender
ヘルパンギーナ,2004,51,2004-W51,10,3,13,142,gender
流行性耳下腺炎,2004,51,2004-W51,82,52,134,142,gender
川崎病,2004,51,2004-W51,1,1,2,142,gender
インフルエンザ,2018,28,2018-W28,14,8,22,411,gender
RSウイルス感染症,2018,28,2018-W28,88,63,151,260,gender
咽頭結膜熱,2018,28,2018-W28,92,62,154,260,gender
Ａ群溶血性レンサ球菌咽頭炎,2018,28,2018-W28,346,288,634,260,gender
感染性胃腸炎,2018,28,2018-W28,761,640,1401,260,gender
水痘,2018,28,2018-W28,43,36,79,260,gender
手足口病,2018,28,2018-W28,180,154,334,260,gender
突発性発しん,2018,28,2018-W28,91,76,167,260,gender
ヘルパンギーナ,2018,28,2018-W28,430,387,817,260,gender
流行性耳下腺炎,2018,28,2018-W28,25,13,38,260,gender
川崎病,2018,28,2018-W28,2,1,3,260,gender
インフルエンザ,2008,51,2008-W51,597,540,1137,284,gender
RSウイルス感染症,2008,51,2008-W51,28,22,50,148,gender
咽頭結膜熱,2008,51,2008-W51,33,19,52,148,gender
Ａ群溶血性レンサ球菌咽頭炎,2008,51,2008-W51,241,216,457,148,gender
感染性胃腸炎,2008,51,2008-W51,1321,1357,2678,148,gender
水痘,2008,51,2008-W51,130,122,252,148,gender
手足口病,2008,51,2008-W51,29,27,56,148,gender
突発性発しん,2008,51,2008-W51,44,48,92,148,gender
ヘルパンギーナ,2008,51,2008-W51,6,7,13,148,gender
流行性耳下腺炎,2008,51,2008-W51,57,43,100,148,gender
川崎病,2008,51,2008-W51,2,0,2,148,gender
インフルエンザ,2014,28,2014-W28,0,1,1,413,gender
RSウイルス感染症,2014,28,2014-W28,16,16,32,262,gender
咽頭結膜熱,2014,28,2014-W28,92,68,160,262,gender
Ａ群溶血性レンサ球菌咽頭炎,2014,28,2014-W28,335,310,645,262,gender
感染性胃腸炎,2014,28,2014-W28,702,646,1348,262,gender
水痘,2014,28,2014-W28,93,94,187,262,gender
手足口病,2014,28,2014-W28,150,135,285,262,gender
突発性発しん,2014,28,2014-W28,102,107,209,262,gender
ヘルパンギーナ,2014,28,2014-W28,980,887,1867,262,gender
流行性耳下腺炎,2014,28,2014-W28,53,46,99,262,gender
川崎病,2014,28,2014-W28,3,0,3,262,gender
インフルエンザ,2017,35,2017-W35,26,32,58,413,gender
RSウイルス感染症,2017,35,2017-W35,420,402,822,259,gender
咽頭結膜熱,2017,35,2017-W35,72,49,121,259,gender
Ａ群溶血性レンサ球菌咽頭炎,2017,35,2017-W35,143,135,278,259,gender
感染性胃腸炎,2017,35,2017-W35,447,425,872,259,gender
水痘,2017,35,2017-W35,16,18,34,259,gender
手足口病,2017,35,2017-W35,1198,970,2168,259,gender
突発性発しん,2017,35,2017-W35,75,62,137,259,gender
ヘルパンギーナ,2017,35,2017-W35,224,217,441,259,gender
流行性耳下腺炎,2017,35,2017-W35,25,21,46,259,gender
川崎病,2017,35,2017-W35,2,1,3,259,gender
インフルエンザ,2025,13,2025-W13,387,411,798,418,gender
新型コロナウイルス感染症（COVID-19）,2025,13,2025-W13,382,423,805,418,gender
RSウイルス感染症,2025,13,2025-W13,67,58,125,263,gender
咽頭結膜熱,2025,13,2025-W13,14,11,25,263,gender
Ａ群溶血性レンサ球菌咽頭炎,2025,13,2025-W13,354,235,589,263,gender
感染性胃腸炎,2025,13,2025-W13,1071,999,2070,263,gender
水痘,2025,13,2025-W13,73,79,152,263,gender
手足口病,2025,13,2025-W13,9,5,14,263,gender
突発性発しん,2025,13,2025-W13,23,33,56,263,gender
ヘルパンギーナ,2025,13,2025-W13,1,1,2,263,gender
流行性耳下腺炎,2025,13,2025-W13,8,11,19,263,gender
川崎病,2025,13,2025-W13,3,1,4,263,gender
インフルエンザ,2015,46,2015-W46,32,29,61,411,gender
RSウイルス感染症,2015,46,2015-W46,166,144,310,259,gender
咽頭結膜熱,2015,46,2015-W46,41,48,89,259,gender
Ａ群溶血性レンサ球菌咽頭炎,2015,46,2015-W46,358,297,655,259,gender
感染性胃腸炎,2015,46,2015-W46,1000,871,1871,259,gender
水痘,2015,46,2015-W46,73,69,142,259,gender
手足口病,2015,46,2015-W46,34,23,57,259,gender
突発性発しん,2015,46,2015-W46,78,65,143,259,gender
ヘルパンギーナ,2015,46,2015-W46,6,4,10,259,gender
流行性耳下腺炎,2015,46,2015-W46,79,62,141,259,gender
川崎病,2015,46,2015-W46,1,2,3,259,gender
インフルエンザ,2018,16,2018-W16,184,190,374,417,gender
RSウイルス感染症,2018,16,2018-W16,42,48,90,264,gender
咽頭結膜熱,2018,16,2018-W16,29,35,64,264,gender
Ａ群溶血性レンサ球菌咽頭炎,2018,16,2018-W16,435,353,788,264,gender
感染性胃腸炎,2018,16,2018-W16,885,830,1715,264,gender
水痘,2018,16,2018-W16,43,41,84,264,gender
手足口病,2018,16,2018-W16,14,8,22,264,gender
突発性発しん,2018,16,2018-W16,82,67,149,264,gender
ヘルパンギーナ,2018,16,2018-W16,1,0,1,264,gender
流行性耳下腺炎,2018,16,2018-W16,18,13,31,264,gender
川崎病,2018,16,2018-W16,2,2,4,264,gender
インフルエンザ,2011,32,2011-W32,6,3,9,386,gender
RSウイルス感染症,2011,32,2011-W32,33,29,62,247,gender
咽頭結膜熱,2011,32,2011-W32,57,37,94,247,gender
Ａ群溶血性レンサ球菌咽頭炎,2011,32,2011-W32,71,65,136,247,gender
感染性胃腸炎,2011,32,2011-W32,312,259,571,247,gender
水痘,2011,32,2011-W32,50,48,98,247,gender
手足口病,2011,32,2011-W32,1097,886,1983,247,gender
突発性発しん,2011,32,2011-W32,68,80,148,247,gender
ヘルパンギーナ,2011,32,2011-W32,610,612,1222,247,gender
流行性耳下腺炎,2011,32,2011-W32,45,34,79,247,gender
川崎病,2011,32,2011-W32,3,0,3,247,gender
インフルエンザ,2013,41,2013-W41,8,6,14,403,gender
RSウイルス感染症,2013,41,2013-W41,173,149,322,258,gender
咽頭結膜熱,2013,41,2013-W41,52,44,96,258,gender
Ａ群溶血性レンサ球菌咽頭炎,2013,41,2013-W41,163,139,302,258,gender
感染性胃腸炎,2013,41,2013-W41,498,398,896,258,gender
水痘,2013,41,2013-W41,77,92,169,258,gender
手足口病,2013,41,2013-W41,200,184,384,258,gender
突発性発しん,2013,41,2013-W41,96,83,179,258,gender
ヘルパンギーナ,2013,41,2013-W41,39,34,73,258,gender
流行性耳下腺炎,2013,41,2013-W41,31,19,50,258,gender
川崎病,2013,41,2013-W41,3,1,4,258,gender
インフルエンザ,2023,14,2023-W14,502,451,953,411,gender
RSウイルス感染症,2023,14,2023-W14,33,31,64,260,gender
咽頭結膜熱,2023,14,2023-W14,17,13,30,260,gender
Ａ群溶血性レンサ球菌咽頭炎,2023,14,2023-W14,54,45,99,260,gender
感染性胃腸炎,2023,14,2023-W14,550,404,954,260,gender
水痘,2023,14,2023-W14,19,12,31,260,gender
手足口病,2023,14,2023-W14,4,7,11,260,gender
突発性発しん,2023,14,2023-W14,36,33,69,260,gender
ヘルパンギーナ,2023,14,2023-W14,3,7,10,260,gender
流行性耳下腺炎,2023,14,2023-W14,9,3,12,260,gender
川崎病,2023,14,2023-W14,0,1,1,260,gender
インフルエンザ,2004,20,2004-W20,1,0,1,178,gender
RSウイルス感染症,2004,20,2004-W20,1,1,2,142,gender
咽頭結膜熱,2004,20,2004-W20,10,7,17,142,gender
Ａ群溶血性レンサ球菌咽頭炎,2004,20,2004-W20,110,71,181,142,gender
感染性胃腸炎,2004,20,2004-W20,341,310,651,142,gender
水痘,2004,20,2004-W20,93,91,184,142,gender
手足口病,2004,20,2004-W20,2,6,8,142,gender
突発性発しん,2004,20,2004-W20,50,39,89,142,gender
ヘルパンギーナ,2004,20,2004-W20,9,9,18,142,gender
流行性耳下腺炎,2004,20,2004-W20,34,30,64,142,gender
川崎病,2004,20,2004-W20,0,1,1,142,gender
インフルエンザ,2016,14,2016-W14,1015,1013,2028,414,gender
RSウイルス感染症,2016,14,2016-W14,11,6,17,260,gender
咽頭結膜熱,2016,14,2016-W14,28,27,55,260,gender
Ａ群溶血性レンサ球菌咽頭炎,2016,14,2016-W14,275,241,516,260,gender
感染性胃腸炎,2016,14,2016-W14,645,614,1259,260,gender
水痘,2016,14,2016-W14,60,48,108,260,gender
手足口病,2016,14,2016-W14,5,4,9,260,gender
突発性発しん,2016,14,2016-W14,59,59,118,260,gender
ヘルパンギーナ,2016,14,2016-W14,1,1,2,260,gender
流行性耳下腺炎,2016,14,2016-W14,66,46,112,260,gender
川崎病,2016,14,2016-W14,1,1,2,260,gender
インフルエンザ,2024,32,2024-W32,54,31,85,404,gender
新型コロナウイルス感染症（COVID-19）,2024,32,2024-W32,1038,1187,2225,404,gender
RSウイルス感染症,2024,32,2024-W32,55,45,100,255,gender
咽頭結膜熱,2024,32,2024-W32,33,40,73,255,gender
Ａ群溶血性レンサ球菌咽頭炎,2024,32,2024-W32,178,180,358,255,gender
感染性胃腸炎,2024,32,2024-W32,404,359,763,255,gender
水痘,2024,32,2024-W32,19,21,40,255,gender
手足口病,2024,32,2024-W32,1065,918,1983,255,gender
突発性発しん,2024,32,2024-W32,29,45,74,255,gender
ヘルパンギーナ,2024,32,2024-W32,156,154,310,255,gender
流行性耳下腺炎,2024,32,2024-W32,8,4,12,255,gender
川崎病,2024,32,2024-W32,3,0,3,255,gender
インフルエンザ,2019,37,2019-W37,208,179,387,412,gender
RSウイルス感染症,2019,37,2019-W37,341,320,661,260,gender
咽頭結膜熱,2019,37,2019-W37,52,46,98,260,gender
Ａ群溶血性レンサ球菌咽頭炎,2019,37,2019-W37,185,168,353,260,gender
感染性胃腸炎,2019,37,2019-W37,508,397,905,260,gender
水痘,2019,37,2019-W37,22,23,45,260,gender
手足口病,2019,37,2019-W37,380,316,696,260,gender
突発性発しん,2019,37,2019-W37,70,49,119,260,gender
ヘルパンギーナ,2019,37,2019-W37,226,214,440,260,gender
流行性耳下腺炎,2019,37,2019-W37,8,9,17,260,gender
川崎病,2019,37,2019-W37,2,0,2,260,gender
インフルエンザ,2011,6,2011-W06,4306,4204,8510,417,gender
RSウイルス感染症,2011,6,2011-W06,36,19,55,262,gender
咽頭結膜熱,2011,6,2011-W06,48,45,93,262,gender
Ａ群溶血性レンサ球菌咽頭炎,2011,6,2011-W06,295,255,550,262,gender
感染性胃腸炎,2011,6,2011-W06,1461,1290,2751,262,gender
水痘,2011,6,2011-W06,169,142,311,262,gender
手足口病,2011,6,2011-W06,11,5,16,262,gender
突発性発しん,2011,6,2011-W06,57,50,107,262,gender
ヘルパンギーナ,2011,6,2011-W06,2,0,2,262,gender
流行性耳下腺炎,2011,6,2011-W06,35,22,57,262,gender
川崎病,2011,6,2011-W06,2,0,2,262,gender
インフルエンザ,2020,46,2020-W46,2,0,2,412,gender
RSウイルス感染症,2020,46,2020-W46,1,1,2,259,gender
咽頭結膜熱,2020,46,2020-W46,17,15,32,259,gender
Ａ群溶血性レンサ球菌咽頭炎,2020,46,2020-W46,64,60,124,259,gender
感染性胃腸炎,2020,46,2020-W46,342,273,615,259,gender
水痘,2020,46,2020-W46,24,25,49,259,gender
手足口病,2020,46,2020-W46,8,0,8,259,gender
突発性発しん,2020,46,2020-W46,62,64,126,259,gender
ヘルパンギーナ,2020,46,2020-W46,4,4,8,259,gender
流行性耳下腺炎,2020,46,2020-W46,12,9,21,259,gender
川崎病,2020,46,2020-W46,0,0,0,259,gender
インフルエンザ,2010,13,2010-W13,12,8,20,287,gender
RSウイルス感染症,2010,13,2010-W13,8,9,17,147,gender
咽頭結膜熱,2010,13,2010-W13,9,8,17,147,gender
Ａ群溶血性レンサ球菌咽頭炎,2010,13,2010-W13,97,87,184,147,gender
感染性胃腸炎,2010,13,2010-W13,563,538,1101,147,gender
水痘,2010,13,2010-W13,152,146,298,147,gender
手足口病,2010,13,2010-W13,14,5,19,147,gender
突発性発しん,2010,13,2010-W13,40,41,81,147,gender
ヘルパンギーナ,2010,13,2010-W13,7,0,7,147,gender
流行性耳下腺炎,2010,13,2010-W13,60,50,110,147,gender
川崎病,2010,13,2010-W13,2,4,6,147,gender
インフルエンザ,2022,35,2022-W35,6,2,8,411,gender
RSウイルス感染症,2022,35,2022-W35,264,218,482,259,gender
咽頭結膜熱,2022,35,2022-W35,8,3,11,259,gender
Ａ群溶血性レンサ球菌咽頭炎,2022,35,2022-W35,20,11,31,259,gender
感染性胃腸炎,2022,35,2022-W35,308,263,571,259,gender
水痘,2022,35,2022-W35,4,10,14,259,gender
手足口病,2022,35,2022-W35,794,646,1440,259,gender
突発性発しん,2022,35,2022-W35,41,28,69,259,gender
ヘルパンギーナ,2022,35,2022-W35,175,152,327,259,gender
流行性耳下腺炎,2022,35,2022-W35,12,5,17,259,gender
川崎病,2022,35,2022-W35,0,0,0,259,gender
インフルエンザ,2003,49,2003-W49,13,11,24,178,gender
RSウイルス感染症,2003,49,2003-W49,7,3,10,142,gender
咽頭結膜熱,2003,49,2003-W49,14,6,20,142,gender
Ａ群溶血性レンサ球菌咽頭炎,2003,49,2003-W49,77,60,137,142,gender
感染性胃腸炎,2003,49,2003-W49,864,881,1745,142,gender
水痘,2003,49,2003-W49,95,87,182,142,gender
手足口病,2003,49,2003-W49,13,5,18,142,gender
突発性発しん,2003,49,2003-W49,37,40,77,142,gender
ヘルパンギーナ,2003,49,2003-W49,2,2,4,142,gender
流行性耳下腺炎,2003,49,2003-W49,17,14,31,142,gender
川崎病,2003,49,2003-W49,1,0,1,142,gender
インフルエンザ,2021,28,2021-W28,0,0,0,411,gender
RSウイルス感染症,2021,28,2021-W28,1194,1108,2302,258,gender
咽頭結膜熱,2021,28,2021-W28,28,20,48,258,gender
Ａ群溶血性レンサ球菌咽頭炎,2021,28,2021-W28,45,48,93,258,gender
感染性胃腸炎,2021,28,2021-W28,495,379,874,258,gender
水痘,2021,28,2021-W28,7,9,16,258,gender
手足口病,2021,28,2021-W28,13,8,21,258,gender
突発性発しん,2021,28,2021-W28,45,63,108,258,gender
ヘルパンギーナ,2021,28,2021-W28,17,12,29,258,gender
流行性耳下腺炎,2021,28,2021-W28,10,6,16,258,gender
川崎病,2021,28,2021-W28,3,1,4,258,gender
インフルエンザ,2002,27,2002-W27,0,1,1,178,gender
RSウイルス感染症,2002,27,2002-W27,0,0,0,142,gender
咽頭結膜熱,2002,27,2002-W27,14,1,15,142,gender
Ａ群溶血性レンサ球菌咽頭炎,2002,27,2002-W27,48,49,97,142,gender
感染性胃腸炎,2002,27,2002-W27,239,180,419,142,gender
水痘,2002,27,2002-W27,89,75,164,142,gender
手足口病,2002,27,2002-W27,115,100,215,142,gender
突発性発しん,2002,27,2002-W27,31,32,63,142,gender
ヘルパンギーナ,2002,27,2002-W27,299,285,584,142,gender
流行性耳下腺炎,2002,27,2002-W27,53,55,108,142,gender
川崎病,2002,27,2002-W27,1,2,3,142,gender
インフルエンザ,2008,3,2008-W03,829,766,1595,289,gender
RSウイルス感染症,2008,3,2008-W03,11,6,17,150,gender
咽頭結膜熱,2008,3,2008-W03,16,22,38,150,gender
Ａ群溶血性レンサ球菌咽頭炎,2008,3,2008-W03,115,110,225,150,gender
感染性胃腸炎,2008,3,2008-W03,652,666,1318,150,gender
水痘,2008,3,2008-W03,70,82,152,150,gender
手足口病,2008,3,2008-W03,5,5,10,150,gender
突発性発しん,2008,3,2008-W03,38,39,77,150,gender
ヘルパンギーナ,2008,3,2008-W03,0,2,2,150,gender
流行性耳下腺炎,2008,3,2008-W03,18,11,29,150,gender
川崎病,2008,3,2008-W03,2,1,3,150,gender
インフルエンザ,2021,16,2021-W16,0,0,0,402,gender
RSウイルス感染症,2021,16,2021-W16,36,26,62,257,gender
咽頭結膜熱,2021,16,2021-W16,12,12,24,257,gender
Ａ群溶血性レンサ球菌咽頭炎,2021,16,2021-W16,39,49,88,257,gender
感染性胃腸炎,2021,16,2021-W16,550,464,1014,257,gender
水痘,2021,16,2021-W16,9,11,20,257,gender
手足口病,2021,16,2021-W16,2,1,3,257,gender
突発性発しん,2021,16,2021-W16,86,72,158,257,gender
ヘルパンギーナ,2021,16,2021-W16,2,0,2,257,gender
流行性耳下腺炎,2021,16,2021-W16,11,5,16,257,gender
川崎病,2021,16,2021-W16,2,3,5,257,gender
インフルエンザ,2011,43,2011-W43,10,8,18,414,gender
RSウイルス感染症,2011,43,2011-W43,61,47,108,261,gender
咽頭結膜熱,2011,43,2011-W43,16,18,34,261,gender
Ａ群溶血性レンサ球菌咽頭炎,2011,43,2011-W43,174,187,361,261,gender
感染性胃腸炎,2011,43,2011-W43,529,474,1003,261,gender
水痘,2011,43,2011-W43,95,83,178,261,gender
手足口病,2011,43,2011-W43,140,120,260,261,gender
突発性発しん,2011,43,2011-W43,99,71,170,261,gender
ヘルパンギーナ,2011,43,2011-W43,22,23,45,261,gender
流行性耳下腺炎,2011,43,2011-W43,34,32,66,261,gender
川崎病,2011,43,2011-W43,0,0,0,261,gender
インフルエンザ,2013,30,2013-W30,0,2,2,415,gender
RSウイルス感染症,2013,30,2013-W30,30,25,55,262,gender
咽頭結膜熱,2013,30,2013-W30,102,70,172,262,gender
Ａ群溶血性レンサ球菌咽頭炎,2013,30,2013-W30,186,166,352,262,gender
感染性胃腸炎,2013,30,2013-W30,487,412,899,262,gender
水痘,2013,30,2013-W30,89,72,161,262,gender
手足口病,2013,30,2013-W30,2253,1873,4126,262,gender
突発性発しん,2013,30,2013-W30,87,76,163,262,gender
ヘルパンギーナ,2013,30,2013-W30,633,575,1208,262,gender
流行性耳下腺炎,2013,30,2013-W30,19,30,49,262,gender
川崎病,2013,30,2013-W30,2,0,2,262,gender
インフルエンザ,2002,19,2002-W19,2,0,2,178,gender
RSウイルス感染症,2002,19,2002-W19,0,0,0,142,gender
咽頭結膜熱,2002,19,2002-W19,3,0,3,142,gender
Ａ群溶血性レンサ球菌咽頭炎,2002,19,2002-W19,47,51,98,142,gender
感染性胃腸炎,2002,19,2002-W19,209,224,433,142,gender
水痘,2002,19,2002-W19,113,89,202,142,gender
手足口病,2002,19,2002-W19,15,7,22,142,gender
突発性発しん,2002,19,2002-W19,37,37,74,142,gender
ヘルパンギーナ,2002,19,2002-W19,12,4,16,142,gender
流行性耳下腺炎,2002,19,2002-W19,50,40,90,142,gender
川崎病,2002,19,2002-W19,0,0,0,142,gender
インフルエンザ,2006,1,2006-W01,261,253,514,178,gender
RSウイルス感染症,2006,1,2006-W01,10,13,23,142,gender
咽頭結膜熱,2006,1,2006-W01,11,3,14,142,gender
Ａ群溶血性レンサ球菌咽頭炎,2006,1,2006-W01,50,40,90,142,gender
感染性胃腸炎,2006,1,2006-W01,430,447,877,142,gender
水痘,2006,1,2006-W01,91,117,208,142,gender
手足口病,2006,1,2006-W01,3,3,6,142,gender
突発性発しん,2006,1,2006-W01,13,16,29,142,gender
ヘルパンギーナ,2006,1,2006-W01,1,1,2,142,gender
流行性耳下腺炎,2006,1,2006-W01,51,61,112,142,gender
川崎病,2006,1,2006-W01,1,3,4,142,gender
インフルエンザ,2017,44,2017-W44,118,116,234,416,gender
RSウイルス感染症,2017,44,2017-W44,66,51,117,262,gender
咽頭結膜熱,2017,44,2017-W44,68,54,122,262,gender
Ａ群溶血性レンサ球菌咽頭炎,2017,44,2017-W44,322,288,610,262,gender
感染性胃腸炎,2017,44,2017-W44,619,555,1174,262,gender
水痘,2017,44,2017-W44,68,55,123,262,gender
手足口病,2017,44,2017-W44,259,215,474,262,gender
突発性発しん,2017,44,2017-W44,64,71,135,262,gender
ヘルパンギーナ,2017,44,2017-W44,52,34,86,262,gender
流行性耳下腺炎,2017,44,2017-W44,17,18,35,262,gender
川崎病,2017,44,2017-W44,1,3,4,262,gender
インフルエンザ,2015,37,2015-W37,15,15,30,414,gender
RSウイルス感染症,2015,37,2015-W37,131,116,247,261,gender
咽頭結膜熱,2015,37,2015-W37,43,43,86,261,gender
Ａ群溶血性レンサ球菌咽頭炎,2015,37,2015-W37,211,167,378,261,gender
感染性胃腸炎,2015,37,2015-W37,539,430,969,261,gender
水痘,2015,37,2015-W37,27,27,54,261,gender
手足口病,2015,37,2015-W37,691,502,1193,261,gender
突発性発しん,2015,37,2015-W37,88,71,159,261,gender
ヘルパンギーナ,2015,37,2015-W37,123,126,249,261,gender
流行性耳下腺炎,2015,37,2015-W37,58,36,94,261,gender
川崎病,2015,37,2015-W37,1,2,3,261,gender
インフルエンザ,2025,2,2025-W02,4542,4624,9166,418,gender
新型コロナウイルス感染症（COVID-19）,2025,2,2025-W02,746,815,1561,418,gender
RSウイルス感染症,2025,2,2025-W02,54,32,86,263,gender
咽頭結膜熱,2025,2,2025-W02,18,16,34,263,gender
Ａ群溶血性レンサ球菌咽頭炎,2025,2,2025-W02,232,177,409,263,gender
感染性胃腸炎,2025,2,2025-W02,810,705,1515,263,gender
水痘,2025,2,2025-W02,94,63,157,263,gender
手足口病,2025,2,2025-W02,21,14,35,263,gender
突発性発しん,2025,2,2025-W02,34,24,58,263,gender
ヘルパンギーナ,2025,2,2025-W02,1,2,3,263,gender
流行性耳下腺炎,2025,2,2025-W02,5,5,10,263,gender
川崎病,2025,2,2025-W02,4,3,7,263,gender
インフルエンザ,2008,20,2008-W20,23,25,48,285,gender
RSウイルス感染症,2008,20,2008-W20,1,0,1,148,gender
咽頭結膜熱,2008,20,2008-W20,41,23,64,148,gender
Ａ群溶血性レンサ球菌咽頭炎,2008,20,2008-W20,249,188,437,148,gender
感染性胃腸炎,2008,20,2008-W20,463,425,888,148,gender
水痘,2008,20,2008-W20,130,109,239,148,gender
手足口病,2008,20,2008-W20,7,9,16,148,gender
突発性発しん,2008,20,2008-W20,54,49,103,148,gender
ヘルパンギーナ,2008,20,2008-W20,8,7,15,148,gender
流行性耳下腺炎,2008,20,2008-W20,29,28,57,148,gender
川崎病,2008,20,2008-W20,0,0,0,148,gender
インフルエンザ,2018,30,2018-W30,3,5,8,410,gender
RSウイルス感染症,2018,30,2018-W30,121,124,245,257,gender
咽頭結膜熱,2018,30,2018-W30,71,55,126,257,gender
Ａ群溶血性レンサ球菌咽頭炎,2018,30,2018-W30,263,193,456,257,gender
感染性胃腸炎,2018,30,2018-W30,565,539,1104,257,gender
水痘,2018,30,2018-W30,29,32,61,257,gender
手足口病,2018,30,2018-W30,184,124,308,257,gender
突発性発しん,2018,30,2018-W30,84,75,159,257,gender
ヘルパンギーナ,2018,30,2018-W30,504,474,978,257,gender
流行性耳下腺炎,2018,30,2018-W30,13,15,28,257,gender
川崎病,2018,30,2018-W30,0,2,2,257,gender
インフルエンザ,2004,49,2004-W49,38,38,76,178,gender
RSウイルス感染症,2004,49,2004-W49,26,13,39,142,gender
咽頭結膜熱,2004,49,2004-W49,6,9,15,142,gender
Ａ群溶血性レンサ球菌咽頭炎,2004,49,2004-W49,62,43,105,142,gender
感染性胃腸炎,2004,49,2004-W49,680,693,1373,142,gender
水痘,2004,49,2004-W49,98,86,184,142,gender
手足口病,2004,49,2004-W49,68,57,125,142,gender
突発性発しん,2004,49,2004-W49,38,36,74,142,gender
ヘルパンギーナ,2004,49,2004-W49,1,4,5,142,gender
流行性耳下腺炎,2004,49,2004-W49,65,67,132,142,gender
川崎病,2004,49,2004-W49,2,1,3,142,gender
インフルエンザ,2009,19,2009-W19,87,88,175,289,gender
RSウイルス感染症,2009,19,2009-W19,2,2,4,149,gender
咽頭結膜熱,2009,19,2009-W19,15,9,24,149,gender
Ａ群溶血性レンサ球菌咽頭炎,2009,19,2009-W19,83,66,149,149,gender
感染性胃腸炎,2009,19,2009-W19,359,313,672,149,gender
水痘,2009,19,2009-W19,80,82,162,149,gender
手足口病,2009,19,2009-W19,7,3,10,149,gender
突発性発しん,2009,19,2009-W19,28,30,58,149,gender
ヘルパンギーナ,2009,19,2009-W19,1,2,3,149,gender
流行性耳下腺炎,2009,19,2009-W19,50,43,93,149,gender
川崎病,2009,19,2009-W19,0,0,0,149,gender
インフルエンザ,2017,13,2017-W13,1262,1373,2635,417,gender
RSウイルス感染症,2017,13,2017-W13,17,17,34,263,gender
咽頭結膜熱,2017,13,2017-W13,31,25,56,263,gender
Ａ群溶血性レンサ球菌咽頭炎,2017,13,2017-W13,272,222,494,263,gender
感染性胃腸炎,2017,13,2017-W13,952,869,1821,263,gender
水痘,2017,13,2017-W13,55,53,108,263,gender
手足口病,2017,13,2017-W13,13,10,23,263,gender
突発性発しん,2017,13,2017-W13,46,73,119,263,gender
ヘルパンギーナ,2017,13,2017-W13,0,1,1,263,gender
流行性耳下腺炎,2017,13,2017-W13,31,35,66,263,gender
川崎病,2017,13,2017-W13,5,4,9,263,gender
インフルエンザ,2005,27,2005-W27,2,1,3,178,gender
RSウイルス感染症,2005,27,2005-W27,3,2,5,142,gender
咽頭結膜熱,2005,27,2005-W27,65,53,118,142,gender
Ａ群溶血性レンサ球菌咽頭炎,2005,27,2005-W27,97,84,181,142,gender
感染性胃腸炎,2005,27,2005-W27,281,234,515,142,gender
水痘,2005,27,2005-W27,92,68,160,142,gender
手足口病,2005,27,2005-W27,202,140,342,142,gender
突発性発しん,2005,27,2005-W27,46,51,97,142,gender
ヘルパンギーナ,2005,27,2005-W27,558,505,1063,142,gender
流行性耳下腺炎,2005,27,2005-W27,140,98,238,142,gender
川崎病,2005,27,2005-W27,1,0,1,142,gender
インフルエンザ,2003,20,2003-W20,0,0,0,178,gender
RSウイルス感染症,2003,20,2003-W20,0,0,0,142,gender
咽頭結膜熱,2003,20,2003-W20,16,11,27,142,gender
Ａ群溶血性レンサ球菌咽頭炎,2003,20,2003-W20,66,68,134,142,gender
感染性胃腸炎,2003,20,2003-W20,216,243,459,142,gender
水痘,2003,20,2003-W20,93,73,166,142,gender
手足口病,2003,20,2003-W20,32,28,60,142,gender
突発性発しん,2003,20,2003-W20,47,31,78,142,gender
ヘルパンギーナ,2003,20,2003-W20,9,7,16,142,gender
流行性耳下腺炎,2003,20,2003-W20,17,8,25,142,gender
川崎病,2003,20,2003-W20,1,1,2,142,gender
インフルエンザ,2022,2,2022-W02,2,2,4,411,gender
RSウイルス感染症,2022,2,2022-W02,4,4,8,258,gender
咽頭結膜熱,2022,2,2022-W02,20,9,29,258,gender
Ａ群溶血性レンサ球菌咽頭炎,2022,2,2022-W02,40,39,79,258,gender
感染性胃腸炎,2022,2,2022-W02,986,940,1926,258,gender
水痘,2022,2,2022-W02,7,9,16,258,gender
手足口病,2022,2,2022-W02,22,33,55,258,gender
突発性発しん,2022,2,2022-W02,54,29,83,258,gender
ヘルパンギーナ,2022,2,2022-W02,3,4,7,258,gender
流行性耳下腺炎,2022,2,2022-W02,5,5,10,258,gender
川崎病,2022,2,2022-W02,2,0,2,258,gender
インフルエンザ,2023,32,2023-W32,213,203,416,397,gender
新型コロナウイルス感染症（COVID-19）,2023,32,2023-W32,1901,2144,4045,397,gender
RSウイルス感染症,2023,32,2023-W32,60,63,123,250,gender
咽頭結膜熱,2023,32,2023-W32,82,54,136,250,gender
Ａ群溶血性レンサ球菌咽頭炎,2023,32,2023-W32,140,132,272,250,gender
感染性胃腸炎,2023,32,2023-W32,370,326,696,250,gender
水痘,2023,32,2023-W32,11,15,26,250,gender
手足口病,2023,32,2023-W32,69,52,121,250,gender
突発性発しん,2023,32,2023-W32,17,28,45,250,gender
ヘルパンギーナ,2023,32,2023-W32,169,151,320,250,gender
流行性耳下腺炎,2023,32,2023-W32,9,0,9,250,gender
川崎病,2023,32,2023-W32,1,2,3,250,gender
インフルエンザ,2011,14,2011-W14,947,981,1928,414,gender
RSウイルス感染症,2011,14,2011-W14,9,11,20,260,gender
咽頭結膜熱,2011,14,2011-W14,23,15,38,260,gender
Ａ群溶血性レンサ球菌咽頭炎,2011,14,2011-W14,206,209,415,260,gender
感染性胃腸炎,2011,14,2011-W14,893,846,1739,260,gender
水痘,2011,14,2011-W14,125,109,234,260,gender
手足口病,2011,14,2011-W14,4,4,8,260,gender
突発性発しん,2011,14,2011-W14,73,71,144,260,gender
ヘルパンギーナ,2011,14,2011-W14,6,1,7,260,gender
流行性耳下腺炎,2011,14,2011-W14,36,32,68,260,gender
川崎病,2011,14,2011-W14,1,2,3,260,gender
インフルエンザ,2021,41,2021-W41,1,0,1,411,gender
RSウイルス感染症,2021,41,2021-W41,11,9,20,257,gender
咽頭結膜熱,2021,41,2021-W41,10,7,17,257,gender
Ａ群溶血性レンサ球菌咽頭炎,2021,41,2021-W41,30,35,65,257,gender
感染性胃腸炎,2021,41,2021-W41,355,311,666,257,gender
水痘,2021,41,2021-W41,9,16,25,257,gender
手足口病,2021,41,2021-W41,49,46,95,257,gender
突発性発しん,2021,41,2021-W41,66,50,116,257,gender
ヘルパンギーナ,2021,41,2021-W41,110,99,209,257,gender
流行性耳下腺炎,2021,41,2021-W41,6,5,11,257,gender
川崎病,2021,41,2021-W41,1,0,1,257,gender
インフルエンザ,2001,1,2001-W01,14,7,21,178,gender
RSウイルス感染症,2001,1,2001-W01,0,0,0,142,gender
咽頭結膜熱,2001,1,2001-W01,11,4,15,142,gender
Ａ群溶血性レンサ球菌咽頭炎,2001,1,2001-W01,12,8,20,142,gender
感染性胃腸炎,2001,1,2001-W01,214,225,439,142,gender
水痘,2001,1,2001-W01,72,82,154,142,gender
手足口病,2001,1,2001-W01,1,1,2,142,gender
突発性発しん,2001,1,2001-W01,11,13,24,142,gender
ヘルパンギーナ,2001,1,2001-W01,0,1,1,142,gender
流行性耳下腺炎,2001,1,2001-W01,58,35,93,142,gender
川崎病,2001,1,2001-W01,0,0,0,142,gender
インフルエンザ,2012,37,2012-W37,23,20,43,409,gender
RSウイルス感染症,2012,37,2012-W37,189,169,358,258,gender
咽頭結膜熱,2012,37,2012-W37,100,94,194,258,gender
Ａ群溶血性レンサ球菌咽頭炎,2012,37,2012-W37,152,118,270,258,gender
感染性胃腸炎,2012,37,2012-W37,521,442,963,258,gender
水痘,2012,37,2012-W37,48,34,82,258,gender
手足口病,2012,37,2012-W37,73,59,132,258,gender
突発性発しん,2012,37,2012-W37,131,112,243,258,gender
ヘルパンギーナ,2012,37,2012-W37,122,105,227,258,gender
流行性耳下腺炎,2012,37,2012-W37,45,30,75,258,gender
川崎病,2012,37,2012-W37,0,2,2,258,gender
インフルエンザ,2010,44,2010-W44,21,23,44,288,gender
RSウイルス感染症,2010,44,2010-W44,26,27,53,149,gender
咽頭結膜熱,2010,44,2010-W44,17,20,37,149,gender
Ａ群溶血性レンサ球菌咽頭炎,2010,44,2010-W44,114,84,198,149,gender
感染性胃腸炎,2010,44,2010-W44,457,421,878,149,gender
水痘,2010,44,2010-W44,61,48,109,149,gender
手足口病,2010,44,2010-W44,41,24,65,149,gender
突発性発しん,2010,44,2010-W44,35,36,71,149,gender
ヘルパンギーナ,2010,44,2010-W44,11,9,20,149,gender
流行性耳下腺炎,2010,44,2010-W44,31,35,66,149,gender
川崎病,2010,44,2010-W44,1,2,3,149,gender
インフルエンザ,2020,11,2020-W11,183,189,372,416,gender
RSウイルス感染症,2020,11,2020-W11,23,19,42,261,gender
咽頭結膜熱,2020,11,2020-W11,21,18,39,261,gender
Ａ群溶血性レンサ球菌咽頭炎,2020,11,2020-W11,289,261,550,261,gender
感染性胃腸炎,2020,11,2020-W11,427,440,867,261,gender
水痘,2020,11,2020-W11,60,42,102,261,gender
手足口病,2020,11,2020-W11,9,11,20,261,gender
突発性発しん,2020,11,2020-W11,33,38,71,261,gender
ヘルパンギーナ,2020,11,2020-W11,2,4,6,261,gender
流行性耳下腺炎,2020,11,2020-W11,9,0,9,261,gender
川崎病,2020,11,2020-W11,2,1,3,261,gender
インフルエンザ,2018,4,2018-W04,11405,11099,22504,416,gender
RSウイルス感染症,2018,4,2018-W04,49,38,87,263,gender
咽頭結膜熱,2018,4,2018-W04,24,20,44,263,gender
Ａ群溶血性レンサ球菌咽頭炎,2018,4,2018-W04,382,338,720,263,gender
感染性胃腸炎,2018,4,2018-W04,725,701,1426,263,gender
水痘,2018,4,2018-W04,34,19,53,263,gender
手足口病,2018,4,2018-W04,10,13,23,263,gender
突発性発しん,2018,4,2018-W04,56,53,109,263,gender
ヘルパンギーナ,2018,4,2018-W04,0,1,1,263,gender
流行性耳下腺炎,2018,4,2018-W04,12,13,25,263,gender
川崎病,2018,4,2018-W04,2,0,2,263,gender
インフルエンザ,2009,27,2009-W27,7,13,20,288,gender
RSウイルス感染症,2009,27,2009-W27,9,8,17,148,gender
咽頭結膜熱,2009,27,2009-W27,22,22,44,148,gender
Ａ群溶血性レンサ球菌咽頭炎,2009,27,2009-W27,103,100,203,148,gender
感染性胃腸炎,2009,27,2009-W27,291,299,590,148,gender
水痘,2009,27,2009-W27,73,63,136,148,gender
手足口病,2009,27,2009-W27,44,55,99,148,gender
突発性発しん,2009,27,2009-W27,52,53,105,148,gender
ヘルパンギーナ,2009,27,2009-W27,32,19,51,148,gender
流行性耳下腺炎,2009,27,2009-W27,68,59,127,148,gender
川崎病,2009,27,2009-W27,4,0,4,148,gender
インフルエンザ,2014,30,2014-W30,2,0,2,415,gender
RSウイルス感染症,2014,30,2014-W30,13,11,24,262,gender
咽頭結膜熱,2014,30,2014-W30,77,49,126,262,gender
Ａ群溶血性レンサ球菌咽頭炎,2014,30,2014-W30,187,141,328,262,gender
感染性胃腸炎,2014,30,2014-W30,534,463,997,262,gender
水痘,2014,30,2014-W30,74,66,140,262,gender
手足口病,2014,30,2014-W30,201,142,343,262,gender
突発性発しん,2014,30,2014-W30,78,76,154,262,gender
ヘルパンギーナ,2014,30,2014-W30,988,946,1934,262,gender
流行性耳下腺炎,2014,30,2014-W30,44,35,79,262,gender
川崎病,2014,30,2014-W30,2,2,4,262,gender
インフルエンザ,2005,19,2005-W19,15,17,32,178,gender
RSウイルス感染症,2005,19,2005-W19,2,2,4,142,gender
咽頭結膜熱,2005,19,2005-W19,17,10,27,142,gender
Ａ群溶血性レンサ球菌咽頭炎,2005,19,2005-W19,88,82,170,142,gender
感染性胃腸炎,2005,19,2005-W19,363,321,684,142,gender
水痘,2005,19,2005-W19,133,102,235,142,gender
手足口病,2005,19,2005-W19,8,9,17,142,gender
突発性発しん,2005,19,2005-W19,48,34,82,142,gender
ヘルパンギーナ,2005,19,2005-W19,10,11,21,142,gender
流行性耳下腺炎,2005,19,2005-W19,71,71,142,142,gender
川崎病,2005,19,2005-W19,1,0,1,142,gender
インフルエンザ,2008,49,2008-W49,257,221,478,287,gender
RSウイルス感染症,2008,49,2008-W49,57,42,99,149,gender
咽頭結膜熱,2008,49,2008-W49,30,26,56,149,gender
Ａ群溶血性レンサ球菌咽頭炎,2008,49,2008-W49,178,157,335,149,gender
感染性胃腸炎,2008,49,2008-W49,1158,1134,2292,149,gender
水痘,2008,49,2008-W49,118,75,193,149,gender
手足口病,2008,49,2008-W49,23,21,44,149,gender
突発性発しん,2008,49,2008-W49,39,43,82,149,gender
ヘルパンギーナ,2008,49,2008-W49,6,7,13,149,gender
流行性耳下腺炎,2008,49,2008-W49,41,47,88,149,gender
川崎病,2008,49,2008-W49,2,1,3,149,gender
インフルエンザ,2016,43,2016-W43,73,86,159,410,gender
RSウイルス感染症,2016,43,2016-W43,160,151,311,260,gender
咽頭結膜熱,2016,43,2016-W43,30,33,63,260,gender
Ａ群溶血性レンサ球菌咽頭炎,2016,43,2016-W43,257,199,456,260,gender
感染性胃腸炎,2016,43,2016-W43,881,800,1681,260,gender
水痘,2016,43,2016-W43,49,44,93,260,gender
手足口病,2016,43,2016-W43,188,151,339,260,gender
突発性発しん,2016,43,2016-W43,74,70,144,260,gender
ヘルパンギーナ,2016,43,2016-W43,43,47,90,260,gender
流行性耳下腺炎,2016,43,2016-W43,99,90,189,260,gender
川崎病,2016,43,2016-W43,4,6,10,260,gender
インフルエンザ,2016,6,2016-W06,7743,7751,15494,416,gender
RSウイルス感染症,2016,6,2016-W06,30,15,45,262,gender
咽頭結膜熱,2016,6,2016-W06,30,26,56,262,gender
Ａ群溶血性レンサ球菌咽頭炎,2016,6,2016-W06,427,353,780,262,gender
感染性胃腸炎,2016,6,2016-W06,945,898,1843,262,gender
水痘,2016,6,2016-W06,63,54,117,262,gender
手足口病,2016,6,2016-W06,7,1,8,262,gender
突発性発しん,2016,6,2016-W06,51,39,90,262,gender
ヘルパンギーナ,2016,6,2016-W06,1,0,1,262,gender
流行性耳下腺炎,2016,6,2016-W06,65,53,118,262,gender
川崎病,2016,6,2016-W06,3,1,4,262,gender
インフルエンザ,2021,3,2021-W03,4,1,5,409,gender
RSウイルス感染症,2021,3,2021-W03,6,7,13,256,gender
咽頭結膜熱,2021,3,2021-W03,23,14,37,256,gender
Ａ群溶血性レンサ球菌咽頭炎,2021,3,2021-W03,50,52,102,256,gender
感染性胃腸炎,2021,3,2021-W03,456,396,852,256,gender
水痘,2021,3,2021-W03,15,14,29,256,gender
手足口病,2021,3,2021-W03,4,3,7,256,gender
突発性発しん,2021,3,2021-W03,56,60,116,256,gender
ヘルパンギーナ,2021,3,2021-W03,2,0,2,256,gender
流行性耳下腺炎,2021,3,2021-W03,12,2,14,256,gender
川崎病,2021,3,2021-W03,3,1,4,256,gender
インフルエンザ,2023,43,2023-W43,4301,3981,8282,416,gender
新型コロナウイルス感染症（COVID-19）,2023,43,2023-W43,390,374,764,416,gender
RSウイルス感染症,2023,43,2023-W43,4,0,4,261,gender
咽頭結膜熱,2023,43,2023-W43,371,315,686,261,gender
Ａ群溶血性レンサ球菌咽頭炎,2023,43,2023-W43,614,501,1115,261,gender
感染性胃腸炎,2023,43,2023-W43,532,430,962,261,gender
水痘,2023,43,2023-W43,18,13,31,261,gender
手足口病,2023,43,2023-W43,94,90,184,261,gender
突発性発しん,2023,43,2023-W43,25,24,49,261,gender
ヘルパンギーナ,2023,43,2023-W43,9,16,25,261,gender
流行性耳下腺炎,2023,43,2023-W43,6,7,13,261,gender
川崎病,2023,43,2023-W43,2,3,5,261,gender
インフルエンザ,2013,16,2013-W16,207,184,391,412,gender
RSウイルス感染症,2013,16,2013-W16,17,19,36,261,gender
咽頭結膜熱,2013,16,2013-W16,48,44,92,261,gender
Ａ群溶血性レンサ球菌咽頭炎,2013,16,2013-W16,416,365,781,261,gender
感染性胃腸炎,2013,16,2013-W16,1107,1079,2186,261,gender
水痘,2013,16,2013-W16,88,88,176,261,gender
手足口病,2013,16,2013-W16,19,14,33,261,gender
突発性発しん,2013,16,2013-W16,91,101,192,261,gender
ヘルパンギーナ,2013,16,2013-W16,3,4,7,261,gender
流行性耳下腺炎,2013,16,2013-W16,20,18,38,261,gender
川崎病,2013,16,2013-W16,3,2,5,261,gender
インフルエンザ,2021,30,2021-W30,1,0,1,409,gender
RSウイルス感染症,2021,30,2021-W30,632,528,1160,257,gender
咽頭結膜熱,2021,30,2021-W30,14,14,28,257,gender
Ａ群溶血性レンサ球菌咽頭炎,2021,30,2021-W30,34,36,70,257,gender
感染性胃腸炎,2021,30,2021-W30,311,263,574,257,gender
水痘,2021,30,2021-W30,16,11,27,257,gender
手足口病,2021,30,2021-W30,7,8,15,257,gender
突発性発しん,2021,30,2021-W30,53,44,97,257,gender
ヘルパンギーナ,2021,30,2021-W30,13,23,36,257,gender
流行性耳下腺炎,2021,30,2021-W30,9,6,15,257,gender
川崎病,2021,30,2021-W30,3,2,5,257,gender
インフルエンザ,2003,51,2003-W51,57,70,127,178,gender
RSウイルス感染症,2003,51,2003-W51,10,8,18,142,gender
咽頭結膜熱,2003,51,2003-W51,12,6,18,142,gender
Ａ群溶血性レンサ球菌咽頭炎,2003,51,2003-W51,70,89,159,142,gender
感染性胃腸炎,2003,51,2003-W51,1154,1090,2244,142,gender
水痘,2003,51,2003-W51,117,105,222,142,gender
手足口病,2003,51,2003-W51,5,4,9,142,gender
突発性発しん,2003,51,2003-W51,44,45,89,142,gender
ヘルパンギーナ,2003,51,2003-W51,3,2,5,142,gender
流行性耳下腺炎,2003,51,2003-W51,16,7,23,142,gender
川崎病,2003,51,2003-W51,1,1,2,142,gender
インフルエンザ,2001,22,2001-W22,0,0,0,178,gender
RSウイルス感染症,2001,22,2001-W22,0,0,0,142,gender
咽頭結膜熱,2001,22,2001-W22,9,8,17,142,gender
Ａ群溶血性レンサ球菌咽頭炎,2001,22,2001-W22,49,32,81,142,gender
感染性胃腸炎,2001,22,2001-W22,225,187,412,142,gender
水痘,2001,22,2001-W22,91,66,157,142,gender
手足口病,2001,22,2001-W22,34,29,63,142,gender
突発性発しん,2001,22,2001-W22,43,37,80,142,gender
ヘルパンギーナ,2001,22,2001-W22,35,34,69,142,gender
流行性耳下腺炎,2001,22,2001-W22,85,72,157,142,gender
川崎病,2001,22,2001-W22,0,1,1,142,gender
インフルエンザ,2007,25,2007-W25,2,1,3,287,gender
RSウイルス感染症,2007,25,2007-W25,6,8,14,149,gender
咽頭結膜熱,2007,25,2007-W25,66,65,131,149,gender
Ａ群溶血性レンサ球菌咽頭炎,2007,25,2007-W25,133,139,272,149,gender
感染性胃腸炎,2007,25,2007-W25,472,373,845,149,gender
水痘,2007,25,2007-W25,123,86,209,149,gender
手足口病,2007,25,2007-W25,53,31,84,149,gender
突発性発しん,2007,25,2007-W25,64,44,108,149,gender
ヘルパンギーナ,2007,25,2007-W25,68,49,117,149,gender
流行性耳下腺炎,2007,25,2007-W25,36,21,57,149,gender
川崎病,2007,25,2007-W25,1,0,1,149,gender
インフルエンザ,2015,11,2015-W11,566,547,1113,411,gender
RSウイルス感染症,2015,11,2015-W11,30,19,49,260,gender
咽頭結膜熱,2015,11,2015-W11,39,16,55,260,gender
Ａ群溶血性レンサ球菌咽頭炎,2015,11,2015-W11,466,393,859,260,gender
感染性胃腸炎,2015,11,2015-W11,1251,1098,2349,260,gender
水痘,2015,11,2015-W11,60,76,136,260,gender
手足口病,2015,11,2015-W11,12,8,20,260,gender
突発性発しん,2015,11,2015-W11,60,65,125,260,gender
ヘルパンギーナ,2015,11,2015-W11,1,2,3,260,gender
流行性耳下腺炎,2015,11,2015-W11,44,45,89,260,gender
川崎病,2015,11,2015-W11,5,4,9,260,gender
インフルエンザ,2018,41,2018-W41,20,22,42,418,gender
RSウイルス感染症,2018,41,2018-W41,118,131,249,263,gender
咽頭結膜熱,2018,41,2018-W41,27,21,48,263,gender
Ａ群溶血性レンサ球菌咽頭炎,2018,41,2018-W41,206,166,372,263,gender
感染性胃腸炎,2018,41,2018-W41,496,460,956,263,gender
水痘,2018,41,2018-W41,48,31,79,263,gender
手足口病,2018,41,2018-W41,189,173,362,263,gender
突発性発しん,2018,41,2018-W41,42,57,99,263,gender
ヘルパンギーナ,2018,41,2018-W41,54,65,119,263,gender
流行性耳下腺炎,2018,41,2018-W41,6,10,16,263,gender
川崎病,2018,41,2018-W41,3,0,3,263,gender
インフルエンザ,2004,38,2004-W38,0,0,0,178,gender
RSウイルス感染症,2004,38,2004-W38,0,0,0,142,gender
咽頭結膜熱,2004,38,2004-W38,14,13,27,142,gender
Ａ群溶血性レンサ球菌咽頭炎,2004,38,2004-W38,26,27,53,142,gender
感染性胃腸炎,2004,38,2004-W38,177,148,325,142,gender
水痘,2004,38,2004-W38,16,19,35,142,gender
手足口病,2004,38,2004-W38,76,55,131,142,gender
突発性発しん,2004,38,2004-W38,47,42,89,142,gender
ヘルパンギーナ,2004,38,2004-W38,22,15,37,142,gender
流行性耳下腺炎,2004,38,2004-W38,29,28,57,142,gender
川崎病,2004,38,2004-W38,0,1,1,142,gender
インフルエンザ,2014,41,2014-W41,13,13,26,406,gender
RSウイルス感染症,2014,41,2014-W41,123,115,238,260,gender
咽頭結膜熱,2014,41,2014-W41,39,34,73,260,gender
Ａ群溶血性レンサ球菌咽頭炎,2014,41,2014-W41,184,198,382,260,gender
感染性胃腸炎,2014,41,2014-W41,492,364,856,260,gender
水痘,2014,41,2014-W41,65,49,114,260,gender
手足口病,2014,41,2014-W41,123,100,223,260,gender
突発性発しん,2014,41,2014-W41,80,83,163,260,gender
ヘルパンギーナ,2014,41,2014-W41,45,52,97,260,gender
流行性耳下腺炎,2014,41,2014-W41,35,18,53,260,gender
川崎病,2014,41,2014-W41,2,3,5,260,gender
インフルエンザ,2019,11,2019-W11,255,270,525,413,gender
RSウイルス感染症,2019,11,2019-W11,40,41,81,259,gender
咽頭結膜熱,2019,11,2019-W11,45,14,59,259,gender
Ａ群溶血性レンサ球菌咽頭炎,2019,11,2019-W11,383,306,689,259,gender
感染性胃腸炎,2019,11,2019-W11,931,844,1775,259,gender
水痘,2019,11,2019-W11,50,63,113,259,gender
手足口病,2019,11,2019-W11,16,14,30,259,gender
突発性発しん,2019,11,2019-W11,59,46,105,259,gender
ヘルパンギーナ,2019,11,2019-W11,2,1,3,259,gender
流行性耳下腺炎,2019,11,2019-W11,9,2,11,259,gender
川崎病,2019,11,2019-W11,2,4,6,259,gender
インフルエンザ,2008,38,2008-W38,3,4,7,277,gender
RSウイルス感染症,2008,38,2008-W38,23,17,40,144,gender
咽頭結膜熱,2008,38,2008-W38,25,15,40,144,gender
Ａ群溶血性レンサ球菌咽頭炎,2008,38,2008-W38,55,55,110,144,gender
感染性胃腸炎,2008,38,2008-W38,243,201,444,144,gender
水痘,2008,38,2008-W38,32,22,54,144,gender
手足口病,2008,38,2008-W38,79,67,146,144,gender
突発性発しん,2008,38,2008-W38,59,57,116,144,gender
ヘルパンギーナ,2008,38,2008-W38,44,30,74,144,gender
流行性耳下腺炎,2008,38,2008-W38,50,38,88,144,gender
川崎病,2008,38,2008-W38,0,0,0,144,gender
インフルエンザ,2024,14,2024-W14,919,825,1744,418,gender
新型コロナウイルス感染症（COVID-19）,2024,14,2024-W14,529,616,1145,418,gender
RSウイルス感染症,2024,14,2024-W14,133,110,243,263,gender
咽頭結膜熱,2024,14,2024-W14,26,27,53,263,gender
Ａ群溶血性レンサ球菌咽頭炎,2024,14,2024-W14,347,318,665,263,gender
感染性胃腸炎,2024,14,2024-W14,519,491,1010,263,gender
水痘,2024,14,2024-W14,27,14,41,263,gender
手足口病,2024,14,2024-W14,12,13,25,263,gender
突発性発しん,2024,14,2024-W14,33,29,62,263,gender
ヘルパンギーナ,2024,14,2024-W14,1,2,3,263,gender
流行性耳下腺炎,2024,14,2024-W14,10,5,15,263,gender
川崎病,2024,14,2024-W14,2,2,4,263,gender
インフルエンザ,2016,32,2016-W32,4,2,6,389,gender
RSウイルス感染症,2016,32,2016-W32,54,49,103,244,gender
咽頭結膜熱,2016,32,2016-W32,51,32,83,244,gender
Ａ群溶血性レンサ球菌咽頭炎,2016,32,2016-W32,126,121,247,244,gender
感染性胃腸炎,2016,32,2016-W32,429,373,802,244,gender
水痘,2016,32,2016-W32,39,30,69,244,gender
手足口病,2016,32,2016-W32,108,76,184,244,gender
突発性発しん,2016,32,2016-W32,45,46,91,244,gender
ヘルパンギーナ,2016,32,2016-W32,449,389,838,244,gender
流行性耳下腺炎,2016,32,2016-W32,93,78,171,244,gender
川崎病,2016,32,2016-W32,0,1,1,244,gender
インフルエンザ,2015,7,2015-W07,1562,1642,3204,414,gender
RSウイルス感染症,2015,7,2015-W07,33,30,63,260,gender
咽頭結膜熱,2015,7,2015-W07,19,14,33,260,gender
Ａ群溶血性レンサ球菌咽頭炎,2015,7,2015-W07,346,280,626,260,gender
感染性胃腸炎,2015,7,2015-W07,970,940,1910,260,gender
水痘,2015,7,2015-W07,58,32,90,260,gender
手足口病,2015,7,2015-W07,9,11,20,260,gender
突発性発しん,2015,7,2015-W07,65,52,117,260,gender
ヘルパンギーナ,2015,7,2015-W07,0,1,1,260,gender
流行性耳下腺炎,2015,7,2015-W07,33,19,52,260,gender
川崎病,2015,7,2015-W07,2,1,3,260,gender
インフルエンザ,2013,28,2013-W28,4,4,8,410,gender
RSウイルス感染症,2013,28,2013-W28,20,19,39,259,gender
咽頭結膜熱,2013,28,2013-W28,99,101,200,259,gender
Ａ群溶血性レンサ球菌咽頭炎,2013,28,2013-W28,215,207,422,259,gender
感染性胃腸炎,2013,28,2013-W28,522,408,930,259,gender
水痘,2013,28,2013-W28,146,123,269,259,gender
手足口病,2013,28,2013-W28,1581,1261,2842,259,gender
突発性発しん,2013,28,2013-W28,83,82,165,259,gender
ヘルパンギーナ,2013,28,2013-W28,511,496,1007,259,gender
流行性耳下腺炎,2013,28,2013-W28,55,35,90,259,gender
川崎病,2013,28,2013-W28,3,1,4,259,gender
インフルエンザ,2022,13,2022-W13,0,0,0,410,gender
RSウイルス感染症,2022,13,2022-W13,0,0,0,257,gender
咽頭結膜熱,2022,13,2022-W13,0,1,1,257,gender
Ａ群溶血性レンサ球菌咽頭炎,2022,13,2022-W13,24,15,39,257,gender
感染性胃腸炎,2022,13,2022-W13,453,381,834,257,gender
水痘,2022,13,2022-W13,11,6,17,257,gender
手足口病,2022,13,2022-W13,3,1,4,257,gender
突発性発しん,2022,13,2022-W13,40,39,79,257,gender
ヘルパンギーナ,2022,13,2022-W13,1,2,3,257,gender
流行性耳下腺炎,2022,13,2022-W13,3,3,6,257,gender
川崎病,2022,13,2022-W13,1,0,1,257,gender
インフルエンザ,2012,46,2012-W46,31,41,72,413,gender
RSウイルス感染症,2012,46,2012-W46,76,59,135,261,gender
咽頭結膜熱,2012,46,2012-W46,57,49,106,261,gender
Ａ群溶血性レンサ球菌咽頭炎,2012,46,2012-W46,312,267,579,261,gender
感染性胃腸炎,2012,46,2012-W46,1832,1676,3508,261,gender
水痘,2012,46,2012-W46,130,109,239,261,gender
手足口病,2012,46,2012-W46,71,47,118,261,gender
突発性発しん,2012,46,2012-W46,95,60,155,261,gender
ヘルパンギーナ,2012,46,2012-W46,8,9,17,261,gender
流行性耳下腺炎,2012,46,2012-W46,42,25,67,261,gender
川崎病,2012,46,2012-W46,2,1,3,261,gender
インフルエンザ,2010,35,2010-W35,9,8,17,286,gender
RSウイルス感染症,2010,35,2010-W35,7,2,9,149,gender
咽頭結膜熱,2010,35,2010-W35,17,21,38,149,gender
Ａ群溶血性レンサ球菌咽頭炎,2010,35,2010-W35,35,44,79,149,gender
感染性胃腸炎,2010,35,2010-W35,251,228,479,149,gender
水痘,2010,35,2010-W35,29,26,55,149,gender
手足口病,2010,35,2010-W35,102,72,174,149,gender
突発性発しん,2010,35,2010-W35,54,63,117,149,gender
ヘルパンギーナ,2010,35,2010-W35,56,44,100,149,gender
流行性耳下腺炎,2010,35,2010-W35,45,25,70,149,gender
川崎病,2010,35,2010-W35,3,0,3,149,gender
インフルエンザ,2013,27,2013-W27,8,5,13,414,gender
RSウイルス感染症,2013,27,2013-W27,19,14,33,262,gender
咽頭結膜熱,2013,27,2013-W27,127,109,236,262,gender
Ａ群溶血性レンサ球菌咽頭炎,2013,27,2013-W27,288,224,512,262,gender
感染性胃腸炎,2013,27,2013-W27,621,540,1161,262,gender
水痘,2013,27,2013-W27,114,105,219,262,gender
手足口病,2013,27,2013-W27,889,686,1575,262,gender
突発性発しん,2013,27,2013-W27,100,93,193,262,gender
ヘルパンギーナ,2013,27,2013-W27,303,245,548,262,gender
流行性耳下腺炎,2013,27,2013-W27,43,36,79,262,gender
川崎病,2013,27,2013-W27,5,2,7,262,gender
インフルエンザ,2001,13,2001-W13,167,192,359,178,gender
RSウイルス感染症,2001,13,2001-W13,0,0,0,142,gender
咽頭結膜熱,2001,13,2001-W13,1,3,4,142,gender
Ａ群溶血性レンサ球菌咽頭炎,2001,13,2001-W13,24,17,41,142,gender
感染性胃腸炎,2001,13,2001-W13,284,278,562,142,gender
水痘,2001,13,2001-W13,82,80,162,142,gender
手足口病,2001,13,2001-W13,1,1,2,142,gender
突発性発しん,2001,13,2001-W13,42,35,77,142,gender
ヘルパンギーナ,2001,13,2001-W13,4,7,11,142,gender
流行性耳下腺炎,2001,13,2001-W13,70,87,157,142,gender
川崎病,2001,13,2001-W13,0,2,2,142,gender
インフルエンザ,2012,49,2012-W49,127,134,261,417,gender
RSウイルス感染症,2012,49,2012-W49,81,57,138,262,gender
咽頭結膜熱,2012,49,2012-W49,104,82,186,262,gender
Ａ群溶血性レンサ球菌咽頭炎,2012,49,2012-W49,358,283,641,262,gender
感染性胃腸炎,2012,49,2012-W49,3637,3424,7061,262,gender
水痘,2012,49,2012-W49,249,182,431,262,gender
手足口病,2012,49,2012-W49,63,47,110,262,gender
突発性発しん,2012,49,2012-W49,89,73,162,262,gender
ヘルパンギーナ,2012,49,2012-W49,6,10,16,262,gender
流行性耳下腺炎,2012,49,2012-W49,29,32,61,262,gender
川崎病,2012,49,2012-W49,2,1,3,262,gender
インフルエンザ,2007,14,2007-W14,782,823,1605,282,gender
RSウイルス感染症,2007,14,2007-W14,4,3,7,147,gender
咽頭結膜熱,2007,14,2007-W14,20,14,34,147,gender
Ａ群溶血性レンサ球菌咽頭炎,2007,14,2007-W14,103,77,180,147,gender
感染性胃腸炎,2007,14,2007-W14,431,347,778,147,gender
水痘,2007,14,2007-W14,94,102,196,147,gender
手足口病,2007,14,2007-W14,2,5,7,147,gender
突発性発しん,2007,14,2007-W14,37,45,82,147,gender
ヘルパンギーナ,2007,14,2007-W14,2,0,2,147,gender
流行性耳下腺炎,2007,14,2007-W14,23,10,33,147,gender
川崎病,2007,14,2007-W14,2,0,2,147,gender
インフルエンザ,2008,37,2008-W37,2,0,2,282,gender
RSウイルス感染症,2008,37,2008-W37,19,21,40,145,gender
咽頭結膜熱,2008,37,2008-W37,27,22,49,145,gender
Ａ群溶血性レンサ球菌咽頭炎,2008,37,2008-W37,64,64,128,145,gender
感染性胃腸炎,2008,37,2008-W37,263,223,486,145,gender
水痘,2008,37,2008-W37,33,21,54,145,gender
手足口病,2008,37,2008-W37,93,76,169,145,gender
突発性発しん,2008,37,2008-W37,58,61,119,145,gender
ヘルパンギーナ,2008,37,2008-W37,71,66,137,145,gender
流行性耳下腺炎,2008,37,2008-W37,36,29,65,145,gender
川崎病,2008,37,2008-W37,0,0,0,145,gender
インフルエンザ,2010,4,2010-W04,711,730,1441,288,gender
RSウイルス感染症,2010,4,2010-W04,70,73,143,149,gender
咽頭結膜熱,2010,4,2010-W04,7,4,11,149,gender
Ａ群溶血性レンサ球菌咽頭炎,2010,4,2010-W04,135,98,233,149,gender
感染性胃腸炎,2010,4,2010-W04,1290,1221,2511,149,gender
水痘,2010,4,2010-W04,71,79,150,149,gender
手足口病,2010,4,2010-W04,8,3,11,149,gender
突発性発しん,2010,4,2010-W04,35,41,76,149,gender
ヘルパンギーナ,2010,4,2010-W04,2,1,3,149,gender
流行性耳下腺炎,2010,4,2010-W04,40,39,79,149,gender
川崎病,2010,4,2010-W04,1,0,1,149,gender
インフルエンザ,2015,8,2015-W08,1096,1117,2213,415,gender
RSウイルス感染症,2015,8,2015-W08,42,39,81,261,gender
咽頭結膜熱,2015,8,2015-W08,29,19,48,261,gender
Ａ群溶血性レンサ球菌咽頭炎,2015,8,2015-W08,373,329,702,261,gender
感染性胃腸炎,2015,8,2015-W08,1128,1068,2196,261,gender
水痘,2015,8,2015-W08,70,52,122,261,gender
手足口病,2015,8,2015-W08,11,12,23,261,gender
突発性発しん,2015,8,2015-W08,62,56,118,261,gender
ヘルパンギーナ,2015,8,2015-W08,2,1,3,261,gender
流行性耳下腺炎,2015,8,2015-W08,42,25,67,261,gender
川崎病,2015,8,2015-W08,0,1,1,261,gender
インフルエンザ,2015,20,2015-W20,36,35,71,418,gender
RSウイルス感染症,2015,20,2015-W20,6,9,15,264,gender
咽頭結膜熱,2015,20,2015-W20,77,62,139,264,gender
Ａ群溶血性レンサ球菌咽頭炎,2015,20,2015-W20,613,479,1092,264,gender
感染性胃腸炎,2015,20,2015-W20,916,850,1766,264,gender
水痘,2015,20,2015-W20,82,72,154,264,gender
手足口病,2015,20,2015-W20,53,32,85,264,gender
突発性発しん,2015,20,2015-W20,99,90,189,264,gender
ヘルパンギーナ,2015,20,2015-W20,12,9,21,264,gender
流行性耳下腺炎,2015,20,2015-W20,39,30,69,264,gender
川崎病,2015,20,2015-W20,1,1,2,264,gender
インフルエンザ,2024,25,2024-W25,42,35,77,418,gender
新型コロナウイルス感染症（COVID-19）,2024,25,2024-W25,889,1077,1966,418,gender
RSウイルス感染症,2024,25,2024-W25,83,64,147,264,gender
咽頭結膜熱,2024,25,2024-W25,83,69,152,264,gender
Ａ群溶血性レンサ球菌咽頭炎,2024,25,2024-W25,486,375,861,264,gender
感染性胃腸炎,2024,25,2024-W25,663,514,1177,264,gender
水痘,2024,25,2024-W25,31,25,56,264,gender
手足口病,2024,25,2024-W25,845,722,1567,264,gender
突発性発しん,2024,25,2024-W25,48,38,86,264,gender
ヘルパンギーナ,2024,25,2024-W25,192,163,355,264,gender
流行性耳下腺炎,2024,25,2024-W25,18,14,32,264,gender
川崎病,2024,25,2024-W25,2,1,3,264,gender
インフルエンザ,2019,20,2019-W20,180,181,361,414,gender
RSウイルス感染症,2019,20,2019-W20,23,32,55,259,gender
咽頭結膜熱,2019,20,2019-W20,51,31,82,259,gender
Ａ群溶血性レンサ球菌咽頭炎,2019,20,2019-W20,493,341,834,259,gender
感染性胃腸炎,2019,20,2019-W20,1074,1030,2104,259,gender
水痘,2019,20,2019-W20,55,51,106,259,gender
手足口病,2019,20,2019-W20,50,33,83,259,gender
突発性発しん,2019,20,2019-W20,77,69,146,259,gender
ヘルパンギーナ,2019,20,2019-W20,10,4,14,259,gender
流行性耳下腺炎,2019,20,2019-W20,12,9,21,259,gender
川崎病,2019,20,2019-W20,0,3,3,259,gender
インフルエンザ,2009,1,2009-W01,285,261,546,255,gender
RSウイルス感染症,2009,1,2009-W01,5,1,6,126,gender
咽頭結膜熱,2009,1,2009-W01,3,6,9,126,gender
Ａ群溶血性レンサ球菌咽頭炎,2009,1,2009-W01,27,29,56,126,gender
感染性胃腸炎,2009,1,2009-W01,154,156,310,126,gender
水痘,2009,1,2009-W01,39,48,87,126,gender
手足口病,2009,1,2009-W01,1,3,4,126,gender
突発性発しん,2009,1,2009-W01,6,10,16,126,gender
ヘルパンギーナ,2009,1,2009-W01,0,1,1,126,gender
流行性耳下腺炎,2009,1,2009-W01,10,7,17,126,gender
川崎病,2009,1,2009-W01,0,0,0,126,gender
インフルエンザ,2006,44,2006-W44,0,0,0,178,gender
RSウイルス感染症,2006,44,2006-W44,5,6,11,142,gender
咽頭結膜熱,2006,44,2006-W44,14,13,27,142,gender
Ａ群溶血性レンサ球菌咽頭炎,2006,44,2006-W44,96,98,194,142,gender
感染性胃腸炎,2006,44,2006-W44,487,454,941,142,gender
水痘,2006,44,2006-W44,52,37,89,142,gender
手足口病,2006,44,2006-W44,40,35,75,142,gender
突発性発しん,2006,44,2006-W44,27,29,56,142,gender
ヘルパンギーナ,2006,44,2006-W44,11,6,17,142,gender
流行性耳下腺炎,2006,44,2006-W44,41,34,75,142,gender
川崎病,2006,44,2006-W44,0,1,1,142,gender
インフルエンザ,2004,37,2004-W37,0,0,0,178,gender
RSウイルス感染症,2004,37,2004-W37,0,1,1,142,gender
咽頭結膜熱,2004,37,2004-W37,11,11,22,142,gender
Ａ群溶血性レンサ球菌咽頭炎,2004,37,2004-W37,17,17,34,142,gender
感染性胃腸炎,2004,37,2004-W37,179,162,341,142,gender
水痘,2004,37,2004-W37,22,22,44,142,gender
手足口病,2004,37,2004-W37,54,54,108,142,gender
突発性発しん,2004,37,2004-W37,56,50,106,142,gender
ヘルパンギーナ,2004,37,2004-W37,30,34,64,142,gender
流行性耳下腺炎,2004,37,2004-W37,30,21,51,142,gender
川崎病,2004,37,2004-W37,1,3,4,142,gender
インフルエンザ,2000,43,2000-W43,7,2,9,178,gender
RSウイルス感染症,2000,43,2000-W43,0,0,0,142,gender
咽頭結膜熱,2000,43,2000-W43,4,2,6,142,gender
Ａ群溶血性レンサ球菌咽頭炎,2000,43,2000-W43,36,27,63,142,gender
感染性胃腸炎,2000,43,2000-W43,193,161,354,142,gender
水痘,2000,43,2000-W43,27,21,48,142,gender
手足口病,2000,43,2000-W43,77,63,140,142,gender
突発性発しん,2000,43,2000-W43,35,38,73,142,gender
ヘルパンギーナ,2000,43,2000-W43,8,8,16,142,gender
流行性耳下腺炎,2000,43,2000-W43,50,54,104,142,gender
川崎病,2000,43,2000-W43,0,1,1,142,gender
インフルエンザ,2013,19,2013-W19,128,136,264,414,gender
RSウイルス感染症,2013,19,2013-W19,14,8,22,262,gender
咽頭結膜熱,2013,19,2013-W19,75,66,141,262,gender
Ａ群溶血性レンサ球菌咽頭炎,2013,19,2013-W19,329,303,632,262,gender
感染性胃腸炎,2013,19,2013-W19,994,979,1973,262,gender
水痘,2013,19,2013-W19,177,166,343,262,gender
手足口病,2013,19,2013-W19,18,15,33,262,gender
突発性発しん,2013,19,2013-W19,91,82,173,262,gender
ヘルパンギーナ,2013,19,2013-W19,7,12,19,262,gender
流行性耳下腺炎,2013,19,2013-W19,25,27,52,262,gender
川崎病,2013,19,2013-W19,3,1,4,262,gender
インフルエンザ,2002,30,2002-W30,0,0,0,178,gender
RSウイルス感染症,2002,30,2002-W30,0,0,0,142,gender
咽頭結膜熱,2002,30,2002-W30,16,14,30,142,gender
Ａ群溶血性レンサ球菌咽頭炎,2002,30,2002-W30,30,14,44,142,gender
感染性胃腸炎,2002,30,2002-W30,155,122,277,142,gender
水痘,2002,30,2002-W30,63,65,128,142,gender
手足口病,2002,30,2002-W30,119,103,222,142,gender
突発性発しん,2002,30,2002-W30,43,42,85,142,gender
ヘルパンギーナ,2002,30,2002-W30,224,221,445,142,gender
流行性耳下腺炎,2002,30,2002-W30,41,36,77,142,gender
川崎病,2002,30,2002-W30,3,1,4,142,gender
インフルエンザ,2007,3,2007-W03,86,80,166,276,gender
RSウイルス感染症,2007,3,2007-W03,35,27,62,141,gender
咽頭結膜熱,2007,3,2007-W03,13,15,28,141,gender
Ａ群溶血性レンサ球菌咽頭炎,2007,3,2007-W03,113,102,215,141,gender
感染性胃腸炎,2007,3,2007-W03,472,473,945,141,gender
水痘,2007,3,2007-W03,80,68,148,141,gender
手足口病,2007,3,2007-W03,5,7,12,141,gender
突発性発しん,2007,3,2007-W03,42,31,73,141,gender
ヘルパンギーナ,2007,3,2007-W03,2,0,2,141,gender
流行性耳下腺炎,2007,3,2007-W03,16,15,31,141,gender
川崎病,2007,3,2007-W03,2,0,2,141,gender
インフルエンザ,2020,51,2020-W51,1,2,3,412,gender
RSウイルス感染症,2020,51,2020-W51,3,1,4,259,gender
咽頭結膜熱,2020,51,2020-W51,29,21,50,259,gender
Ａ群溶血性レンサ球菌咽頭炎,2020,51,2020-W51,55,62,117,259,gender
感染性胃腸炎,2020,51,2020-W51,454,394,848,259,gender
水痘,2020,51,2020-W51,34,25,59,259,gender
手足口病,2020,51,2020-W51,4,4,8,259,gender
突発性発しん,2020,51,2020-W51,66,66,132,259,gender
ヘルパンギーナ,2020,51,2020-W51,1,3,4,259,gender
流行性耳下腺炎,2020,51,2020-W51,1,4,5,259,gender
川崎病,2020,51,2020-W51,1,0,1,259,gender
インフルエンザ,2022,22,2022-W22,0,0,0,411,gender
RSウイルス感染症,2022,22,2022-W22,11,14,25,257,gender
咽頭結膜熱,2022,22,2022-W22,40,34,74,257,gender
Ａ群溶血性レンサ球菌咽頭炎,2022,22,2022-W22,37,34,71,257,gender
感染性胃腸炎,2022,22,2022-W22,857,754,1611,257,gender
水痘,2022,22,2022-W22,8,8,16,257,gender
手足口病,2022,22,2022-W22,26,25,51,257,gender
突発性発しん,2022,22,2022-W22,61,44,105,257,gender
ヘルパンギーナ,2022,22,2022-W22,5,1,6,257,gender
流行性耳下腺炎,2022,22,2022-W22,7,5,12,257,gender
川崎病,2022,22,2022-W22,1,0,1,257,gender
インフルエンザ,2017,22,2017-W22,23,25,48,415,gender
RSウイルス感染症,2017,22,2017-W22,36,27,63,263,gender
咽頭結膜熱,2017,22,2017-W22,154,132,286,263,gender
Ａ群溶血性レンサ球菌咽頭炎,2017,22,2017-W22,454,404,858,263,gender
感染性胃腸炎,2017,22,2017-W22,1060,879,1939,263,gender
水痘,2017,22,2017-W22,71,63,134,263,gender
手足口病,2017,22,2017-W22,118,104,222,263,gender
突発性発しん,2017,22,2017-W22,105,97,202,263,gender
ヘルパンギーナ,2017,22,2017-W22,25,14,39,263,gender
流行性耳下腺炎,2017,22,2017-W22,37,28,65,263,gender
川崎病,2017,22,2017-W22,3,3,6,263,gender
インフルエンザ,2009,28,2009-W28,25,23,48,288,gender
RSウイルス感染症,2009,28,2009-W28,4,0,4,149,gender
咽頭結膜熱,2009,28,2009-W28,35,19,54,149,gender
Ａ群溶血性レンサ球菌咽頭炎,2009,28,2009-W28,116,103,219,149,gender
感染性胃腸炎,2009,28,2009-W28,276,249,525,149,gender
水痘,2009,28,2009-W28,60,59,119,149,gender
手足口病,2009,28,2009-W28,98,64,162,149,gender
突発性発しん,2009,28,2009-W28,60,55,115,149,gender
ヘルパンギーナ,2009,28,2009-W28,61,44,105,149,gender
流行性耳下腺炎,2009,28,2009-W28,85,64,149,149,gender
川崎病,2009,28,2009-W28,2,1,3,149,gender
インフルエンザ,2015,51,2015-W51,122,109,231,414,gender
RSウイルス感染症,2015,51,2015-W51,154,122,276,261,gender
咽頭結膜熱,2015,51,2015-W51,75,72,147,261,gender
Ａ群溶血性レンサ球菌咽頭炎,2015,51,2015-W51,574,474,1048,261,gender
感染性胃腸炎,2015,51,2015-W51,2043,1914,3957,261,gender
水痘,2015,51,2015-W51,139,128,267,261,gender
手足口病,2015,51,2015-W51,17,10,27,261,gender
突発性発しん,2015,51,2015-W51,76,56,132,261,gender
ヘルパンギーナ,2015,51,2015-W51,8,5,13,261,gender
流行性耳下腺炎,2015,51,2015-W51,96,100,196,261,gender
川崎病,2015,51,2015-W51,6,0,6,261,gender
インフルエンザ,2016,9,2016-W09,4819,4680,9499,415,gender
RSウイルス感染症,2016,9,2016-W09,19,14,33,260,gender
咽頭結膜熱,2016,9,2016-W09,19,24,43,260,gender
Ａ群溶血性レンサ球菌咽頭炎,2016,9,2016-W09,393,347,740,260,gender
感染性胃腸炎,2016,9,2016-W09,927,894,1821,260,gender
水痘,2016,9,2016-W09,52,46,98,260,gender
手足口病,2016,9,2016-W09,2,0,2,260,gender
突発性発しん,2016,9,2016-W09,60,45,105,260,gender
ヘルパンギーナ,2016,9,2016-W09,5,4,9,260,gender
流行性耳下腺炎,2016,9,2016-W09,72,49,121,260,gender
川崎病,2016,9,2016-W09,2,4,6,260,gender
インフルエンザ,2013,5,2013-W05,7430,7598,15028,419,gender
RSウイルス感染症,2013,5,2013-W05,71,54,125,264,gender
咽頭結膜熱,2013,5,2013-W05,30,24,54,264,gender
Ａ群溶血性レンサ球菌咽頭炎,2013,5,2013-W05,299,285,584,264,gender
感染性胃腸炎,2013,5,2013-W05,1081,1020,2101,264,gender
水痘,2013,5,2013-W05,96,59,155,264,gender
手足口病,2013,5,2013-W05,14,10,24,264,gender
突発性発しん,2013,5,2013-W05,73,61,134,264,gender
ヘルパンギーナ,2013,5,2013-W05,1,2,3,264,gender
流行性耳下腺炎,2013,5,2013-W05,14,24,38,264,gender
川崎病,2013,5,2013-W05,3,2,5,264,gender
インフルエンザ,2008,46,2008-W46,44,33,77,287,gender
RSウイルス感染症,2008,46,2008-W46,60,46,106,148,gender
咽頭結膜熱,2008,46,2008-W46,23,9,32,148,gender
Ａ群溶血性レンサ球菌咽頭炎,2008,46,2008-W46,138,146,284,148,gender
感染性胃腸炎,2008,46,2008-W46,661,548,1209,148,gender
水痘,2008,46,2008-W46,110,94,204,148,gender
手足口病,2008,46,2008-W46,42,38,80,148,gender
突発性発しん,2008,46,2008-W46,60,47,107,148,gender
ヘルパンギーナ,2008,46,2008-W46,8,7,15,148,gender
流行性耳下腺炎,2008,46,2008-W46,44,37,81,148,gender
川崎病,2008,46,2008-W46,2,0,2,148,gender
インフルエンザ,2005,16,2005-W16,99,88,187,178,gender
RSウイルス感染症,2005,16,2005-W16,4,3,7,142,gender
咽頭結膜熱,2005,16,2005-W16,17,11,28,142,gender
Ａ群溶血性レンサ球菌咽頭炎,2005,16,2005-W16,81,63,144,142,gender
感染性胃腸炎,2005,16,2005-W16,426,462,888,142,gender
水痘,2005,16,2005-W16,78,48,126,142,gender
手足口病,2005,16,2005-W16,13,15,28,142,gender
突発性発しん,2005,16,2005-W16,30,41,71,142,gender
ヘルパンギーナ,2005,16,2005-W16,7,3,10,142,gender
流行性耳下腺炎,2005,16,2005-W16,65,57,122,142,gender
川崎病,2005,16,2005-W16,1,0,1,142,gender
インフルエンザ,2012,38,2012-W38,13,14,27,406,gender
RSウイルス感染症,2012,38,2012-W38,194,139,333,255,gender
咽頭結膜熱,2012,38,2012-W38,90,58,148,255,gender
Ａ群溶血性レンサ球菌咽頭炎,2012,38,2012-W38,131,101,232,255,gender
感染性胃腸炎,2012,38,2012-W38,407,389,796,255,gender
水痘,2012,38,2012-W38,55,49,104,255,gender
手足口病,2012,38,2012-W38,79,61,140,255,gender
突発性発しん,2012,38,2012-W38,83,70,153,255,gender
ヘルパンギーナ,2012,38,2012-W38,86,69,155,255,gender
流行性耳下腺炎,2012,38,2012-W38,38,27,65,255,gender
川崎病,2012,38,2012-W38,1,1,2,255,gender
インフルエンザ,2003,11,2003-W11,206,248,454,178,gender
RSウイルス感染症,2003,11,2003-W11,0,0,0,142,gender
咽頭結膜熱,2003,11,2003-W11,2,0,2,142,gender
Ａ群溶血性レンサ球菌咽頭炎,2003,11,2003-W11,44,34,78,142,gender
感染性胃腸炎,2003,11,2003-W11,457,448,905,142,gender
水痘,2003,11,2003-W11,57,56,113,142,gender
手足口病,2003,11,2003-W11,0,1,1,142,gender
突発性発しん,2003,11,2003-W11,24,37,61,142,gender
ヘルパンギーナ,2003,11,2003-W11,1,2,3,142,gender
流行性耳下腺炎,2003,11,2003-W11,16,13,29,142,gender
川崎病,2003,11,2003-W11,0,0,0,142,gender
インフルエンザ,2011,25,2011-W25,8,3,11,414,gender
RSウイルス感染症,2011,25,2011-W25,8,12,20,260,gender
咽頭結膜熱,2011,25,2011-W25,108,88,196,260,gender
Ａ群溶血性レンサ球菌咽頭炎,2011,25,2011-W25,369,319,688,260,gender
感染性胃腸炎,2011,25,2011-W25,763,638,1401,260,gender
水痘,2011,25,2011-W25,153,162,315,260,gender
手足口病,2011,25,2011-W25,199,150,349,260,gender
突発性発しん,2011,25,2011-W25,94,104,198,260,gender
ヘルパンギーナ,2011,25,2011-W25,110,84,194,260,gender
流行性耳下腺炎,2011,25,2011-W25,81,52,133,260,gender
川崎病,2011,25,2011-W25,2,3,5,260,gender
インフルエンザ,2020,20,2020-W20,0,0,0,411,gender
RSウイルス感染症,2020,20,2020-W20,0,0,0,258,gender
咽頭結膜熱,2020,20,2020-W20,4,1,5,258,gender
Ａ群溶血性レンサ球菌咽頭炎,2020,20,2020-W20,45,39,84,258,gender
感染性胃腸炎,2020,20,2020-W20,147,144,291,258,gender
水痘,2020,20,2020-W20,8,8,16,258,gender
手足口病,2020,20,2020-W20,11,2,13,258,gender
突発性発しん,2020,20,2020-W20,32,38,70,258,gender
ヘルパンギーナ,2020,20,2020-W20,1,2,3,258,gender
流行性耳下腺炎,2020,20,2020-W20,3,5,8,258,gender
川崎病,2020,20,2020-W20,1,1,2,258,gender
インフルエンザ,2000,32,2000-W32,0,0,0,178,gender
RSウイルス感染症,2000,32,2000-W32,0,0,0,142,gender
咽頭結膜熱,2000,32,2000-W32,11,13,24,142,gender
Ａ群溶血性レンサ球菌咽頭炎,2000,32,2000-W32,15,8,23,142,gender
感染性胃腸炎,2000,32,2000-W32,102,86,188,142,gender
水痘,2000,32,2000-W32,36,29,65,142,gender
手足口病,2000,32,2000-W32,168,169,337,142,gender
突発性発しん,2000,32,2000-W32,31,23,54,142,gender
ヘルパンギーナ,2000,32,2000-W32,136,116,252,142,gender
流行性耳下腺炎,2000,32,2000-W32,47,53,100,142,gender
川崎病,2000,32,2000-W32,0,0,0,142,gender
インフルエンザ,2004,2,2004-W02,379,302,681,178,gender
RSウイルス感染症,2004,2,2004-W02,7,8,15,142,gender
咽頭結膜熱,2004,2,2004-W02,16,13,29,142,gender
Ａ群溶血性レンサ球菌咽頭炎,2004,2,2004-W02,50,40,90,142,gender
感染性胃腸炎,2004,2,2004-W02,501,528,1029,142,gender
水痘,2004,2,2004-W02,149,140,289,142,gender
手足口病,2004,2,2004-W02,1,1,2,142,gender
突発性発しん,2004,2,2004-W02,38,32,70,142,gender
ヘルパンギーナ,2004,2,2004-W02,1,1,2,142,gender
流行性耳下腺炎,2004,2,2004-W02,31,31,62,142,gender
川崎病,2004,2,2004-W02,1,0,1,142,gender
インフルエンザ,2002,41,2002-W41,0,0,0,178,gender
RSウイルス感染症,2002,41,2002-W41,0,0,0,142,gender
咽頭結膜熱,2002,41,2002-W41,6,6,12,142,gender
Ａ群溶血性レンサ球菌咽頭炎,2002,41,2002-W41,26,16,42,142,gender
感染性胃腸炎,2002,41,2002-W41,187,140,327,142,gender
水痘,2002,41,2002-W41,27,29,56,142,gender
手足口病,2002,41,2002-W41,23,12,35,142,gender
突発性発しん,2002,41,2002-W41,49,38,87,142,gender
ヘルパンギーナ,2002,41,2002-W41,4,12,16,142,gender
流行性耳下腺炎,2002,41,2002-W41,20,15,35,142,gender
川崎病,2002,41,2002-W41,1,1,2,142,gender
インフルエンザ,2006,35,2006-W35,0,0,0,178,gender
RSウイルス感染症,2006,35,2006-W35,2,1,3,142,gender
咽頭結膜熱,2006,35,2006-W35,31,31,62,142,gender
Ａ群溶血性レンサ球菌咽頭炎,2006,35,2006-W35,30,32,62,142,gender
感染性胃腸炎,2006,35,2006-W35,204,179,383,142,gender
水痘,2006,35,2006-W35,21,15,36,142,gender
手足口病,2006,35,2006-W35,49,48,97,142,gender
突発性発しん,2006,35,2006-W35,57,48,105,142,gender
ヘルパンギーナ,2006,35,2006-W35,25,15,40,142,gender
流行性耳下腺炎,2006,35,2006-W35,44,21,65,142,gender
川崎病,2006,35,2006-W35,2,1,3,142,gender
インフルエンザ,2009,16,2009-W16,467,524,991,287,gender
RSウイルス感染症,2009,16,2009-W16,7,3,10,147,gender
咽頭結膜熱,2009,16,2009-W16,20,11,31,147,gender
Ａ群溶血性レンサ球菌咽頭炎,2009,16,2009-W16,125,97,222,147,gender
感染性胃腸炎,2009,16,2009-W16,556,519,1075,147,gender
水痘,2009,16,2009-W16,76,81,157,147,gender
手足口病,2009,16,2009-W16,2,4,6,147,gender
突発性発しん,2009,16,2009-W16,58,55,113,147,gender
ヘルパンギーナ,2009,16,2009-W16,1,3,4,147,gender
流行性耳下腺炎,2009,16,2009-W16,45,48,93,147,gender
川崎病,2009,16,2009-W16,1,0,1,147,gender
インフルエンザ,2004,46,2004-W46,25,26,51,178,gender
RSウイルス感染症,2004,46,2004-W46,5,4,9,142,gender
咽頭結膜熱,2004,46,2004-W46,6,10,16,142,gender
Ａ群溶血性レンサ球菌咽頭炎,2004,46,2004-W46,45,40,85,142,gender
感染性胃腸炎,2004,46,2004-W46,289,249,538,142,gender
水痘,2004,46,2004-W46,65,59,124,142,gender
手足口病,2004,46,2004-W46,94,84,178,142,gender
突発性発しん,2004,46,2004-W46,38,34,72,142,gender
ヘルパンギーナ,2004,46,2004-W46,7,3,10,142,gender
流行性耳下腺炎,2004,46,2004-W46,54,46,100,142,gender
川崎病,2004,46,2004-W46,1,0,1,142,gender
インフルエンザ,2005,28,2005-W28,0,0,0,178,gender
RSウイルス感染症,2005,28,2005-W28,2,2,4,142,gender
咽頭結膜熱,2005,28,2005-W28,50,43,93,142,gender
Ａ群溶血性レンサ球菌咽頭炎,2005,28,2005-W28,96,99,195,142,gender
感染性胃腸炎,2005,28,2005-W28,261,186,447,142,gender
水痘,2005,28,2005-W28,55,66,121,142,gender
手足口病,2005,28,2005-W28,200,178,378,142,gender
突発性発しん,2005,28,2005-W28,41,50,91,142,gender
ヘルパンギーナ,2005,28,2005-W28,543,473,1016,142,gender
流行性耳下腺炎,2005,28,2005-W28,94,103,197,142,gender
川崎病,2005,28,2005-W28,0,1,1,142,gender
インフルエンザ,2019,51,2019-W51,4663,4677,9340,416,gender
RSウイルス感染症,2019,51,2019-W51,40,25,65,261,gender
咽頭結膜熱,2019,51,2019-W51,78,67,145,261,gender
Ａ群溶血性レンサ球菌咽頭炎,2019,51,2019-W51,526,463,989,261,gender
感染性胃腸炎,2019,51,2019-W51,1381,1258,2639,261,gender
水痘,2019,51,2019-W51,96,95,191,261,gender
手足口病,2019,51,2019-W51,121,125,246,261,gender
突発性発しん,2019,51,2019-W51,48,59,107,261,gender
ヘルパンギーナ,2019,51,2019-W51,15,14,29,261,gender
流行性耳下腺炎,2019,51,2019-W51,10,6,16,261,gender
川崎病,2019,51,2019-W51,3,2,5,261,gender
インフルエンザ,2023,10,2023-W10,2208,2083,4291,412,gender
RSウイルス感染症,2023,10,2023-W10,11,15,26,258,gender
咽頭結膜熱,2023,10,2023-W10,21,21,42,258,gender
Ａ群溶血性レンサ球菌咽頭炎,2023,10,2023-W10,62,41,103,258,gender
感染性胃腸炎,2023,10,2023-W10,747,625,1372,258,gender
水痘,2023,10,2023-W10,6,7,13,258,gender
手足口病,2023,10,2023-W10,2,3,5,258,gender
突発性発しん,2023,10,2023-W10,25,22,47,258,gender
ヘルパンギーナ,2023,10,2023-W10,0,2,2,258,gender
流行性耳下腺炎,2023,10,2023-W10,2,2,4,258,gender
川崎病,2023,10,2023-W10,2,1,3,258,gender
インフルエンザ,2013,45,2013-W45,23,31,54,410,gender
RSウイルス感染症,2013,45,2013-W45,127,109,236,258,gender
咽頭結膜熱,2013,45,2013-W45,38,36,74,258,gender
Ａ群溶血性レンサ球菌咽頭炎,2013,45,2013-W45,161,142,303,258,gender
感染性胃腸炎,2013,45,2013-W45,611,558,1169,258,gender
水痘,2013,45,2013-W45,87,84,171,258,gender
手足口病,2013,45,2013-W45,73,52,125,258,gender
突発性発しん,2013,45,2013-W45,65,57,122,258,gender
ヘルパンギーナ,2013,45,2013-W45,17,16,33,258,gender
流行性耳下腺炎,2013,45,2013-W45,21,19,40,258,gender
川崎病,2013,45,2013-W45,0,2,2,258,gender
インフルエンザ,2011,36,2011-W36,2,5,7,416,gender
RSウイルス感染症,2011,36,2011-W36,53,44,97,262,gender
咽頭結膜熱,2011,36,2011-W36,34,31,65,262,gender
Ａ群溶血性レンサ球菌咽頭炎,2011,36,2011-W36,96,85,181,262,gender
感染性胃腸炎,2011,36,2011-W36,461,391,852,262,gender
水痘,2011,36,2011-W36,66,40,106,262,gender
手足口病,2011,36,2011-W36,629,507,1136,262,gender
突発性発しん,2011,36,2011-W36,96,103,199,262,gender
ヘルパンギーナ,2011,36,2011-W36,287,286,573,262,gender
流行性耳下腺炎,2011,36,2011-W36,37,44,81,262,gender
川崎病,2011,36,2011-W36,1,1,2,262,gender
インフルエンザ,2015,42,2015-W42,16,16,32,410,gender
RSウイルス感染症,2015,42,2015-W42,193,170,363,259,gender
咽頭結膜熱,2015,42,2015-W42,35,23,58,259,gender
Ａ群溶血性レンサ球菌咽頭炎,2015,42,2015-W42,230,188,418,259,gender
感染性胃腸炎,2015,42,2015-W42,457,410,867,259,gender
水痘,2015,42,2015-W42,34,42,76,259,gender
手足口病,2015,42,2015-W42,120,95,215,259,gender
突発性発しん,2015,42,2015-W42,62,73,135,259,gender
ヘルパンギーナ,2015,42,2015-W42,20,16,36,259,gender
流行性耳下腺炎,2015,42,2015-W42,64,60,124,259,gender
川崎病,2015,42,2015-W42,2,0,2,259,gender
インフルエンザ,2018,12,2018-W12,583,621,1204,413,gender
RSウイルス感染症,2018,12,2018-W12,40,37,77,262,gender
咽頭結膜熱,2018,12,2018-W12,23,19,42,262,gender
Ａ群溶血性レンサ球菌咽頭炎,2018,12,2018-W12,310,278,588,262,gender
感染性胃腸炎,2018,12,2018-W12,603,576,1179,262,gender
水痘,2018,12,2018-W12,32,33,65,262,gender
手足口病,2018,12,2018-W12,4,13,17,262,gender
突発性発しん,2018,12,2018-W12,67,52,119,262,gender
ヘルパンギーナ,2018,12,2018-W12,0,1,1,262,gender
流行性耳下腺炎,2018,12,2018-W12,7,7,14,262,gender
川崎病,2018,12,2018-W12,3,1,4,262,gender
インフルエンザ,2025,17,2025-W17,194,178,372,417,gender
新型コロナウイルス感染症（COVID-19）,2025,17,2025-W17,162,179,341,417,gender
RSウイルス感染症,2025,17,2025-W17,54,48,102,264,gender
咽頭結膜熱,2025,17,2025-W17,50,30,80,264,gender
Ａ群溶血性レンサ球菌咽頭炎,2025,17,2025-W17,603,461,1064,264,gender
感染性胃腸炎,2025,17,2025-W17,1247,1033,2280,264,gender
水痘,2025,17,2025-W17,128,101,229,264,gender
手足口病,2025,17,2025-W17,12,8,20,264,gender
突発性発しん,2025,17,2025-W17,45,65,110,264,gender
ヘルパンギーナ,2025,17,2025-W17,2,0,2,264,gender
流行性耳下腺炎,2025,17,2025-W17,16,14,30,264,gender
川崎病,2025,17,2025-W17,5,1,6,264,gender
インフルエンザ,2006,18,2006-W18,22,19,41,178,gender
RSウイルス感染症,2006,18,2006-W18,4,1,5,142,gender
咽頭結膜熱,2006,18,2006-W18,31,23,54,142,gender
Ａ群溶血性レンサ球菌咽頭炎,2006,18,2006-W18,166,127,293,142,gender
感染性胃腸炎,2006,18,2006-W18,289,270,559,142,gender
水痘,2006,18,2006-W18,85,74,159,142,gender
手足口病,2006,18,2006-W18,6,5,11,142,gender
突発性発しん,2006,18,2006-W18,33,24,57,142,gender
ヘルパンギーナ,2006,18,2006-W18,9,21,30,142,gender
流行性耳下腺炎,2006,18,2006-W18,34,26,60,142,gender
川崎病,2006,18,2006-W18,1,1,2,142,gender
インフルエンザ,2017,31,2017-W31,55,40,95,411,gender
RSウイルス感染症,2017,31,2017-W31,312,271,583,259,gender
咽頭結膜熱,2017,31,2017-W31,141,103,244,259,gender
Ａ群溶血性レンサ球菌咽頭炎,2017,31,2017-W31,211,191,402,259,gender
感染性胃腸炎,2017,31,2017-W31,562,458,1020,259,gender
水痘,2017,31,2017-W31,29,35,64,259,gender
手足口病,2017,31,2017-W31,1683,1383,3066,259,gender
突発性発しん,2017,31,2017-W31,78,65,143,259,gender
ヘルパンギーナ,2017,31,2017-W31,354,299,653,259,gender
流行性耳下腺炎,2017,31,2017-W31,21,25,46,259,gender
川崎病,2017,31,2017-W31,3,1,4,259,gender
インフルエンザ,2005,4,2005-W04,1117,1132,2249,178,gender
RSウイルス感染症,2005,4,2005-W04,6,4,10,142,gender
咽頭結膜熱,2005,4,2005-W04,12,9,21,142,gender
Ａ群溶血性レンサ球菌咽頭炎,2005,4,2005-W04,74,62,136,142,gender
感染性胃腸炎,2005,4,2005-W04,644,649,1293,142,gender
水痘,2005,4,2005-W04,99,110,209,142,gender
手足口病,2005,4,2005-W04,13,13,26,142,gender
突発性発しん,2005,4,2005-W04,49,33,82,142,gender
ヘルパンギーナ,2005,4,2005-W04,3,1,4,142,gender
流行性耳下腺炎,2005,4,2005-W04,48,40,88,142,gender
川崎病,2005,4,2005-W04,1,1,2,142,gender
インフルエンザ,2006,26,2006-W26,2,0,2,178,gender
RSウイルス感染症,2006,26,2006-W26,0,0,0,142,gender
咽頭結膜熱,2006,26,2006-W26,120,101,221,142,gender
Ａ群溶血性レンサ球菌咽頭炎,2006,26,2006-W26,107,101,208,142,gender
感染性胃腸炎,2006,26,2006-W26,266,219,485,142,gender
水痘,2006,26,2006-W26,110,100,210,142,gender
手足口病,2006,26,2006-W26,53,30,83,142,gender
突発性発しん,2006,26,2006-W26,57,43,100,142,gender
ヘルパンギーナ,2006,26,2006-W26,417,367,784,142,gender
流行性耳下腺炎,2006,26,2006-W26,57,68,125,142,gender
川崎病,2006,26,2006-W26,1,2,3,142,gender
インフルエンザ,2014,12,2014-W12,3089,3017,6106,414,gender
RSウイルス感染症,2014,12,2014-W12,15,18,33,261,gender
咽頭結膜熱,2014,12,2014-W12,29,17,46,261,gender
Ａ群溶血性レンサ球菌咽頭炎,2014,12,2014-W12,241,248,489,261,gender
感染性胃腸炎,2014,12,2014-W12,663,562,1225,261,gender
水痘,2014,12,2014-W12,84,77,161,261,gender
手足口病,2014,12,2014-W12,3,4,7,261,gender
突発性発しん,2014,12,2014-W12,42,54,96,261,gender
ヘルパンギーナ,2014,12,2014-W12,1,1,2,261,gender
流行性耳下腺炎,2014,12,2014-W12,17,9,26,261,gender
川崎病,2014,12,2014-W12,2,1,3,261,gender
インフルエンザ,2019,42,2019-W42,108,135,243,415,gender
RSウイルス感染症,2019,42,2019-W42,99,56,155,260,gender
咽頭結膜熱,2019,42,2019-W42,38,19,57,260,gender
Ａ群溶血性レンサ球菌咽頭炎,2019,42,2019-W42,223,196,419,260,gender
感染性胃腸炎,2019,42,2019-W42,414,351,765,260,gender
水痘,2019,42,2019-W42,44,37,81,260,gender
手足口病,2019,42,2019-W42,283,226,509,260,gender
突発性発しん,2019,42,2019-W42,46,63,109,260,gender
ヘルパンギーナ,2019,42,2019-W42,57,52,109,260,gender
流行性耳下腺炎,2019,42,2019-W42,15,5,20,260,gender
川崎病,2019,42,2019-W42,1,0,1,260,gender
インフルエンザ,2024,47,2024-W47,527,473,1000,418,gender
新型コロナウイルス感染症（COVID-19）,2024,47,2024-W47,188,227,415,418,gender
RSウイルス感染症,2024,47,2024-W47,33,29,62,264,gender
咽頭結膜熱,2024,47,2024-W47,26,17,43,264,gender
Ａ群溶血性レンサ球菌咽頭炎,2024,47,2024-W47,293,241,534,264,gender
感染性胃腸炎,2024,47,2024-W47,438,423,861,264,gender
水痘,2024,47,2024-W47,33,22,55,264,gender
手足口病,2024,47,2024-W47,449,381,830,264,gender
突発性発しん,2024,47,2024-W47,35,34,69,264,gender
ヘルパンギーナ,2024,47,2024-W47,11,6,17,264,gender
流行性耳下腺炎,2024,47,2024-W47,3,2,5,264,gender
川崎病,2024,47,2024-W47,4,1,5,264,gender
インフルエンザ,2007,48,2007-W48,318,333,651,286,gender
RSウイルス感染症,2007,48,2007-W48,38,47,85,149,gender
咽頭結膜熱,2007,48,2007-W48,15,13,28,149,gender
Ａ群溶血性レンサ球菌咽頭炎,2007,48,2007-W48,190,174,364,149,gender
感染性胃腸炎,2007,48,2007-W48,1030,1040,2070,149,gender
水痘,2007,48,2007-W48,110,96,206,149,gender
手足口病,2007,48,2007-W48,28,17,45,149,gender
突発性発しん,2007,48,2007-W48,46,41,87,149,gender
ヘルパンギーナ,2007,48,2007-W48,6,6,12,149,gender
流行性耳下腺炎,2007,48,2007-W48,20,9,29,149,gender
川崎病,2007,48,2007-W48,0,1,1,149,gender
インフルエンザ,2022,40,2022-W40,0,2,2,413,gender
RSウイルス感染症,2022,40,2022-W40,166,133,299,260,gender
咽頭結膜熱,2022,40,2022-W40,8,3,11,260,gender
Ａ群溶血性レンサ球菌咽頭炎,2022,40,2022-W40,24,12,36,260,gender
感染性胃腸炎,2022,40,2022-W40,348,285,633,260,gender
水痘,2022,40,2022-W40,11,8,19,260,gender
手足口病,2022,40,2022-W40,289,228,517,260,gender
突発性発しん,2022,40,2022-W40,28,22,50,260,gender
ヘルパンギーナ,2022,40,2022-W40,53,43,96,260,gender
流行性耳下腺炎,2022,40,2022-W40,2,5,7,260,gender
川崎病,2022,40,2022-W40,1,2,3,260,gender
インフルエンザ,2012,15,2012-W15,841,744,1585,416,gender
RSウイルス感染症,2012,15,2012-W15,29,18,47,262,gender
咽頭結膜熱,2012,15,2012-W15,20,14,34,262,gender
Ａ群溶血性レンサ球菌咽頭炎,2012,15,2012-W15,216,241,457,262,gender
感染性胃腸炎,2012,15,2012-W15,1569,1434,3003,262,gender
水痘,2012,15,2012-W15,110,96,206,262,gender
手足口病,2012,15,2012-W15,9,5,14,262,gender
突発性発しん,2012,15,2012-W15,96,81,177,262,gender
ヘルパンギーナ,2012,15,2012-W15,1,3,4,262,gender
流行性耳下腺炎,2012,15,2012-W15,28,20,48,262,gender
川崎病,2012,15,2012-W15,2,1,3,262,gender
インフルエンザ,2020,33,2020-W33,0,1,1,378,gender
RSウイルス感染症,2020,33,2020-W33,0,0,0,240,gender
咽頭結膜熱,2020,33,2020-W33,11,2,13,240,gender
Ａ群溶血性レンサ球菌咽頭炎,2020,33,2020-W33,26,28,54,240,gender
感染性胃腸炎,2020,33,2020-W33,150,137,287,240,gender
水痘,2020,33,2020-W33,15,16,31,240,gender
手足口病,2020,33,2020-W33,10,11,21,240,gender
突発性発しん,2020,33,2020-W33,46,39,85,240,gender
ヘルパンギーナ,2020,33,2020-W33,11,5,16,240,gender
流行性耳下腺炎,2020,33,2020-W33,4,3,7,240,gender
川崎病,2020,33,2020-W33,1,1,2,240,gender
インフルエンザ,2002,52,2002-W52,356,353,709,178,gender
RSウイルス感染症,2002,52,2002-W52,0,0,0,142,gender
咽頭結膜熱,2002,52,2002-W52,9,6,15,142,gender
Ａ群溶血性レンサ球菌咽頭炎,2002,52,2002-W52,35,33,68,142,gender
感染性胃腸炎,2002,52,2002-W52,501,521,1022,142,gender
水痘,2002,52,2002-W52,110,90,200,142,gender
手足口病,2002,52,2002-W52,3,1,4,142,gender
突発性発しん,2002,52,2002-W52,30,26,56,142,gender
ヘルパンギーナ,2002,52,2002-W52,4,4,8,142,gender
流行性耳下腺炎,2002,52,2002-W52,14,11,25,142,gender
川崎病,2002,52,2002-W52,2,0,2,142,gender
インフルエンザ,2012,3,2012-W03,3124,3022,6146,418,gender
RSウイルス感染症,2012,3,2012-W03,43,31,74,263,gender
咽頭結膜熱,2012,3,2012-W03,28,24,52,263,gender
Ａ群溶血性レンサ球菌咽頭炎,2012,3,2012-W03,303,248,551,263,gender
感染性胃腸炎,2012,3,2012-W03,1712,1616,3328,263,gender
水痘,2012,3,2012-W03,194,190,384,263,gender
手足口病,2012,3,2012-W03,10,11,21,263,gender
突発性発しん,2012,3,2012-W03,78,60,138,263,gender
ヘルパンギーナ,2012,3,2012-W03,2,2,4,263,gender
流行性耳下腺炎,2012,3,2012-W03,22,21,43,263,gender
川崎病,2012,3,2012-W03,4,1,5,263,gender
インフルエンザ,2000,21,2000-W21,4,4,8,178,gender
RSウイルス感染症,2000,21,2000-W21,0,0,0,142,gender
咽頭結膜熱,2000,21,2000-W21,4,7,11,142,gender
Ａ群溶血性レンサ球菌咽頭炎,2000,21,2000-W21,65,40,105,142,gender
感染性胃腸炎,2000,21,2000-W21,309,273,582,142,gender
水痘,2000,21,2000-W21,102,96,198,142,gender
手足口病,2000,21,2000-W21,25,18,43,142,gender
突発性発しん,2000,21,2000-W21,45,29,74,142,gender
ヘルパンギーナ,2000,21,2000-W21,37,30,67,142,gender
流行性耳下腺炎,2000,21,2000-W21,38,32,70,142,gender
川崎病,2000,21,2000-W21,0,0,0,142,gender
インフルエンザ,2008,24,2008-W24,11,11,22,287,gender
RSウイルス感染症,2008,24,2008-W24,1,2,3,149,gender
咽頭結膜熱,2008,24,2008-W24,72,33,105,149,gender
Ａ群溶血性レンサ球菌咽頭炎,2008,24,2008-W24,205,190,395,149,gender
感染性胃腸炎,2008,24,2008-W24,531,450,981,149,gender
水痘,2008,24,2008-W24,140,142,282,149,gender
手足口病,2008,24,2008-W24,55,46,101,149,gender
突発性発しん,2008,24,2008-W24,54,61,115,149,gender
ヘルパンギーナ,2008,24,2008-W24,84,73,157,149,gender
流行性耳下腺炎,2008,24,2008-W24,38,24,62,149,gender
川崎病,2008,24,2008-W24,1,0,1,149,gender
インフルエンザ,2025,6,2025-W06,592,537,1129,419,gender
新型コロナウイルス感染症（COVID-19）,2025,6,2025-W06,723,764,1487,419,gender
RSウイルス感染症,2025,6,2025-W06,95,87,182,264,gender
咽頭結膜熱,2025,6,2025-W06,15,22,37,264,gender
Ａ群溶血性レンサ球菌咽頭炎,2025,6,2025-W06,387,312,699,264,gender
感染性胃腸炎,2025,6,2025-W06,1407,1236,2643,264,gender
水痘,2025,6,2025-W06,53,42,95,264,gender
手足口病,2025,6,2025-W06,8,3,11,264,gender
突発性発しん,2025,6,2025-W06,23,28,51,264,gender
ヘルパンギーナ,2025,6,2025-W06,0,1,1,264,gender
流行性耳下腺炎,2025,6,2025-W06,8,3,11,264,gender
川崎病,2025,6,2025-W06,0,0,0,264,gender
インフルエンザ,2015,33,2015-W33,1,3,4,374,gender
RSウイルス感染症,2015,33,2015-W33,18,17,35,231,gender
咽頭結膜熱,2015,33,2015-W33,63,39,102,231,gender
Ａ群溶血性レンサ球菌咽頭炎,2015,33,2015-W33,110,105,215,231,gender
感染性胃腸炎,2015,33,2015-W33,314,266,580,231,gender
水痘,2015,33,2015-W33,20,28,48,231,gender
手足口病,2015,33,2015-W33,840,695,1535,231,gender
突発性発しん,2015,33,2015-W33,67,52,119,231,gender
ヘルパンギーナ,2015,33,2015-W33,187,155,342,231,gender
流行性耳下腺炎,2015,33,2015-W33,32,30,62,231,gender
川崎病,2015,33,2015-W33,1,0,1,231,gender
インフルエンザ,2003,9,2003-W09,582,573,1155,178,gender
RSウイルス感染症,2003,9,2003-W09,0,0,0,142,gender
咽頭結膜熱,2003,9,2003-W09,2,5,7,142,gender
Ａ群溶血性レンサ球菌咽頭炎,2003,9,2003-W09,36,25,61,142,gender
感染性胃腸炎,2003,9,2003-W09,435,434,869,142,gender
水痘,2003,9,2003-W09,71,51,122,142,gender
手足口病,2003,9,2003-W09,0,1,1,142,gender
突発性発しん,2003,9,2003-W09,26,20,46,142,gender
ヘルパンギーナ,2003,9,2003-W09,1,2,3,142,gender
流行性耳下腺炎,2003,9,2003-W09,7,6,13,142,gender
川崎病,2003,9,2003-W09,0,0,0,142,gender
インフルエンザ,2017,40,2017-W40,28,28,56,412,gender
RSウイルス感染症,2017,40,2017-W40,147,132,279,262,gender
咽頭結膜熱,2017,40,2017-W40,45,42,87,262,gender
Ａ群溶血性レンサ球菌咽頭炎,2017,40,2017-W40,254,209,463,262,gender
感染性胃腸炎,2017,40,2017-W40,484,411,895,262,gender
水痘,2017,40,2017-W40,26,20,46,262,gender
手足口病,2017,40,2017-W40,469,403,872,262,gender
突発性発しん,2017,40,2017-W40,64,62,126,262,gender
ヘルパンギーナ,2017,40,2017-W40,82,116,198,262,gender
流行性耳下腺炎,2017,40,2017-W40,17,24,41,262,gender
川崎病,2017,40,2017-W40,3,1,4,262,gender
インフルエンザ,2006,5,2006-W05,2301,2298,4599,178,gender
RSウイルス感染症,2006,5,2006-W05,8,5,13,142,gender
咽頭結膜熱,2006,5,2006-W05,14,15,29,142,gender
Ａ群溶血性レンサ球菌咽頭炎,2006,5,2006-W05,167,148,315,142,gender
感染性胃腸炎,2006,5,2006-W05,564,545,1109,142,gender
水痘,2006,5,2006-W05,71,63,134,142,gender
手足口病,2006,5,2006-W05,4,5,9,142,gender
突発性発しん,2006,5,2006-W05,30,26,56,142,gender
ヘルパンギーナ,2006,5,2006-W05,1,2,3,142,gender
流行性耳下腺炎,2006,5,2006-W05,71,30,101,142,gender
川崎病,2006,5,2006-W05,0,0,0,142,gender
インフルエンザ,2013,34,2013-W34,1,2,3,395,gender
RSウイルス感染症,2013,34,2013-W34,37,41,78,245,gender
咽頭結膜熱,2013,34,2013-W34,47,45,92,245,gender
Ａ群溶血性レンサ球菌咽頭炎,2013,34,2013-W34,69,77,146,245,gender
感染性胃腸炎,2013,34,2013-W34,315,301,616,245,gender
水痘,2013,34,2013-W34,75,52,127,245,gender
手足口病,2013,34,2013-W34,598,538,1136,245,gender
突発性発しん,2013,34,2013-W34,67,74,141,245,gender
ヘルパンギーナ,2013,34,2013-W34,152,159,311,245,gender
流行性耳下腺炎,2013,34,2013-W34,25,24,49,245,gender
川崎病,2013,34,2013-W34,3,1,4,245,gender
インフルエンザ,2011,47,2011-W47,13,16,29,417,gender
RSウイルス感染症,2011,47,2011-W47,60,52,112,263,gender
咽頭結膜熱,2011,47,2011-W47,32,28,60,263,gender
Ａ群溶血性レンサ球菌咽頭炎,2011,47,2011-W47,293,281,574,263,gender
感染性胃腸炎,2011,47,2011-W47,1042,902,1944,263,gender
水痘,2011,47,2011-W47,235,203,438,263,gender
手足口病,2011,47,2011-W47,73,57,130,263,gender
突発性発しん,2011,47,2011-W47,74,90,164,263,gender
ヘルパンギーナ,2011,47,2011-W47,9,10,19,263,gender
流行性耳下腺炎,2011,47,2011-W47,54,26,80,263,gender
川崎病,2011,47,2011-W47,4,4,8,263,gender
インフルエンザ,2021,12,2021-W12,1,0,1,410,gender
RSウイルス感染症,2021,12,2021-W12,7,8,15,257,gender
咽頭結膜熱,2021,12,2021-W12,13,9,22,257,gender
Ａ群溶血性レンサ球菌咽頭炎,2021,12,2021-W12,49,44,93,257,gender
感染性胃腸炎,2021,12,2021-W12,366,295,661,257,gender
水痘,2021,12,2021-W12,10,14,24,257,gender
手足口病,2021,12,2021-W12,4,2,6,257,gender
突発性発しん,2021,12,2021-W12,66,51,117,257,gender
ヘルパンギーナ,2021,12,2021-W12,3,2,5,257,gender
流行性耳下腺炎,2021,12,2021-W12,6,5,11,257,gender
川崎病,2021,12,2021-W12,0,3,3,257,gender
インフルエンザ,2008,7,2008-W07,788,780,1568,288,gender
RSウイルス感染症,2008,7,2008-W07,8,7,15,149,gender
咽頭結膜熱,2008,7,2008-W07,6,13,19,149,gender
Ａ群溶血性レンサ球菌咽頭炎,2008,7,2008-W07,142,165,307,149,gender
感染性胃腸炎,2008,7,2008-W07,808,804,1612,149,gender
水痘,2008,7,2008-W07,89,68,157,149,gender
手足口病,2008,7,2008-W07,1,4,5,149,gender
突発性発しん,2008,7,2008-W07,41,34,75,149,gender
ヘルパンギーナ,2008,7,2008-W07,2,0,2,149,gender
流行性耳下腺炎,2008,7,2008-W07,29,19,48,149,gender
川崎病,2008,7,2008-W07,0,0,0,149,gender
インフルエンザ,2010,29,2010-W29,4,3,7,282,gender
RSウイルス感染症,2010,29,2010-W29,1,4,5,148,gender
咽頭結膜熱,2010,29,2010-W29,26,18,44,148,gender
Ａ群溶血性レンサ球菌咽頭炎,2010,29,2010-W29,51,68,119,148,gender
感染性胃腸炎,2010,29,2010-W29,226,186,412,148,gender
水痘,2010,29,2010-W29,64,48,112,148,gender
手足口病,2010,29,2010-W29,320,240,560,148,gender
突発性発しん,2010,29,2010-W29,41,45,86,148,gender
ヘルパンギーナ,2010,29,2010-W29,484,470,954,148,gender
流行性耳下腺炎,2010,29,2010-W29,79,63,142,148,gender
川崎病,2010,29,2010-W29,0,0,0,148,gender
インフルエンザ,2002,23,2002-W23,0,0,0,178,gender
RSウイルス感染症,2002,23,2002-W23,0,0,0,142,gender
咽頭結膜熱,2002,23,2002-W23,3,2,5,142,gender
Ａ群溶血性レンサ球菌咽頭炎,2002,23,2002-W23,67,46,113,142,gender
感染性胃腸炎,2002,23,2002-W23,219,194,413,142,gender
水痘,2002,23,2002-W23,131,102,233,142,gender
手足口病,2002,23,2002-W23,70,54,124,142,gender
突発性発しん,2002,23,2002-W23,50,37,87,142,gender
ヘルパンギーナ,2002,23,2002-W23,107,96,203,142,gender
流行性耳下腺炎,2002,23,2002-W23,52,56,108,142,gender
川崎病,2002,23,2002-W23,3,2,5,142,gender
インフルエンザ,2000,50,2000-W50,21,22,43,178,gender
RSウイルス感染症,2000,50,2000-W50,0,0,0,142,gender
咽頭結膜熱,2000,50,2000-W50,5,5,10,142,gender
Ａ群溶血性レンサ球菌咽頭炎,2000,50,2000-W50,32,20,52,142,gender
感染性胃腸炎,2000,50,2000-W50,778,750,1528,142,gender
水痘,2000,50,2000-W50,92,107,199,142,gender
手足口病,2000,50,2000-W50,30,27,57,142,gender
突発性発しん,2000,50,2000-W50,38,34,72,142,gender
ヘルパンギーナ,2000,50,2000-W50,5,0,5,142,gender
流行性耳下腺炎,2000,50,2000-W50,84,91,175,142,gender
川崎病,2000,50,2000-W50,0,0,0,142,gender
インフルエンザ,2022,31,2022-W31,13,10,23,405,gender
RSウイルス感染症,2022,31,2022-W31,248,193,441,255,gender
咽頭結膜熱,2022,31,2022-W31,10,10,20,255,gender
Ａ群溶血性レンサ球菌咽頭炎,2022,31,2022-W31,12,17,29,255,gender
感染性胃腸炎,2022,31,2022-W31,295,249,544,255,gender
水痘,2022,31,2022-W31,5,6,11,255,gender
手足口病,2022,31,2022-W31,691,568,1259,255,gender
突発性発しん,2022,31,2022-W31,27,34,61,255,gender
ヘルパンギーナ,2022,31,2022-W31,200,175,375,255,gender
流行性耳下腺炎,2022,31,2022-W31,5,3,8,255,gender
川崎病,2022,31,2022-W31,1,1,2,255,gender
インフルエンザ,2010,17,2010-W17,16,11,27,277,gender
RSウイルス感染症,2010,17,2010-W17,2,3,5,147,gender
咽頭結膜熱,2010,17,2010-W17,21,14,35,147,gender
Ａ群溶血性レンサ球菌咽頭炎,2010,17,2010-W17,150,137,287,147,gender
感染性胃腸炎,2010,17,2010-W17,649,654,1303,147,gender
水痘,2010,17,2010-W17,125,110,235,147,gender
手足口病,2010,17,2010-W17,31,32,63,147,gender
突発性発しん,2010,17,2010-W17,38,37,75,147,gender
ヘルパンギーナ,2010,17,2010-W17,13,17,30,147,gender
流行性耳下腺炎,2010,17,2010-W17,47,49,96,147,gender
川崎病,2010,17,2010-W17,0,1,1,147,gender
インフルエンザ,2020,42,2020-W42,0,1,1,412,gender
RSウイルス感染症,2020,42,2020-W42,2,0,2,260,gender
咽頭結膜熱,2020,42,2020-W42,12,10,22,260,gender
Ａ群溶血性レンサ球菌咽頭炎,2020,42,2020-W42,64,48,112,260,gender
感染性胃腸炎,2020,42,2020-W42,303,275,578,260,gender
水痘,2020,42,2020-W42,16,18,34,260,gender
手足口病,2020,42,2020-W42,4,4,8,260,gender
突発性発しん,2020,42,2020-W42,67,50,117,260,gender
ヘルパンギーナ,2020,42,2020-W42,5,12,17,260,gender
流行性耳下腺炎,2020,42,2020-W42,5,8,13,260,gender
川崎病,2020,42,2020-W42,2,1,3,260,gender
インフルエンザ,2011,2,2011-W02,2153,1988,4141,419,gender
RSウイルス感染症,2011,2,2011-W02,69,46,115,264,gender
咽頭結膜熱,2011,2,2011-W02,59,53,112,264,gender
Ａ群溶血性レンサ球菌咽頭炎,2011,2,2011-W02,196,213,409,264,gender
感染性胃腸炎,2011,2,2011-W02,1314,1278,2592,264,gender
水痘,2011,2,2011-W02,236,186,422,264,gender
手足口病,2011,2,2011-W02,9,10,19,264,gender
突発性発しん,2011,2,2011-W02,60,77,137,264,gender
ヘルパンギーナ,2011,2,2011-W02,2,5,7,264,gender
流行性耳下腺炎,2011,2,2011-W02,66,51,117,264,gender
川崎病,2011,2,2011-W02,2,3,5,264,gender
インフルエンザ,2019,33,2019-W33,25,36,61,358,gender
RSウイルス感染症,2019,33,2019-W33,190,174,364,221,gender
咽頭結膜熱,2019,33,2019-W33,18,18,36,221,gender
Ａ群溶血性レンサ球菌咽頭炎,2019,33,2019-W33,82,76,158,221,gender
感染性胃腸炎,2019,33,2019-W33,219,170,389,221,gender
水痘,2019,33,2019-W33,31,22,53,221,gender
手足口病,2019,33,2019-W33,324,281,605,221,gender
突発性発しん,2019,33,2019-W33,22,35,57,221,gender
ヘルパンギーナ,2019,33,2019-W33,140,127,267,221,gender
流行性耳下腺炎,2019,33,2019-W33,5,3,8,221,gender
川崎病,2019,33,2019-W33,0,0,0,221,gender
インフルエンザ,2024,36,2024-W36,106,102,208,419,gender
新型コロナウイルス感染症（COVID-19）,2024,36,2024-W36,892,1119,2011,419,gender
RSウイルス感染症,2024,36,2024-W36,32,37,69,264,gender
咽頭結膜熱,2024,36,2024-W36,20,33,53,264,gender
Ａ群溶血性レンサ球菌咽頭炎,2024,36,2024-W36,243,208,451,264,gender
感染性胃腸炎,2024,36,2024-W36,455,384,839,264,gender
水痘,2024,36,2024-W36,12,20,32,264,gender
手足口病,2024,36,2024-W36,1141,892,2033,264,gender
突発性発しん,2024,36,2024-W36,61,38,99,264,gender
ヘルパンギーナ,2024,36,2024-W36,121,101,222,264,gender
流行性耳下腺炎,2024,36,2024-W36,6,10,16,264,gender
川崎病,2024,36,2024-W36,2,1,3,264,gender
インフルエンザ,2007,39,2007-W39,8,8,16,288,gender
RSウイルス感染症,2007,39,2007-W39,2,5,7,150,gender
咽頭結膜熱,2007,39,2007-W39,19,8,27,150,gender
Ａ群溶血性レンサ球菌咽頭炎,2007,39,2007-W39,54,44,98,150,gender
感染性胃腸炎,2007,39,2007-W39,269,242,511,150,gender
水痘,2007,39,2007-W39,22,26,48,150,gender
手足口病,2007,39,2007-W39,81,65,146,150,gender
突発性発しん,2007,39,2007-W39,58,57,115,150,gender
ヘルパンギーナ,2007,39,2007-W39,51,49,100,150,gender
流行性耳下腺炎,2007,39,2007-W39,9,12,21,150,gender
川崎病,2007,39,2007-W39,0,2,2,150,gender
インフルエンザ,2016,10,2016-W10,4101,3964,8065,415,gender
RSウイルス感染症,2016,10,2016-W10,11,14,25,261,gender
咽頭結膜熱,2016,10,2016-W10,29,16,45,261,gender
Ａ群溶血性レンサ球菌咽頭炎,2016,10,2016-W10,418,333,751,261,gender
感染性胃腸炎,2016,10,2016-W10,906,788,1694,261,gender
水痘,2016,10,2016-W10,41,39,80,261,gender
手足口病,2016,10,2016-W10,2,4,6,261,gender
突発性発しん,2016,10,2016-W10,70,55,125,261,gender
ヘルパンギーナ,2016,10,2016-W10,2,2,4,261,gender
流行性耳下腺炎,2016,10,2016-W10,46,81,127,261,gender
川崎病,2016,10,2016-W10,2,1,3,261,gender
インフルエンザ,2004,24,2004-W24,0,0,0,178,gender
RSウイルス感染症,2004,24,2004-W24,2,1,3,142,gender
咽頭結膜熱,2004,24,2004-W24,39,34,73,142,gender
Ａ群溶血性レンサ球菌咽頭炎,2004,24,2004-W24,113,84,197,142,gender
感染性胃腸炎,2004,24,2004-W24,303,258,561,142,gender
水痘,2004,24,2004-W24,76,80,156,142,gender
手足口病,2004,24,2004-W24,22,18,40,142,gender
突発性発しん,2004,24,2004-W24,34,43,77,142,gender
ヘルパンギーナ,2004,24,2004-W24,67,67,134,142,gender
流行性耳下腺炎,2004,24,2004-W24,35,27,62,142,gender
川崎病,2004,24,2004-W24,0,1,1,142,gender
インフルエンザ,2007,36,2007-W36,0,2,2,286,gender
RSウイルス感染症,2007,36,2007-W36,6,5,11,150,gender
咽頭結膜熱,2007,36,2007-W36,12,16,28,150,gender
Ａ群溶血性レンサ球菌咽頭炎,2007,36,2007-W36,63,49,112,150,gender
感染性胃腸炎,2007,36,2007-W36,254,211,465,150,gender
水痘,2007,36,2007-W36,35,14,49,150,gender
手足口病,2007,36,2007-W36,86,78,164,150,gender
突発性発しん,2007,36,2007-W36,60,47,107,150,gender
ヘルパンギーナ,2007,36,2007-W36,83,80,163,150,gender
流行性耳下腺炎,2007,36,2007-W36,15,12,27,150,gender
川崎病,2007,36,2007-W36,0,1,1,150,gender
インフルエンザ,2008,15,2008-W15,61,51,112,287,gender
RSウイルス感染症,2008,15,2008-W15,7,4,11,149,gender
咽頭結膜熱,2008,15,2008-W15,18,8,26,149,gender
Ａ群溶血性レンサ球菌咽頭炎,2008,15,2008-W15,122,136,258,149,gender
感染性胃腸炎,2008,15,2008-W15,573,528,1101,149,gender
水痘,2008,15,2008-W15,95,75,170,149,gender
手足口病,2008,15,2008-W15,4,3,7,149,gender
突発性発しん,2008,15,2008-W15,57,58,115,149,gender
ヘルパンギーナ,2008,15,2008-W15,3,2,5,149,gender
流行性耳下腺炎,2008,15,2008-W15,29,37,66,149,gender
川崎病,2008,15,2008-W15,2,2,4,149,gender
インフルエンザ,2005,45,2005-W45,3,2,5,178,gender
RSウイルス感染症,2005,45,2005-W45,20,23,43,142,gender
咽頭結膜熱,2005,45,2005-W45,29,25,54,142,gender
Ａ群溶血性レンサ球菌咽頭炎,2005,45,2005-W45,118,90,208,142,gender
感染性胃腸炎,2005,45,2005-W45,333,305,638,142,gender
水痘,2005,45,2005-W45,65,55,120,142,gender
手足口病,2005,45,2005-W45,24,12,36,142,gender
突発性発しん,2005,45,2005-W45,48,41,89,142,gender
ヘルパンギーナ,2005,45,2005-W45,10,10,20,142,gender
流行性耳下腺炎,2005,45,2005-W45,92,86,178,142,gender
川崎病,2005,45,2005-W45,3,0,3,142,gender
インフルエンザ,2024,39,2024-W39,145,145,290,418,gender
新型コロナウイルス感染症（COVID-19）,2024,39,2024-W39,579,693,1272,418,gender
RSウイルス感染症,2024,39,2024-W39,44,37,81,263,gender
咽頭結膜熱,2024,39,2024-W39,27,23,50,263,gender
Ａ群溶血性レンサ球菌咽頭炎,2024,39,2024-W39,184,167,351,263,gender
感染性胃腸炎,2024,39,2024-W39,370,308,678,263,gender
水痘,2024,39,2024-W39,23,19,42,263,gender
手足口病,2024,39,2024-W39,1247,1116,2363,263,gender
突発性発しん,2024,39,2024-W39,34,29,63,263,gender
ヘルパンギーナ,2024,39,2024-W39,67,55,122,263,gender
流行性耳下腺炎,2024,39,2024-W39,8,5,13,263,gender
川崎病,2024,39,2024-W39,0,0,0,263,gender
インフルエンザ,2018,52,2018-W52,2200,2345,4545,394,gender
RSウイルス感染症,2018,52,2018-W52,19,27,46,249,gender
咽頭結膜熱,2018,52,2018-W52,42,31,73,249,gender
Ａ群溶血性レンサ球菌咽頭炎,2018,52,2018-W52,287,251,538,249,gender
感染性胃腸炎,2018,52,2018-W52,1211,1217,2428,249,gender
水痘,2018,52,2018-W52,74,67,141,249,gender
手足口病,2018,52,2018-W52,46,36,82,249,gender
突発性発しん,2018,52,2018-W52,43,36,79,249,gender
ヘルパンギーナ,2018,52,2018-W52,3,2,5,249,gender
流行性耳下腺炎,2018,52,2018-W52,7,5,12,249,gender
川崎病,2018,52,2018-W52,1,0,1,249,gender
インフルエンザ,2021,23,2021-W23,0,0,0,405,gender
RSウイルス感染症,2021,23,2021-W23,354,301,655,258,gender
咽頭結膜熱,2021,23,2021-W23,35,24,59,258,gender
Ａ群溶血性レンサ球菌咽頭炎,2021,23,2021-W23,55,50,105,258,gender
感染性胃腸炎,2021,23,2021-W23,603,449,1052,258,gender
水痘,2021,23,2021-W23,17,16,33,258,gender
手足口病,2021,23,2021-W23,19,18,37,258,gender
突発性発しん,2021,23,2021-W23,54,56,110,258,gender
ヘルパンギーナ,2021,23,2021-W23,8,5,13,258,gender
流行性耳下腺炎,2021,23,2021-W23,6,3,9,258,gender
川崎病,2021,23,2021-W23,3,0,3,258,gender
インフルエンザ,2023,50,2023-W50,4352,4125,8477,414,gender
新型コロナウイルス感染症（COVID-19）,2023,50,2023-W50,510,559,1069,414,gender
RSウイルス感染症,2023,50,2023-W50,6,2,8,261,gender
咽頭結膜熱,2023,50,2023-W50,460,417,877,261,gender
Ａ群溶血性レンサ球菌咽頭炎,2023,50,2023-W50,869,710,1579,261,gender
感染性胃腸炎,2023,50,2023-W50,1414,1262,2676,261,gender
水痘,2023,50,2023-W50,48,32,80,261,gender
手足口病,2023,50,2023-W50,57,40,97,261,gender
突発性発しん,2023,50,2023-W50,33,22,55,261,gender
ヘルパンギーナ,2023,50,2023-W50,4,5,9,261,gender
流行性耳下腺炎,2023,50,2023-W50,7,1,8,261,gender
川崎病,2023,50,2023-W50,4,4,8,261,gender
インフルエンザ,2001,31,2001-W31,0,0,0,178,gender
RSウイルス感染症,2001,31,2001-W31,0,0,0,142,gender
咽頭結膜熱,2001,31,2001-W31,21,18,39,142,gender
Ａ群溶血性レンサ球菌咽頭炎,2001,31,2001-W31,10,21,31,142,gender
感染性胃腸炎,2001,31,2001-W31,120,102,222,142,gender
水痘,2001,31,2001-W31,33,29,62,142,gender
手足口病,2001,31,2001-W31,60,40,100,142,gender
突発性発しん,2001,31,2001-W31,31,32,63,142,gender
ヘルパンギーナ,2001,31,2001-W31,189,173,362,142,gender
流行性耳下腺炎,2001,31,2001-W31,57,53,110,142,gender
川崎病,2001,31,2001-W31,0,1,1,142,gender
インフルエンザ,2014,1,2014-W01,165,115,280,289,gender
RSウイルス感染症,2014,1,2014-W01,11,15,26,164,gender
咽頭結膜熱,2014,1,2014-W01,20,10,30,164,gender
Ａ群溶血性レンサ球菌咽頭炎,2014,1,2014-W01,40,27,67,164,gender
感染性胃腸炎,2014,1,2014-W01,240,253,493,164,gender
水痘,2014,1,2014-W01,52,47,99,164,gender
手足口病,2014,1,2014-W01,2,0,2,164,gender
突発性発しん,2014,1,2014-W01,8,5,13,164,gender
ヘルパンギーナ,2014,1,2014-W01,0,1,1,164,gender
流行性耳下腺炎,2014,1,2014-W01,3,6,9,164,gender
川崎病,2014,1,2014-W01,1,0,1,164,gender
インフルエンザ,2010,18,2010-W18,5,3,8,283,gender
RSウイルス感染症,2010,18,2010-W18,2,4,6,148,gender
咽頭結膜熱,2010,18,2010-W18,16,19,35,148,gender
Ａ群溶血性レンサ球菌咽頭炎,2010,18,2010-W18,63,55,118,148,gender
感染性胃腸炎,2010,18,2010-W18,388,321,709,148,gender
水痘,2010,18,2010-W18,146,105,251,148,gender
手足口病,2010,18,2010-W18,17,22,39,148,gender
突発性発しん,2010,18,2010-W18,26,27,53,148,gender
ヘルパンギーナ,2010,18,2010-W18,6,9,15,148,gender
流行性耳下腺炎,2010,18,2010-W18,59,48,107,148,gender
川崎病,2010,18,2010-W18,0,2,2,148,gender
インフルエンザ,2003,42,2003-W42,0,0,0,178,gender
RSウイルス感染症,2003,42,2003-W42,0,0,0,142,gender
咽頭結膜熱,2003,42,2003-W42,4,3,7,142,gender
Ａ群溶血性レンサ球菌咽頭炎,2003,42,2003-W42,25,30,55,142,gender
感染性胃腸炎,2003,42,2003-W42,194,189,383,142,gender
水痘,2003,42,2003-W42,39,35,74,142,gender
手足口病,2003,42,2003-W42,18,16,34,142,gender
突発性発しん,2003,42,2003-W42,45,33,78,142,gender
ヘルパンギーナ,2003,42,2003-W42,12,11,23,142,gender
流行性耳下腺炎,2003,42,2003-W42,12,6,18,142,gender
川崎病,2003,42,2003-W42,2,0,2,142,gender
インフルエンザ,2011,48,2011-W48,18,17,35,418,gender
RSウイルス感染症,2011,48,2011-W48,68,43,111,264,gender
咽頭結膜熱,2011,48,2011-W48,46,30,76,264,gender
Ａ群溶血性レンサ球菌咽頭炎,2011,48,2011-W48,343,289,632,264,gender
感染性胃腸炎,2011,48,2011-W48,1507,1357,2864,264,gender
水痘,2011,48,2011-W48,251,249,500,264,gender
手足口病,2011,48,2011-W48,58,40,98,264,gender
突発性発しん,2011,48,2011-W48,87,75,162,264,gender
ヘルパンギーナ,2011,48,2011-W48,1,4,5,264,gender
流行性耳下腺炎,2011,48,2011-W48,61,40,101,264,gender
川崎病,2011,48,2011-W48,2,2,4,264,gender
インフルエンザ,2002,12,2002-W12,290,232,522,178,gender
RSウイルス感染症,2002,12,2002-W12,0,0,0,142,gender
咽頭結膜熱,2002,12,2002-W12,2,1,3,142,gender
Ａ群溶血性レンサ球菌咽頭炎,2002,12,2002-W12,44,34,78,142,gender
感染性胃腸炎,2002,12,2002-W12,390,336,726,142,gender
水痘,2002,12,2002-W12,57,52,109,142,gender
手足口病,2002,12,2002-W12,1,5,6,142,gender
突発性発しん,2002,12,2002-W12,34,27,61,142,gender
ヘルパンギーナ,2002,12,2002-W12,2,3,5,142,gender
流行性耳下腺炎,2002,12,2002-W12,49,34,83,142,gender
川崎病,2002,12,2002-W12,0,0,0,142,gender
インフルエンザ,2008,8,2008-W08,741,775,1516,288,gender
RSウイルス感染症,2008,8,2008-W08,6,8,14,149,gender
咽頭結膜熱,2008,8,2008-W08,22,15,37,149,gender
Ａ群溶血性レンサ球菌咽頭炎,2008,8,2008-W08,204,167,371,149,gender
感染性胃腸炎,2008,8,2008-W08,1015,984,1999,149,gender
水痘,2008,8,2008-W08,107,76,183,149,gender
手足口病,2008,8,2008-W08,8,7,15,149,gender
突発性発しん,2008,8,2008-W08,42,35,77,149,gender
ヘルパンギーナ,2008,8,2008-W08,1,1,2,149,gender
流行性耳下腺炎,2008,8,2008-W08,21,23,44,149,gender
川崎病,2008,8,2008-W08,0,0,0,149,gender
インフルエンザ,2010,26,2010-W26,3,3,6,286,gender
RSウイルス感染症,2010,26,2010-W26,6,8,14,148,gender
咽頭結膜熱,2010,26,2010-W26,31,25,56,148,gender
Ａ群溶血性レンサ球菌咽頭炎,2010,26,2010-W26,98,103,201,148,gender
感染性胃腸炎,2010,26,2010-W26,351,292,643,148,gender
水痘,2010,26,2010-W26,117,100,217,148,gender
手足口病,2010,26,2010-W26,185,155,340,148,gender
突発性発しん,2010,26,2010-W26,62,52,114,148,gender
ヘルパンギーナ,2010,26,2010-W26,443,432,875,148,gender
流行性耳下腺炎,2010,26,2010-W26,75,68,143,148,gender
川崎病,2010,26,2010-W26,0,0,0,148,gender
インフルエンザ,2016,21,2016-W21,34,38,72,408,gender
RSウイルス感染症,2016,21,2016-W21,18,7,25,257,gender
咽頭結膜熱,2016,21,2016-W21,122,90,212,257,gender
Ａ群溶血性レンサ球菌咽頭炎,2016,21,2016-W21,444,399,843,257,gender
感染性胃腸炎,2016,21,2016-W21,950,864,1814,257,gender
水痘,2016,21,2016-W21,77,66,143,257,gender
手足口病,2016,21,2016-W21,22,15,37,257,gender
突発性発しん,2016,21,2016-W21,93,122,215,257,gender
ヘルパンギーナ,2016,21,2016-W21,22,9,31,257,gender
流行性耳下腺炎,2016,21,2016-W21,74,47,121,257,gender
川崎病,2016,21,2016-W21,4,1,5,257,gender
インフルエンザ,2025,9,2025-W09,303,286,589,419,gender
新型コロナウイルス感染症（COVID-19）,2025,9,2025-W09,515,643,1158,419,gender
RSウイルス感染症,2025,9,2025-W09,91,66,157,264,gender
咽頭結膜熱,2025,9,2025-W09,16,12,28,264,gender
Ａ群溶血性レンサ球菌咽頭炎,2025,9,2025-W09,279,210,489,264,gender
感染性胃腸炎,2025,9,2025-W09,1849,1592,3441,264,gender
水痘,2025,9,2025-W09,40,47,87,264,gender
手足口病,2025,9,2025-W09,5,7,12,264,gender
突発性発しん,2025,9,2025-W09,22,23,45,264,gender
ヘルパンギーナ,2025,9,2025-W09,0,2,2,264,gender
流行性耳下腺炎,2025,9,2025-W09,3,5,8,264,gender
川崎病,2025,9,2025-W09,6,0,6,264,gender
インフルエンザ,2020,5,2020-W05,2341,2312,4653,416,gender
RSウイルス感染症,2020,5,2020-W05,31,30,61,262,gender
咽頭結膜熱,2020,5,2020-W05,32,31,63,262,gender
Ａ群溶血性レンサ球菌咽頭炎,2020,5,2020-W05,533,434,967,262,gender
感染性胃腸炎,2020,5,2020-W05,1187,1056,2243,262,gender
水痘,2020,5,2020-W05,58,42,100,262,gender
手足口病,2020,5,2020-W05,29,17,46,262,gender
突発性発しん,2020,5,2020-W05,43,40,83,262,gender
ヘルパンギーナ,2020,5,2020-W05,7,15,22,262,gender
流行性耳下腺炎,2020,5,2020-W05,1,9,10,262,gender
川崎病,2020,5,2020-W05,0,1,1,262,gender
インフルエンザ,2014,52,2014-W52,6824,6855,13679,415,gender
RSウイルス感染症,2014,52,2014-W52,197,161,358,262,gender
咽頭結膜熱,2014,52,2014-W52,75,56,131,262,gender
Ａ群溶血性レンサ球菌咽頭炎,2014,52,2014-W52,330,293,623,262,gender
感染性胃腸炎,2014,52,2014-W52,1593,1597,3190,262,gender
水痘,2014,52,2014-W52,112,106,218,262,gender
手足口病,2014,52,2014-W52,34,33,67,262,gender
突発性発しん,2014,52,2014-W52,47,47,94,262,gender
ヘルパンギーナ,2014,52,2014-W52,1,6,7,262,gender
流行性耳下腺炎,2014,52,2014-W52,45,27,72,262,gender
川崎病,2014,52,2014-W52,3,2,5,262,gender
インフルエンザ,2003,6,2003-W06,2204,2121,4325,178,gender
RSウイルス感染症,2003,6,2003-W06,0,0,0,142,gender
咽頭結膜熱,2003,6,2003-W06,5,5,10,142,gender
Ａ群溶血性レンサ球菌咽頭炎,2003,6,2003-W06,35,37,72,142,gender
感染性胃腸炎,2003,6,2003-W06,523,542,1065,142,gender
水痘,2003,6,2003-W06,54,50,104,142,gender
手足口病,2003,6,2003-W06,2,1,3,142,gender
突発性発しん,2003,6,2003-W06,28,35,63,142,gender
ヘルパンギーナ,2003,6,2003-W06,1,2,3,142,gender
流行性耳下腺炎,2003,6,2003-W06,9,13,22,142,gender
川崎病,2003,6,2003-W06,0,0,0,142,gender
インフルエンザ,2009,45,2009-W45,3765,3565,7330,288,gender
RSウイルス感染症,2009,45,2009-W45,7,9,16,149,gender
咽頭結膜熱,2009,45,2009-W45,6,4,10,149,gender
Ａ群溶血性レンサ球菌咽頭炎,2009,45,2009-W45,59,48,107,149,gender
感染性胃腸炎,2009,45,2009-W45,178,131,309,149,gender
水痘,2009,45,2009-W45,38,40,78,149,gender
手足口病,2009,45,2009-W45,29,28,57,149,gender
突発性発しん,2009,45,2009-W45,36,31,67,149,gender
ヘルパンギーナ,2009,45,2009-W45,10,7,17,149,gender
流行性耳下腺炎,2009,45,2009-W45,48,35,83,149,gender
川崎病,2009,45,2009-W45,2,0,2,149,gender
インフルエンザ,2004,15,2004-W15,6,4,10,178,gender
RSウイルス感染症,2004,15,2004-W15,4,3,7,142,gender
咽頭結膜熱,2004,15,2004-W15,10,9,19,142,gender
Ａ群溶血性レンサ球菌咽頭炎,2004,15,2004-W15,80,62,142,142,gender
感染性胃腸炎,2004,15,2004-W15,340,315,655,142,gender
水痘,2004,15,2004-W15,77,91,168,142,gender
手足口病,2004,15,2004-W15,2,2,4,142,gender
突発性発しん,2004,15,2004-W15,46,42,88,142,gender
ヘルパンギーナ,2004,15,2004-W15,1,3,4,142,gender
流行性耳下腺炎,2004,15,2004-W15,27,17,44,142,gender
川崎病,2004,15,2004-W15,0,0,0,142,gender
インフルエンザ,2001,40,2001-W40,1,0,1,178,gender
RSウイルス感染症,2001,40,2001-W40,0,0,0,142,gender
咽頭結膜熱,2001,40,2001-W40,3,2,5,142,gender
Ａ群溶血性レンサ球菌咽頭炎,2001,40,2001-W40,10,6,16,142,gender
感染性胃腸炎,2001,40,2001-W40,119,107,226,142,gender
水痘,2001,40,2001-W40,26,27,53,142,gender
手足口病,2001,40,2001-W40,16,10,26,142,gender
突発性発しん,2001,40,2001-W40,46,31,77,142,gender
ヘルパンギーナ,2001,40,2001-W40,25,16,41,142,gender
流行性耳下腺炎,2001,40,2001-W40,44,38,82,142,gender
川崎病,2001,40,2001-W40,1,0,1,142,gender
インフルエンザ,2003,33,2003-W33,0,0,0,178,gender
RSウイルス感染症,2003,33,2003-W33,0,0,0,142,gender
咽頭結膜熱,2003,33,2003-W33,16,7,23,142,gender
Ａ群溶血性レンサ球菌咽頭炎,2003,33,2003-W33,9,6,15,142,gender
感染性胃腸炎,2003,33,2003-W33,66,55,121,142,gender
水痘,2003,33,2003-W33,22,18,40,142,gender
手足口病,2003,33,2003-W33,104,93,197,142,gender
突発性発しん,2003,33,2003-W33,22,24,46,142,gender
ヘルパンギーナ,2003,33,2003-W33,75,85,160,142,gender
流行性耳下腺炎,2003,33,2003-W33,4,4,8,142,gender
川崎病,2003,33,2003-W33,1,1,2,142,gender
インフルエンザ,2021,52,2021-W52,2,0,2,399,gender
RSウイルス感染症,2021,52,2021-W52,6,6,12,249,gender
咽頭結膜熱,2021,52,2021-W52,11,5,16,249,gender
Ａ群溶血性レンサ球菌咽頭炎,2021,52,2021-W52,27,15,42,249,gender
感染性胃腸炎,2021,52,2021-W52,633,508,1141,249,gender
水痘,2021,52,2021-W52,8,3,11,249,gender
手足口病,2021,52,2021-W52,33,25,58,249,gender
突発性発しん,2021,52,2021-W52,24,17,41,249,gender
ヘルパンギーナ,2021,52,2021-W52,19,14,33,249,gender
流行性耳下腺炎,2021,52,2021-W52,4,0,4,249,gender
川崎病,2021,52,2021-W52,1,1,2,249,gender
インフルエンザ,2023,21,2023-W21,397,388,785,416,gender
新型コロナウイルス感染症（COVID-19）,2023,21,2023-W21,832,817,1649,416,gender
RSウイルス感染症,2023,21,2023-W21,145,148,293,262,gender
咽頭結膜熱,2023,21,2023-W21,83,64,147,262,gender
Ａ群溶血性レンサ球菌咽頭炎,2023,21,2023-W21,247,194,441,262,gender
感染性胃腸炎,2023,21,2023-W21,1043,912,1955,262,gender
水痘,2023,21,2023-W21,22,24,46,262,gender
手足口病,2023,21,2023-W21,52,43,95,262,gender
突発性発しん,2023,21,2023-W21,54,43,97,262,gender
ヘルパンギーナ,2023,21,2023-W21,179,157,336,262,gender
流行性耳下腺炎,2023,21,2023-W21,16,8,24,262,gender
川崎病,2023,21,2023-W21,1,3,4,262,gender
インフルエンザ,2006,29,2006-W29,0,2,2,178,gender
RSウイルス感染症,2006,29,2006-W29,1,0,1,142,gender
咽頭結膜熱,2006,29,2006-W29,84,72,156,142,gender
Ａ群溶血性レンサ球菌咽頭炎,2006,29,2006-W29,68,63,131,142,gender
感染性胃腸炎,2006,29,2006-W29,213,173,386,142,gender
水痘,2006,29,2006-W29,78,66,144,142,gender
手足口病,2006,29,2006-W29,61,45,106,142,gender
突発性発しん,2006,29,2006-W29,50,42,92,142,gender
ヘルパンギーナ,2006,29,2006-W29,142,123,265,142,gender
流行性耳下腺炎,2006,29,2006-W29,55,48,103,142,gender
川崎病,2006,29,2006-W29,0,0,0,142,gender
インフルエンザ,2018,23,2018-W23,29,21,50,417,gender
RSウイルス感染症,2018,23,2018-W23,29,22,51,263,gender
咽頭結膜熱,2018,23,2018-W23,124,108,232,263,gender
Ａ群溶血性レンサ球菌咽頭炎,2018,23,2018-W23,527,422,949,263,gender
感染性胃腸炎,2018,23,2018-W23,1072,916,1988,263,gender
水痘,2018,23,2018-W23,64,63,127,263,gender
手足口病,2018,23,2018-W23,45,45,90,263,gender
突発性発しん,2018,23,2018-W23,91,86,177,263,gender
ヘルパンギーナ,2018,23,2018-W23,30,30,60,263,gender
流行性耳下腺炎,2018,23,2018-W23,16,12,28,263,gender
川崎病,2018,23,2018-W23,3,3,6,263,gender
インフルエンザ,2019,2,2019-W02,6507,6557,13064,412,gender
RSウイルス感染症,2019,2,2019-W02,19,24,43,260,gender
咽頭結膜熱,2019,2,2019-W02,34,31,65,260,gender
Ａ群溶血性レンサ球菌咽頭炎,2019,2,2019-W02,270,244,514,260,gender
感染性胃腸炎,2019,2,2019-W02,1193,1172,2365,260,gender
水痘,2019,2,2019-W02,96,79,175,260,gender
手足口病,2019,2,2019-W02,20,12,32,260,gender
突発性発しん,2019,2,2019-W02,53,43,96,260,gender
ヘルパンギーナ,2019,2,2019-W02,1,2,3,260,gender
流行性耳下腺炎,2019,2,2019-W02,12,8,20,260,gender
川崎病,2019,2,2019-W02,3,1,4,260,gender
インフルエンザ,2007,47,2007-W47,200,216,416,288,gender
RSウイルス感染症,2007,47,2007-W47,38,25,63,150,gender
咽頭結膜熱,2007,47,2007-W47,13,12,25,150,gender
Ａ群溶血性レンサ球菌咽頭炎,2007,47,2007-W47,121,99,220,150,gender
感染性胃腸炎,2007,47,2007-W47,664,649,1313,150,gender
水痘,2007,47,2007-W47,82,67,149,150,gender
手足口病,2007,47,2007-W47,34,22,56,150,gender
突発性発しん,2007,47,2007-W47,54,53,107,150,gender
ヘルパンギーナ,2007,47,2007-W47,10,19,29,150,gender
流行性耳下腺炎,2007,47,2007-W47,17,23,40,150,gender
川崎病,2007,47,2007-W47,2,1,3,150,gender
インフルエンザ,2005,34,2005-W34,0,0,0,178,gender
RSウイルス感染症,2005,34,2005-W34,1,2,3,142,gender
咽頭結膜熱,2005,34,2005-W34,40,24,64,142,gender
Ａ群溶血性レンサ球菌咽頭炎,2005,34,2005-W34,25,23,48,142,gender
感染性胃腸炎,2005,34,2005-W34,169,125,294,142,gender
水痘,2005,34,2005-W34,30,34,64,142,gender
手足口病,2005,34,2005-W34,39,32,71,142,gender
突発性発しん,2005,34,2005-W34,55,33,88,142,gender
ヘルパンギーナ,2005,34,2005-W34,54,49,103,142,gender
流行性耳下腺炎,2005,34,2005-W34,61,51,112,142,gender
川崎病,2005,34,2005-W34,0,0,0,142,gender
インフルエンザ,2024,48,2024-W48,935,872,1807,418,gender
新型コロナウイルス感染症（COVID-19）,2024,48,2024-W48,245,321,566,418,gender
RSウイルス感染症,2024,48,2024-W48,34,23,57,264,gender
咽頭結膜熱,2024,48,2024-W48,33,32,65,264,gender
Ａ群溶血性レンサ球菌咽頭炎,2024,48,2024-W48,389,307,696,264,gender
感染性胃腸炎,2024,48,2024-W48,622,564,1186,264,gender
水痘,2024,48,2024-W48,55,37,92,264,gender
手足口病,2024,48,2024-W48,381,322,703,264,gender
突発性発しん,2024,48,2024-W48,37,39,76,264,gender
ヘルパンギーナ,2024,48,2024-W48,6,4,10,264,gender
流行性耳下腺炎,2024,48,2024-W48,3,6,9,264,gender
川崎病,2024,48,2024-W48,3,0,3,264,gender
インフルエンザ,2006,17,2006-W17,52,23,75,178,gender
RSウイルス感染症,2006,17,2006-W17,1,0,1,142,gender
咽頭結膜熱,2006,17,2006-W17,52,47,99,142,gender
Ａ群溶血性レンサ球菌咽頭炎,2006,17,2006-W17,171,137,308,142,gender
感染性胃腸炎,2006,17,2006-W17,465,429,894,142,gender
水痘,2006,17,2006-W17,125,108,233,142,gender
手足口病,2006,17,2006-W17,2,1,3,142,gender
突発性発しん,2006,17,2006-W17,35,35,70,142,gender
ヘルパンギーナ,2006,17,2006-W17,11,12,23,142,gender
流行性耳下腺炎,2006,17,2006-W17,52,40,92,142,gender
川崎病,2006,17,2006-W17,2,1,3,142,gender
インフルエンザ,2025,18,2025-W18,120,114,234,416,gender
新型コロナウイルス感染症（COVID-19）,2025,18,2025-W18,118,137,255,416,gender
RSウイルス感染症,2025,18,2025-W18,36,22,58,262,gender
咽頭結膜熱,2025,18,2025-W18,38,30,68,262,gender
Ａ群溶血性レンサ球菌咽頭炎,2025,18,2025-W18,430,339,769,262,gender
感染性胃腸炎,2025,18,2025-W18,886,823,1709,262,gender
水痘,2025,18,2025-W18,110,67,177,262,gender
手足口病,2025,18,2025-W18,13,12,25,262,gender
突発性発しん,2025,18,2025-W18,42,43,85,262,gender
ヘルパンギーナ,2025,18,2025-W18,3,2,5,262,gender
流行性耳下腺炎,2025,18,2025-W18,16,11,27,262,gender
川崎病,2025,18,2025-W18,6,2,8,262,gender
インフルエンザ,2009,34,2009-W34,370,367,737,275,gender
RSウイルス感染症,2009,34,2009-W34,12,9,21,143,gender
咽頭結膜熱,2009,34,2009-W34,4,8,12,143,gender
Ａ群溶血性レンサ球菌咽頭炎,2009,34,2009-W34,34,39,73,143,gender
感染性胃腸炎,2009,34,2009-W34,214,178,392,143,gender
水痘,2009,34,2009-W34,36,29,65,143,gender
手足口病,2009,34,2009-W34,90,78,168,143,gender
突発性発しん,2009,34,2009-W34,44,40,84,143,gender
ヘルパンギーナ,2009,34,2009-W34,82,84,166,143,gender
流行性耳下腺炎,2009,34,2009-W34,39,63,102,143,gender
川崎病,2009,34,2009-W34,0,0,0,143,gender
インフルエンザ,2023,4,2023-W04,2008,1782,3790,414,gender
RSウイルス感染症,2023,4,2023-W04,10,5,15,261,gender
咽頭結膜熱,2023,4,2023-W04,13,10,23,261,gender
Ａ群溶血性レンサ球菌咽頭炎,2023,4,2023-W04,33,26,59,261,gender
感染性胃腸炎,2023,4,2023-W04,1280,1057,2337,261,gender
水痘,2023,4,2023-W04,15,8,23,261,gender
手足口病,2023,4,2023-W04,3,3,6,261,gender
突発性発しん,2023,4,2023-W04,33,29,62,261,gender
ヘルパンギーナ,2023,4,2023-W04,1,1,2,261,gender
流行性耳下腺炎,2023,4,2023-W04,6,5,11,261,gender
川崎病,2023,4,2023-W04,1,2,3,261,gender
インフルエンザ,2016,50,2016-W50,1333,1243,2576,413,gender
RSウイルス感染症,2016,50,2016-W50,30,23,53,259,gender
咽頭結膜熱,2016,50,2016-W50,65,50,115,259,gender
Ａ群溶血性レンサ球菌咽頭炎,2016,50,2016-W50,359,314,673,259,gender
感染性胃腸炎,2016,50,2016-W50,3773,3607,7380,259,gender
水痘,2016,50,2016-W50,95,87,182,259,gender
手足口病,2016,50,2016-W50,58,41,99,259,gender
突発性発しん,2016,50,2016-W50,59,71,130,259,gender
ヘルパンギーナ,2016,50,2016-W50,7,8,15,259,gender
流行性耳下腺炎,2016,50,2016-W50,80,59,139,259,gender
川崎病,2016,50,2016-W50,2,3,5,259,gender
インフルエンザ,2014,23,2014-W23,5,3,8,412,gender
RSウイルス感染症,2014,23,2014-W23,11,9,20,262,gender
咽頭結膜熱,2014,23,2014-W23,124,109,233,262,gender
Ａ群溶血性レンサ球菌咽頭炎,2014,23,2014-W23,443,335,778,262,gender
感染性胃腸炎,2014,23,2014-W23,848,779,1627,262,gender
水痘,2014,23,2014-W23,213,157,370,262,gender
手足口病,2014,23,2014-W23,33,36,69,262,gender
突発性発しん,2014,23,2014-W23,118,128,246,262,gender
ヘルパンギーナ,2014,23,2014-W23,49,59,108,262,gender
流行性耳下腺炎,2014,23,2014-W23,47,47,94,262,gender
川崎病,2014,23,2014-W23,2,1,3,262,gender
インフルエンザ,2012,24,2012-W24,5,5,10,418,gender
RSウイルス感染症,2012,24,2012-W24,7,6,13,263,gender
咽頭結膜熱,2012,24,2012-W24,113,78,191,263,gender
Ａ群溶血性レンサ球菌咽頭炎,2012,24,2012-W24,467,427,894,263,gender
感染性胃腸炎,2012,24,2012-W24,1191,1093,2284,263,gender
水痘,2012,24,2012-W24,124,107,231,263,gender
手足口病,2012,24,2012-W24,92,53,145,263,gender
突発性発しん,2012,24,2012-W24,105,99,204,263,gender
ヘルパンギーナ,2012,24,2012-W24,111,97,208,263,gender
流行性耳下腺炎,2012,24,2012-W24,27,27,54,263,gender
川崎病,2012,24,2012-W24,3,2,5,263,gender
インフルエンザ,2011,39,2011-W39,1,5,6,412,gender
RSウイルス感染症,2011,39,2011-W39,97,78,175,258,gender
咽頭結膜熱,2011,39,2011-W39,20,12,32,258,gender
Ａ群溶血性レンサ球菌咽頭炎,2011,39,2011-W39,123,120,243,258,gender
感染性胃腸炎,2011,39,2011-W39,461,401,862,258,gender
水痘,2011,39,2011-W39,55,56,111,258,gender
手足口病,2011,39,2011-W39,386,294,680,258,gender
突発性発しん,2011,39,2011-W39,89,74,163,258,gender
ヘルパンギーナ,2011,39,2011-W39,148,129,277,258,gender
流行性耳下腺炎,2011,39,2011-W39,38,40,78,258,gender
川崎病,2011,39,2011-W39,4,3,7,258,gender
